bedrooms,bathrooms,sqft_living,sqft_lot,floors,waterfront,view,condition,grade,sqft_above,sqft_basement,lat,long,sqft_living15,sqft_lot15,l1area,l2area,l3area,yearsstand,yearsrenovated
3,1.75,1670,8511,1,0,0,3,7,1340,330,47.3257,-122.276,1580,7218,10181,8798,1670,34,34
4,2.5,1921,4888,2,0,0,3,7,1921,0,47.2689,-122.24,1921,9140,6809,11061,1921,10,10
4,2.5,3710,15935,1,0,0,3,10,2130,1580,47.3528,-122.267,3674,17913,19645,21587,3710,14,14
3,1,1510,17040,1,0,0,4,6,1510,0,47.2649,-122.285,1520,14000,18550,15520,1510,44,44
3,1.5,1370,9800,1,0,0,5,7,1370,0,47.3068,-122.27,1370,9800,11170,11170,1370,51,51
5,3,2300,8214,2,0,0,3,8,2300,0,47.3052,-122.276,2594,4950,10514,7544,2300,6,6
3,2.5,1322,6006,2,0,0,3,7,1322,0,47.2706,-122.254,1440,6796,7328,8236,1322,10,10
3,2.25,2060,47318,1,0,2,4,8,1600,460,47.2758,-122.265,1870,19663,49378,21533,2060,43,43
4,2.5,2160,8005,2,0,0,3,7,2160,0,47.2668,-122.231,1790,8016,10165,9806,2160,26,26
4,2.5,2789,3960,2,0,0,3,7,2789,0,47.3059,-122.28,2547,3960,6749,6507,2789,12,12
3,1,1320,9000,1,0,0,3,7,1320,0,47.3461,-122.272,1320,9800,10320,11120,1320,53,53
4,2.5,2160,8049,2,0,0,3,9,2160,0,47.3337,-122.26,2490,8995,10209,11485,2160,31,31
5,2.5,2406,7093,2,0,0,3,8,2406,0,47.2615,-122.252,1767,7093,9499,8860,2406,13,13
3,1.5,1800,9216,1,0,0,4,7,1800,0,47.2739,-122.249,1400,10022,11016,11422,1800,69,69
3,1.75,1840,16679,1,0,0,3,8,1840,0,47.3207,-122.275,1910,15571,18519,17481,1840,30,30
3,2.5,1580,8541,2,0,0,3,7,1580,0,47.3334,-122.289,1640,7542,10121,9182,1580,29,29
4,2.5,1934,5677,2,0,0,3,8,1934,0,47.2602,-122.252,1919,5049,7611,6968,1934,6,6
2,1.75,870,18537,1,0,0,4,6,870,0,47.275,-122.278,1300,22800,19407,24100,870,73,73
3,1.75,1620,37913,2,0,0,4,7,1620,0,47.2875,-122.289,2190,21518,39533,23708,1620,66,39
4,2.5,2250,9091,1,0,0,3,7,1340,910,47.336,-122.269,1540,7802,11341,9342,2250,37,37
4,2.5,2233,6025,2,0,0,3,7,2233,0,47.2599,-122.256,1544,6036,8258,7580,2233,7,7
3,2.5,1970,9607,2,0,0,3,7,1090,880,47.3462,-122.286,2020,9608,11577,11628,1970,31,31
3,2.5,1560,4800,2,0,0,4,7,1560,0,47.2653,-122.285,1510,12240,6360,13750,1560,45,45
4,2.75,2140,9920,2,0,0,3,8,2140,0,47.3529,-122.274,2130,9920,12060,12050,2140,26,26
3,2.5,1794,4769,2,0,0,3,7,1794,0,47.3052,-122.283,3557,4807,6563,8364,1794,14,14
3,2.5,2220,20531,2,0,0,3,8,2220,0,47.2864,-122.264,2420,19249,22751,21669,2220,21,21
4,2.5,2240,4800,2,0,0,3,8,2240,0,47.2911,-122.266,2240,5040,7040,7280,2240,5,5
3,1,1360,20000,1,0,0,4,7,1360,0,47.2861,-122.253,1530,9997,21360,11527,1360,66,66
4,2.5,2900,6918,2,0,0,3,8,2900,0,47.3504,-122.284,2720,10376,9818,13096,2900,18,18
5,2,1590,9350,1,0,0,5,7,1060,530,47.3398,-122.286,1460,8210,10940,9670,1590,57,57
2,1,910,22000,1,0,0,3,6,910,0,47.2777,-122.252,1326,9891,22910,11217,910,63,63
4,2.75,1830,6643,2,0,0,3,8,1830,0,47.2601,-122.286,2400,6472,8473,8872,1830,18,18
3,1.5,1580,14040,1,0,0,3,7,1050,530,47.2932,-122.267,2240,12000,15620,14240,1580,39,39
4,2.25,2190,9113,2,0,0,3,7,2190,0,47.3241,-122.275,1570,8306,11303,9876,2190,33,33
3,1.75,2180,9220,1,0,0,4,7,1090,1090,47.3547,-122.285,2050,22400,11400,24450,2180,81,81
2,1,1000,16524,1,0,0,3,5,1000,0,47.2841,-122.255,1350,10208,17524,11558,1000,106,106
3,1.5,1000,18568,1,0,0,3,6,1000,0,47.2976,-122.271,1610,17420,19568,19030,1000,30,30
4,3.5,3828,18900,2,0,0,3,9,3828,0,47.2851,-122.277,2120,18900,22728,21020,3828,5,5
4,2.5,4073,17334,2,0,0,3,8,4073,0,47.2949,-122.27,1780,9625,21407,11405,4073,11,11
3,1.75,1300,6318,1,0,0,3,7,1300,0,47.2752,-122.251,1150,8002,7618,9152,1300,39,39
3,2,1790,7879,1,0,0,3,7,1790,0,47.2634,-122.289,1790,7879,9669,9669,1790,21,21
4,2.5,2240,6944,1,0,2,3,7,1310,930,47.338,-122.258,1780,7477,9184,9257,2240,40,40
4,2.75,2140,10316,2,0,0,3,8,2140,0,47.3537,-122.274,1920,11337,12456,13257,2140,26,26
4,2,1910,4225,1,0,0,4,6,910,1000,47.3084,-122.234,1060,4800,6135,5860,1910,100,100
3,1.75,1610,7392,1,0,0,4,7,1610,0,47.3413,-122.28,1450,7392,9002,8842,1610,55,55
4,2.5,2891,6499,2,0,0,3,9,2891,0,47.3359,-122.257,2550,8383,9390,10933,2891,5,5
3,1,1580,7560,1,0,0,4,7,1000,580,47.3318,-122.277,1580,7560,9140,9140,1580,43,43
3,1,1070,22489,1,0,0,3,7,1070,0,47.3278,-122.262,1880,20250,23559,22130,1070,52,52
4,2.5,3380,75794,2,0,0,3,10,3380,0,47.3511,-122.266,3710,17913,79174,21623,3380,22,22
4,3,2163,5883,2,0,0,3,7,2163,0,47.2734,-122.251,1700,10143,8046,11843,2163,13,13
4,2.5,2301,6452,2,0,0,3,9,2301,0,47.346,-122.269,2650,6054,8753,8704,2301,9,9
3,2,1560,7352,1,0,0,3,6,1560,0,47.2804,-122.251,1120,7950,8912,9070,1560,27,27
3,1,1980,18730,1,0,0,4,7,1280,700,47.3221,-122.282,1356,9450,20710,10806,1980,76,76
4,2.5,2600,8572,2,0,0,3,8,2600,0,47.3155,-122.266,2170,5288,11172,7458,2600,16,16
4,2.25,2710,22860,1,0,0,4,7,1850,860,47.3207,-122.266,1700,22860,25570,24560,2710,57,57
3,1.5,1220,7300,1,0,0,3,7,1220,0,47.3341,-122.279,1260,7347,8520,8607,1220,46,46
3,2,1630,8018,1,0,0,3,7,1630,0,47.2638,-122.243,1610,8397,9648,10007,1630,16,16
5,2.75,3220,8160,2,0,0,3,9,3220,0,47.3154,-122.254,2876,11521,11380,14397,3220,20,20
4,2.5,2160,9528,2,0,0,3,9,2160,0,47.3341,-122.255,2280,9937,11688,12217,2160,27,27
2,2.75,1770,10534,1,0,0,3,8,1210,560,47.2773,-122.276,1600,17400,12304,19000,1770,16,16
4,3,2050,4000,2,0,0,3,8,2050,0,47.3525,-122.275,2050,4000,6050,6050,2050,5,5
3,2.5,2120,22482,1,0,0,5,7,1360,760,47.341,-122.265,2330,16016,24602,18346,2120,40,40
4,2.5,2650,8685,2,0,0,3,9,2650,0,47.344,-122.269,2650,7932,11335,10582,2650,13,13
3,2,1660,13085,1,0,0,3,7,1010,650,47.3298,-122.277,1660,7778,14745,9438,1660,34,34
3,1,920,14400,1,0,0,4,7,920,0,47.2816,-122.269,1170,9600,15320,10770,920,42,42
4,2.5,1847,8000,2,0,0,3,7,1847,0,47.2874,-122.257,1767,8000,9847,9767,1847,11,11
3,1,910,7194,1,0,0,4,7,910,0,47.3337,-122.275,1530,7200,8104,8730,910,48,48
3,2.25,2120,14915,1,0,0,3,9,1720,400,47.3524,-122.285,2320,13100,17035,15420,2120,40,40
3,1.5,1390,7417,1,0,0,3,7,1390,0,47.3369,-122.275,1390,7665,8807,9055,1390,52,52
4,1,1610,24000,1,0,0,3,6,1610,0,47.2751,-122.252,1270,9600,25610,10870,1610,72,72
4,2.5,2717,4513,2,0,0,3,8,2717,0,47.3373,-122.266,2550,4841,7230,7391,2717,14,14
3,1,1900,33888,1,0,0,4,5,1900,0,47.2738,-122.271,1430,19200,35788,20630,1900,77,77
4,2.5,3230,16171,2,0,3,3,9,2520,710,47.3183,-122.253,2640,8517,19401,11157,3230,18,18
3,2,1430,10850,1,0,0,3,7,1430,0,47.2671,-122.233,1610,8015,12280,9625,1430,25,25
4,2.5,1960,7875,1,0,0,3,7,1220,740,47.3427,-122.274,2030,7650,9835,9680,1960,41,41
3,2.5,2495,4400,2,0,0,3,8,2495,0,47.2877,-122.283,2434,4400,6895,6834,2495,12,12
3,1.5,1360,7488,1,0,0,4,7,1050,310,47.3314,-122.275,1580,7508,8848,9088,1360,44,44
3,1.5,1660,15600,2,0,0,3,7,1660,0,47.2589,-122.279,1660,14400,17260,16060,1660,38,38
4,2.5,2550,7555,2,0,0,3,8,2550,0,47.2614,-122.29,2550,6800,10105,9350,2550,18,18
4,2.75,2260,4440,2,0,0,3,7,2260,0,47.3507,-122.291,2260,4563,6700,6823,2260,5,5
3,2.5,1600,6848,2,0,0,3,7,1600,0,47.3303,-122.271,1700,7210,8448,8910,1600,19,19
4,2.5,2080,9846,1,0,0,3,7,1240,840,47.3338,-122.268,1890,7977,11926,9867,2080,35,35
3,1,1660,7210,1,0,0,3,7,1100,560,47.3394,-122.281,1660,7245,8870,8905,1660,56,56
3,1.5,1200,12000,1,0,0,3,7,1200,0,47.268,-122.245,1200,9405,13200,10605,1200,33,33
4,2,1670,9987,1,0,0,3,7,1670,0,47.3406,-122.284,1640,7280,11657,8920,1670,52,52
4,2.5,1954,5075,2,0,0,3,8,1954,0,47.2606,-122.253,1934,5000,7029,6934,1954,12,12
4,2.5,2240,4648,2,0,0,3,7,2240,0,47.3378,-122.257,2221,4557,6888,6778,2240,14,14
3,2.5,2714,17936,2,0,0,3,9,2714,0,47.3185,-122.275,2590,18386,20650,20976,2714,14,14
3,1,910,7686,1,0,0,3,7,910,0,47.3405,-122.288,1020,7686,8596,8706,910,50,50
2,1.75,2056,52333,1,0,0,4,7,1048,1008,47.2592,-122.291,2220,6458,54389,8678,2056,39,39
3,1,1150,19200,1,0,0,4,5,1150,0,47.2756,-122.27,1290,19200,20350,20490,1150,111,111
5,3,3720,25474,2,0,4,3,9,2090,1630,47.3296,-122.256,1870,14547,29194,16417,3720,33,33
3,2.25,1820,19602,1,0,0,4,7,1820,0,47.331,-122.286,1520,8773,21422,10293,1820,55,55
3,1.75,1370,8006,2,0,0,3,7,1370,0,47.258,-122.252,1530,8006,9376,9536,1370,29,29
3,1.75,1250,8084,1,0,0,4,7,1250,0,47.3364,-122.276,1340,7680,9334,9020,1250,52,52
4,1.5,2050,7100,1,0,0,3,7,1050,1000,47.3395,-122.28,1950,7350,9150,9300,2050,56,56
3,1.75,2710,9088,1,0,0,4,7,2060,650,47.3073,-122.272,1690,10454,11798,12144,2710,54,54
4,2,1450,7560,1,0,0,3,7,1450,0,47.3375,-122.276,1430,7560,9010,8990,1450,52,52
4,2.5,2502,8306,2,0,0,3,9,2502,0,47.2953,-122.265,2597,6983,10808,9580,2502,6,6
3,2.25,1590,11745,1,0,0,3,7,1090,500,47.3553,-122.28,1540,12530,13335,14070,1590,41,41
3,1,1070,6164,1,0,0,3,7,1070,0,47.3377,-122.291,1320,7920,7234,9240,1070,52,52
4,2.5,2068,7242,2,0,0,4,7,2068,0,47.3318,-122.281,1560,7524,9310,9084,2068,43,43
3,2.5,1770,8640,1,0,0,3,7,1420,350,47.326,-122.273,1894,7974,10410,9868,1770,33,33
3,2,2740,23505,2,0,4,3,10,2740,0,47.319,-122.26,2800,16400,26245,19200,2740,31,31
5,2.5,2780,9652,1,0,0,4,8,1390,1390,47.3444,-122.271,1790,9652,12432,11442,2780,52,52
4,1,1340,7920,1,0,0,4,7,1340,0,47.2845,-122.267,1090,9600,9260,10690,1340,49,49
3,1,1010,9576,1,0,0,4,7,1010,0,47.2956,-122.272,1540,9576,10586,11116,1010,52,52
3,1,1390,16000,1,0,0,4,6,1390,0,47.2898,-122.251,1420,10000,17390,11420,1390,59,59
3,1.75,1230,12000,1,0,0,3,6,1230,0,47.2878,-122.251,1550,12000,13230,13550,1230,49,49
2,1,1730,9610,1,0,0,3,7,1380,350,47.2956,-122.285,1310,9812,11340,11122,1730,57,57
3,1.75,3160,76230,1,0,0,4,8,2160,1000,47.274,-122.287,1990,45789,79390,47779,3160,41,41
3,1.75,1690,7735,1,0,0,4,7,1060,630,47.3324,-122.28,1580,7503,9425,9083,1690,43,43
3,2.5,1570,5113,1,0,0,3,7,1090,480,47.3327,-122.29,1570,5150,6683,6720,1570,23,23
5,2.5,2025,7760,2,0,0,3,7,2025,0,47.2671,-122.256,1664,9000,9785,10664,2025,12,12
4,2.25,1700,7056,2,0,0,3,7,1700,0,47.3385,-122.262,1650,6025,8756,7675,1700,20,20
3,2.25,1630,10969,2,0,0,3,7,1630,0,47.3305,-122.285,1410,7920,12599,9330,1630,28,28
3,2.25,1560,8280,2,0,0,4,7,1560,0,47.3393,-122.259,1920,8120,9840,10040,1560,40,40
5,1.75,1798,11232,1,0,0,3,7,1798,0,47.3266,-122.291,1300,15582,13030,16882,1798,52,52
3,1.75,2240,9200,1,0,0,4,7,1440,800,47.2635,-122.284,1740,9600,11440,11340,2240,51,51
3,2.75,1900,16117,1,0,0,4,7,1900,0,47.3144,-122.278,1640,19166,18017,20806,1900,61,61
4,2.75,2060,7350,1,0,0,3,7,1210,850,47.3424,-122.275,1940,7420,9410,9360,2060,41,41
3,1,940,10890,1,0,0,4,5,940,0,47.2763,-122.257,1370,10255,11830,11625,940,110,110
4,2.5,2620,5457,2,0,0,3,8,2620,0,47.3148,-122.27,2740,5816,8077,8556,2620,16,16
3,1.75,1490,10125,1,0,0,4,7,1490,0,47.3075,-122.284,2488,4981,11615,7469,1490,57,57
3,2.25,2070,11576,2,0,0,3,7,2070,0,47.3417,-122.271,1890,7519,13646,9409,2070,45,45
3,2.5,2650,12247,2,0,0,3,9,2650,0,47.3185,-122.259,2920,8965,14897,11885,2650,17,17
3,2,1400,9177,1,0,0,3,7,1400,0,47.3415,-122.272,2020,8547,10577,10567,1400,45,45
3,1,1220,9600,1,0,0,5,7,1220,0,47.2622,-122.282,1310,9600,10820,10910,1220,61,61
1,1,1120,17332,1,0,0,3,7,1120,0,47.2972,-122.267,1280,17334,18452,18614,1120,31,31
3,1,1150,8000,1,0,0,4,6,1150,0,47.2749,-122.252,1170,9600,9150,10770,1150,106,58
4,2,1360,60548,1,0,0,3,6,960,400,47.2718,-122.265,1930,28800,61908,30730,1360,59,59
4,2.25,1730,8400,1,0,0,3,7,1730,0,47.3386,-122.288,1550,7920,10130,9470,1730,57,57
4,2.5,1252,25002,1,0,0,3,8,992,260,47.3216,-122.291,1860,25002,26254,26862,1252,23,23
5,1.75,2320,7700,1,0,0,5,7,1290,1030,47.3426,-122.285,1740,7210,10020,8950,2320,57,57
4,2.5,2940,9172,2,0,0,3,9,2940,0,47.3444,-122.269,2660,7955,12112,10615,2940,13,13
4,2.25,2560,8927,1,0,0,3,7,1790,770,47.34,-122.271,1920,9669,11487,11589,2560,43,43
4,2.75,3230,12651,2,0,0,4,8,3230,0,47.3157,-122.251,2550,12081,15881,14631,3230,17,17
3,2.25,2190,8834,1,0,0,3,7,1390,800,47.2633,-122.244,1490,8766,11024,10256,2190,32,32
3,1.5,1100,33600,1,0,0,3,7,1100,0,47.3185,-122.29,1570,32700,34700,34270,1100,52,52
2,1,840,6480,1,0,0,4,5,840,0,47.264,-122.258,1100,7300,7320,8400,840,65,65
4,1,1220,8075,1,0,0,2,7,890,330,47.3341,-122.282,1290,7800,9295,9090,1220,50,50
1,2,1150,9812,1,0,0,4,7,1150,0,47.2951,-122.284,1200,9812,10962,11012,1150,57,57
4,2.5,2632,4117,2,0,0,3,8,2632,0,47.3428,-122.278,2040,5195,6749,7235,2632,6,6
3,1,1310,9612,1,0,0,3,7,960,350,47.2958,-122.285,1310,9812,10922,11122,1310,57,57
3,2,1050,18304,1,0,0,4,7,1050,0,47.3206,-122.269,1690,15675,19354,17365,1050,66,66
2,1.75,1894,52769,1,0,0,4,6,1520,374,47.3088,-122.273,1820,50529,54663,52349,1894,83,83
3,2.5,1930,4000,2,0,0,3,8,1930,0,47.3518,-122.275,2050,4000,5930,6050,1930,5,5
4,2.5,1767,4500,2,0,0,3,8,1767,0,47.2607,-122.25,1949,4636,6267,6585,1767,13,13
4,1.75,1300,21000,1,0,0,4,7,1300,0,47.3067,-122.285,2120,9920,22300,12040,1300,50,50
4,2.5,1700,4268,2,0,0,3,7,1700,0,47.3303,-122.268,1700,4488,5968,6188,1700,19,19
4,2.25,1500,5393,2,0,0,3,7,1500,0,47.3378,-122.262,1500,5952,6893,7452,1500,20,20
3,1,980,9135,1,0,0,3,7,980,0,47.3496,-122.289,1780,9135,10115,10915,980,64,64
4,2.25,1500,5393,2,0,0,3,7,1500,0,47.3378,-122.263,1700,5917,6893,7617,1500,20,20
3,2.5,1940,10350,1,0,0,3,7,1420,520,47.3385,-122.256,1810,7800,12290,9610,1940,40,40
3,2,1380,7476,1,0,0,3,7,1380,0,47.3336,-122.272,1600,7227,8856,8827,1380,30,30
3,1.75,1290,8250,1,0,0,3,7,1290,0,47.3353,-122.27,1410,7823,9540,9233,1290,36,36
3,2,2250,7904,1,0,0,3,8,2250,0,47.3165,-122.252,2460,8622,10154,11082,2250,21,21
3,2,1440,10111,1,0,0,3,7,1440,0,47.345,-122.283,1580,10200,11551,11780,1440,56,56
3,1.75,1380,14000,1,0,0,4,5,1380,0,47.294,-122.281,1490,18503,15380,19993,1380,80,57
4,2.75,1560,8820,1,0,3,3,7,1060,500,47.3382,-122.257,2140,7800,10380,9940,1560,40,40
3,1.75,1880,30346,1,0,0,3,8,1880,0,47.3515,-122.291,2260,5883,32226,8143,1880,31,31
3,2,1050,18304,1,0,0,4,7,1050,0,47.3206,-122.269,1690,15675,19354,17365,1050,66,66
3,2.25,2520,78408,2,0,0,3,9,2520,0,47.3514,-122.279,1490,29972,80928,31462,2520,31,31
3,1,1250,7820,1,0,0,3,7,1250,0,47.3397,-122.291,1300,7920,9070,9220,1250,52,52
3,2.5,1720,6847,2,0,0,3,7,1720,0,47.3266,-122.272,1610,7790,8567,9400,1720,32,32
2,1,1780,81021,1,0,3,4,9,1780,0,47.2712,-122.265,1780,26723,82801,28503,1780,65,65
3,1.75,1780,35233,1,0,0,4,8,1420,360,47.2949,-122.269,1950,17334,37013,19284,1780,40,40
3,1,1310,9554,1,0,0,3,7,960,350,47.2949,-122.285,1310,9845,10864,11155,1310,57,57
4,2.5,2650,9301,2,0,0,3,9,2650,0,47.3477,-122.271,2730,8688,11951,11418,2650,18,18
3,1,1730,7210,1,0,0,3,7,1430,300,47.3404,-122.28,1820,7210,8940,9030,1730,56,56
3,2,1510,9153,1,0,0,4,7,1510,0,47.3412,-122.273,1780,9286,10663,11066,1510,45,45
3,2,1760,9282,1,0,0,5,7,1100,660,47.3413,-122.29,1730,7500,11042,9230,1760,72,72
3,1.75,1450,12125,1,0,0,4,7,1450,0,47.3575,-122.28,1210,12125,13575,13335,1450,38,38
3,1.75,1910,17003,1,0,0,4,8,1910,0,47.3095,-122.283,1820,14806,18913,16626,1910,56,56
4,3,2050,4000,2,0,0,3,8,2050,0,47.3523,-122.275,2050,4000,6050,6050,2050,5,5
3,1,1370,10708,1,0,0,3,7,1370,0,47.2769,-122.264,1770,14482,12078,16252,1370,50,50
3,2,1410,10248,1,0,0,3,7,1410,0,47.3315,-122.265,2090,9414,11658,11504,1410,34,34
4,3.5,2796,3520,2,0,0,3,8,2796,0,47.3427,-122.278,2040,5195,6316,7235,2796,6,6
4,2.5,2163,5882,2,0,0,3,7,2163,0,47.2736,-122.251,1760,9600,8045,11360,2163,13,13
3,1.5,1810,14400,1,0,0,4,7,1810,0,47.2887,-122.269,1710,12000,16210,13710,1810,65,65
3,2,1824,7120,1,0,0,3,9,1824,0,47.3457,-122.27,2409,6264,8944,8673,1824,9,9
4,2.5,3118,7866,2,0,2,3,9,3118,0,47.2931,-122.264,2673,6500,10984,9173,3118,5,5
4,2.5,1840,13493,2,0,0,3,7,1840,0,47.2649,-122.242,1430,11463,15333,12893,1840,25,25
3,1.75,2170,10018,1,0,0,4,7,1630,540,47.3087,-122.264,2049,15263,12188,17312,2170,41,41
3,1.5,1560,7300,1,0,0,4,7,1040,520,47.3427,-122.281,1460,7910,8860,9370,1560,55,55
4,2.5,2390,7056,2,0,0,3,9,2390,0,47.3385,-122.264,2590,7801,9446,10391,2390,29,29
4,2.5,2575,4725,2,0,0,3,8,2575,0,47.3058,-122.277,2575,5323,7300,7898,2575,8,8
2,1.5,1320,73600,1,0,0,3,7,1320,0,47.2755,-122.271,1320,33600,74920,34920,1320,26,26
3,2.5,2280,7417,2,0,0,3,8,2280,0,47.3557,-122.278,2370,6443,9697,8813,2280,21,21
4,2.5,1820,8217,1,0,0,3,7,1120,700,47.263,-122.242,1310,8217,10037,9527,1820,32,32
3,2,2030,24829,1,0,0,4,7,1220,810,47.2718,-122.291,1980,15204,26859,17184,2030,40,40
4,2.75,2240,7200,1,0,0,3,7,1140,1100,47.3357,-122.275,1580,7416,9440,8996,2240,52,52
3,2,1730,12821,1,0,0,3,8,1730,0,47.353,-122.272,1980,11336,14551,13316,1730,25,25
6,1.5,2140,36509,1,0,0,4,8,2140,0,47.2668,-122.252,1710,12000,38649,13710,2140,116,35
4,1.5,1550,19800,1,0,0,4,7,1050,500,47.3117,-122.27,1640,22654,21350,24294,1550,50,50
4,2.5,2480,8626,2,0,0,3,10,2480,0,47.3185,-122.262,2990,9033,11106,12023,2480,18,18
4,2,2370,76665,2,0,0,4,8,2370,0,47.2831,-122.279,2110,19334,79035,21444,2370,41,41
4,1.75,1880,9600,1,0,0,5,7,1020,860,47.2633,-122.281,1560,14400,11480,15960,1880,73,73
2,1,1960,186872,1,0,0,4,6,1960,0,47.2681,-122.267,1650,19200,188832,20850,1960,83,83
4,2.5,2846,85377,1,0,0,3,8,1976,870,47.317,-122.281,1696,57934,88223,59630,2846,19,19
2,1.75,1220,15600,1,0,0,3,6,1220,0,47.2853,-122.265,1510,17818,16820,19328,1220,47,47
3,1.75,1230,13056,1,0,0,4,7,1230,0,47.3171,-122.279,1690,15750,14286,17440,1230,57,57
0,0,844,4269,1,0,0,4,7,844,0,47.2781,-122.25,1380,9600,5113,10980,844,106,106
3,1,990,7420,1,0,0,5,6,990,0,47.2898,-122.221,1010,7420,8410,8430,990,59,59
6,3,2400,9373,2,0,0,3,7,2400,0,47.3262,-122.214,2060,7316,11773,9376,2400,28,28
6,3,2400,9373,2,0,0,3,7,2400,0,47.3262,-122.214,2060,7316,11773,9376,2400,28,28
3,2,1490,7929,1,0,0,3,7,1490,0,47.2875,-122.218,1650,7929,9419,9579,1490,30,30
4,2.75,1990,7252,1,0,0,3,7,1270,720,47.2839,-122.202,2100,7535,9242,9635,1990,20,20
3,2.25,1584,2800,2,0,0,3,7,1584,0,47.3454,-122.214,1584,2800,4384,4384,1584,7,7
3,2,1470,20000,1,0,0,4,7,1470,0,47.2973,-122.08,1390,30056,21470,31446,1470,51,51
3,1.5,1070,6601,1,0,0,3,6,1070,0,47.3115,-122.209,1030,6614,7671,7644,1070,34,34
4,1.75,1500,12560,1,0,0,4,7,1000,500,47.2918,-122.197,1700,9020,14060,10720,1500,42,42
3,1,1010,8800,1,0,0,4,7,1010,0,47.2761,-122.208,1550,7700,9810,9250,1010,51,51
4,3,2300,7609,2,0,0,4,7,2300,0,47.2943,-122.227,940,5937,9909,6877,2300,43,43
5,2,2250,5472,1,0,0,5,7,1750,500,47.3065,-122.219,1540,5472,7722,7012,2250,89,89
6,3,2744,9926,2,0,0,3,7,2744,0,47.2773,-122.216,2470,9926,12670,12396,2744,13,13
3,1,990,7520,1,0,0,4,7,990,0,47.285,-122.207,990,7440,8510,8430,990,61,61
3,2,1850,8250,1,0,0,4,7,1150,700,47.3066,-122.209,1580,7153,10100,8733,1850,67,67
3,2.25,1481,2820,2,0,0,3,7,1481,0,47.3457,-122.217,1481,3028,4301,4509,1481,7,7
2,1,1000,4179,1,0,0,5,5,1000,0,47.297,-122.227,1010,6327,5179,7337,1000,105,105
3,1.5,1280,4366,2,0,0,4,6,1280,0,47.335,-122.215,1280,4366,5646,5646,1280,34,34
3,1,990,10800,1,0,0,4,6,990,0,47.293,-122.215,1060,10364,11790,11424,990,60,60
4,2.75,2475,4000,2,0,0,3,7,2475,0,47.3452,-122.209,2475,4000,6475,6475,2475,5,5
3,1,900,8100,1,0,0,4,6,900,0,47.2866,-122.221,1000,7830,9000,8830,900,60,60
5,1.75,2030,10200,1,0,0,4,7,2030,0,47.2867,-122.209,1760,11550,12230,13310,2030,61,61
3,1,1010,8581,1,0,0,4,6,1010,0,47.3043,-122.216,1060,10354,9591,11414,1010,99,99
3,2,1640,5280,1,0,0,5,6,1640,0,47.3089,-122.213,1160,7875,6920,9035,1640,109,109
4,1,1230,8636,1,0,0,4,6,1230,0,47.3231,-122.219,1168,8316,9866,9484,1230,65,65
3,1,1510,8760,1,0,0,4,6,1510,0,47.3015,-122.216,1040,7828,10270,8868,1510,73,73
3,1.75,1330,6301,1,0,0,3,7,1330,0,47.3411,-122.219,1330,6144,7631,7474,1330,21,21
4,2,2460,5921,1,0,0,4,7,1230,1230,47.308,-122.209,1260,6648,8381,7908,2460,71,71
3,2,1540,8316,1,0,0,5,6,1540,0,47.323,-122.216,1250,8316,9856,9566,1540,65,65
3,1,1230,6000,1,0,0,4,7,1230,0,47.3256,-122.209,1240,6000,7230,7240,1230,52,52
3,1.75,1930,7267,1,0,0,4,7,1330,600,47.3217,-122.205,1600,7698,9197,9298,1930,42,42
4,3,2390,7309,2,0,0,4,7,2390,0,47.294,-122.218,930,7308,9699,8238,2390,75,33
3,1,1150,4800,1,0,0,4,6,1150,0,47.3101,-122.212,1310,9510,5950,10820,1150,81,81
3,2.25,2120,13090,1,0,0,3,8,2120,0,47.296,-122.219,1400,12039,15210,13439,2120,22,22
4,1.75,1700,6000,1,0,0,3,7,1700,0,47.3252,-122.208,1280,6000,7700,7280,1700,52,52
4,2.75,2475,4000,2,0,0,3,7,2475,0,47.345,-122.209,2475,4000,6475,6475,2475,5,5
3,2.5,2099,4275,2,0,0,3,7,2099,0,47.3521,-122.211,2099,4275,6374,6374,2099,9,9
5,1.75,1970,8925,1,0,0,5,7,1170,800,47.2925,-122.196,1910,8025,10895,9935,1970,42,42
3,2.25,1640,6044,2,0,0,3,7,1640,0,47.2844,-122.205,1600,7418,7684,9018,1640,23,23
4,2.25,2460,11250,1,0,0,4,8,2460,0,47.3182,-122.212,1630,10216,13710,11846,2460,60,60
3,1,920,7314,1,0,0,3,6,920,0,47.2892,-122.22,1010,7420,8234,8430,920,59,59
1,1,1080,3230,1,0,0,3,6,1080,0,47.3075,-122.217,1210,5760,4310,6970,1080,56,56
5,1.75,2140,12058,1,0,0,4,8,2140,0,47.3167,-122.214,1640,10125,14198,11765,2140,68,68
5,2.5,2630,8470,1,0,0,4,8,2630,0,47.2863,-122.196,1780,8575,11100,10355,2630,51,51
4,2.5,1788,10183,2,0,0,4,7,1788,0,47.2883,-122.218,1700,6600,11971,8300,1788,29,29
3,1,920,7314,1,0,0,3,6,920,0,47.2892,-122.22,1010,7420,8234,8430,920,59,59
3,1.75,1310,7314,1,0,0,5,6,1310,0,47.2888,-122.221,1010,7314,8624,8324,1310,59,59
4,2.75,2420,8700,1,0,0,4,7,2420,0,47.3109,-122.229,1070,4804,11120,5874,2420,105,105
4,2.75,2475,4000,2,0,0,3,7,2475,0,47.3452,-122.21,2166,4000,6475,6166,2475,5,5
3,1.5,1280,4031,2,0,0,4,6,1280,0,47.3342,-122.215,1150,4500,5311,5650,1280,34,34
2,1,720,4120,1,0,0,5,5,720,0,47.303,-122.217,940,6180,4840,7120,720,104,104
3,1,1200,8316,1,0,0,4,6,1200,0,47.3231,-122.215,1250,8316,9516,9566,1200,66,66
3,1,960,7314,1,0,0,5,6,960,0,47.2891,-122.221,990,7314,8274,8304,960,59,59
3,2.5,1340,4200,2,0,0,3,7,1340,0,47.2942,-122.226,990,4520,5540,5510,1340,17,17
3,2.5,1890,6088,2,0,0,3,7,1890,0,47.2886,-122.218,1700,6600,7978,8300,1890,23,23
4,1.75,1420,10300,2,0,0,3,7,1420,0,47.3121,-122.215,1420,10300,11720,11720,1420,69,14
3,2.5,1720,8550,1,0,0,4,7,1720,0,47.2837,-122.207,1460,8550,10270,10010,1720,51,51
3,1.75,1590,7810,1,0,0,4,7,1590,0,47.2932,-122.22,1470,7810,9400,9280,1590,60,60
4,1,1600,10183,1,0,0,4,6,1600,0,47.277,-122.211,1410,10416,11783,11826,1600,53,53
3,2.5,2095,3438,2,0,0,3,7,2095,0,47.3523,-122.213,1805,3402,5533,5207,2095,11,11
3,2.25,1560,9706,1,0,0,4,7,1560,0,47.3191,-122.213,1510,9706,11266,11216,1560,56,56
4,3,1680,6003,1,0,0,3,7,1150,530,47.2885,-122.218,1820,6207,7683,8027,1680,22,22
3,1,1220,6000,1,0,0,5,7,1220,0,47.2811,-122.214,1420,13137,7220,14557,1220,58,58
3,1.5,1580,10517,1,0,0,4,6,1580,0,47.2903,-122.214,1400,10658,12097,12058,1580,62,62
6,2.75,3240,5750,1,0,0,4,6,2160,1080,47.3054,-122.221,1230,5750,8990,6980,3240,69,69
2,1.75,1590,11276,1,0,0,4,7,1590,0,47.3177,-122.21,1750,10687,12866,12437,1590,47,47
4,2.5,1710,3500,2,0,0,3,7,1710,0,47.3448,-122.217,1710,3500,5210,5210,1710,5,5
2,1.5,1440,11954,1,0,0,4,8,1440,0,47.2909,-122.219,1460,9730,13394,11190,1440,41,41
3,1,960,10761,1,0,0,4,6,960,0,47.2819,-122.224,960,10761,11721,11721,960,57,57
4,1.5,1920,11595,1,0,0,4,7,1920,0,47.2858,-122.212,1400,10550,13515,11950,1920,57,57
3,1.75,2190,6000,1,0,0,4,7,2190,0,47.3063,-122.223,1610,6000,8190,7610,2190,99,99
3,1.5,1200,7800,1,0,0,4,7,1200,0,47.3137,-122.212,1390,8415,9000,9805,1200,61,61
4,1.75,1900,10588,1,0,0,5,6,1900,0,47.289,-122.212,1530,10587,12488,12117,1900,61,61
3,1,1020,6120,1,0,0,4,7,1020,0,47.278,-122.205,1370,8000,7140,9370,1020,52,52
4,1,1320,11212,1,0,0,5,6,1320,0,47.3098,-122.209,1060,6766,12532,7826,1320,105,105
4,1.5,1570,6717,1,0,0,5,6,1570,0,47.307,-122.217,1140,6716,8287,7856,1570,108,108
3,2.5,2070,8400,2,0,0,4,8,2070,0,47.3099,-122.206,2070,9239,10470,11309,2070,29,29
3,2,1200,6074,1,0,0,3,7,1200,0,47.325,-122.205,1430,6338,7274,7768,1200,51,51
6,5,2732,7655,2,0,0,3,7,2732,0,47.3045,-122.211,3078,69993,10387,73071,2732,10,10
3,1.75,1550,6225,1,0,0,4,7,1550,0,47.3098,-122.218,1760,9496,7775,11256,1550,70,70
3,1.75,1320,10454,1,0,0,4,7,1320,0,47.2844,-122.216,1680,10183,11774,11863,1320,51,51
4,1.5,1600,9289,1,0,0,4,7,1600,0,47.3107,-122.212,1540,9918,10889,11458,1600,60,60
4,2.5,2730,4962,2,0,0,3,8,2730,0,47.3363,-122.216,2150,3802,7692,5952,2730,13,13
4,2,1700,6025,1,0,0,3,6,1700,0,47.3029,-122.221,1320,5956,7725,7276,1700,41,41
3,1.75,1760,12823,1,0,0,4,7,1460,300,47.2868,-122.21,1450,10800,14583,12250,1760,63,63
4,3,1984,4460,2,0,0,3,7,1984,0,47.3532,-122.211,2095,3402,6444,5497,1984,7,7
6,5.25,2860,5682,2,0,0,3,7,2860,0,47.303,-122.221,1390,5956,8542,7346,2860,41,41
3,1.75,1160,6134,1,0,0,3,7,1160,0,47.3414,-122.218,1330,6301,7294,7631,1160,21,21
3,2.5,1852,4000,2,0,0,3,7,1852,0,47.3455,-122.21,2166,4000,5852,6166,1852,5,5
3,2.25,1230,7420,1,0,0,5,7,1230,0,47.3184,-122.22,1260,7556,8650,8816,1230,106,106
3,2.5,1550,3569,2,0,0,3,7,1550,0,47.3528,-122.211,2095,3402,5119,5497,1550,8,8
3,1.75,1770,8868,1,0,0,4,7,1770,0,47.3188,-122.212,1630,9706,10638,11336,1770,60,60
2,1,920,5889,1,0,0,4,6,920,0,47.3012,-122.218,1210,6180,6809,7390,920,69,69
3,2.5,1550,3402,2,0,0,3,7,1550,0,47.3523,-122.212,2095,3402,4952,5497,1550,10,10
4,3,2210,4191,2,0,0,3,7,2210,0,47.2959,-122.225,890,4288,6401,5178,2210,15,15
2,1,780,6685,1,0,0,4,5,780,0,47.305,-122.215,880,6695,7465,7575,780,71,71
6,4.5,3560,14010,2,0,0,3,7,3560,0,47.3244,-122.217,1710,11116,17570,12826,3560,30,30
3,1.5,1910,10583,1,0,0,4,7,1910,0,47.2782,-122.212,1770,9068,12493,10838,1910,97,47
3,2.25,1489,2800,2,0,0,3,7,1489,0,47.3452,-122.215,1584,3200,4289,4784,1489,8,8
2,1.75,1280,6774,1,0,0,3,7,1280,0,47.2925,-122.219,1450,7810,8054,9260,1280,28,28
4,2.25,2550,9736,1,0,0,4,8,2550,0,47.3193,-122.212,1770,9686,12286,11456,2550,52,52
4,1.75,1650,6900,1,0,0,3,7,910,740,47.2802,-122.211,1540,7645,8550,9185,1650,41,21
4,1.5,2010,7561,1,0,0,4,7,1890,120,47.311,-122.227,1420,6564,9571,7984,2010,98,98
4,2.25,2050,12581,2,0,0,4,7,2050,0,47.3215,-122.204,1620,7400,14631,9020,2050,41,41
4,2.75,2475,4276,2,0,0,3,7,2475,0,47.345,-122.21,2475,4000,6751,6475,2475,5,5
3,1,1200,8316,1,0,0,4,6,1200,0,47.3221,-122.215,1200,8316,9516,9516,1200,66,66
3,2.5,1489,3266,2,0,0,3,7,1489,0,47.3452,-122.217,1537,3273,4755,4810,1489,5,5
3,2.5,1852,4000,2,0,0,3,7,1852,0,47.3451,-122.209,2475,4000,5852,6475,1852,5,5
3,2.25,1584,2800,2,0,0,3,7,1584,0,47.3451,-122.214,1584,2800,4384,4384,1584,7,7
3,1.5,1180,7300,1,0,0,4,7,1180,0,47.2857,-122.197,2030,8424,8480,10454,1180,51,51
3,2.5,2437,5136,2,0,0,3,7,2437,0,47.3517,-122.21,2437,4614,7573,7051,2437,8,8
3,1,1090,6710,1,0,0,5,5,1090,0,47.3066,-122.217,1170,6708,7800,7878,1090,107,107
6,2,2220,8797,1,0,0,3,7,2220,0,47.2977,-122.227,1170,5123,11017,6293,2220,42,42
1,0.75,760,5746,1,0,0,4,5,760,0,47.3046,-122.215,970,6696,6506,7666,760,104,104
3,1,920,7276,1,0,0,4,6,920,0,47.285,-122.211,1120,7276,8196,8396,920,58,58
2,1,1200,9850,1,0,0,4,7,1200,0,47.3089,-122.21,1060,5095,11050,6155,1200,98,98
3,1,1300,8316,1,0,0,4,6,1300,0,47.3221,-122.216,1260,8316,9616,9576,1300,65,65
3,1.5,1280,5547,2,0,0,4,6,1280,0,47.3344,-122.215,1150,4500,6827,5650,1280,34,34
3,1.75,1600,7711,1,0,0,3,7,1600,0,47.284,-122.202,2100,7711,9311,9811,1600,20,20
1,1,690,6825,1,0,0,4,5,690,0,47.3109,-122.225,1330,5381,7515,6711,690,102,102
3,1,1380,7282,1,0,0,5,6,1380,0,47.3006,-122.223,860,4826,8662,5686,1380,104,104
4,2,1440,6702,1,0,0,4,7,1440,0,47.3056,-122.217,1030,6702,8142,7732,1440,53,53
3,1.75,1200,9266,1,0,0,4,7,1200,0,47.314,-122.208,1200,9266,10466,10466,1200,59,59
4,2.25,2400,17842,2,0,0,4,7,2400,0,47.2866,-122.217,1610,12100,20242,13710,2400,46,46
2,1,1600,8961,1,0,0,4,7,1390,210,47.3098,-122.21,1502,6798,10561,8300,1600,70,70
3,2,1680,7000,1,0,0,4,7,1680,0,47.2775,-122.203,1540,7480,8680,9020,1680,51,51
3,1.75,2090,12026,1,0,0,4,7,2090,0,47.3095,-122.217,1700,9496,14116,11196,2090,71,71
3,1,1260,7265,1,0,0,4,7,1260,0,47.2979,-122.224,940,7200,8525,8140,1260,65,65
3,1,990,9599,1,0,0,4,6,990,0,47.2934,-122.215,1216,10364,10589,11580,990,60,60
3,2.25,1640,4420,2,0,0,4,7,1640,0,47.311,-122.21,1230,6632,6060,7862,1640,101,31
3,1,1180,8775,1,0,0,3,7,1180,0,47.2848,-122.223,1300,8100,9955,9400,1180,53,53
4,2,1960,16015,1,0,0,3,7,1960,0,47.33,-122.22,1960,16015,17975,17975,1960,39,39
3,2.25,1930,8192,1,0,0,3,7,1470,460,47.2624,-122.299,1510,8192,10122,9702,1930,35,35
6,3,2180,7220,2,0,0,3,7,2180,0,47.3046,-122.305,2260,7344,9400,9604,2180,39,39
3,2.25,2510,12013,2,0,0,3,8,2510,0,47.3473,-122.314,1870,8017,14523,9887,2510,31,31
2,2.5,1240,2689,2,0,0,3,7,1240,0,47.3236,-122.323,1430,3609,3929,5039,1240,33,33
4,2.75,2500,12848,1,0,1,3,8,2120,380,47.3364,-122.321,2370,12497,15348,14867,2500,44,44
3,2.5,2420,36862,1,0,0,4,8,1530,890,47.3264,-122.308,1670,9046,39282,10716,2420,62,62
3,1,1440,11925,1,0,0,3,7,1440,0,47.2738,-122.3,1440,10425,13365,11865,1440,51,51
3,2.25,1550,6022,2,0,0,3,8,1550,0,47.3525,-122.304,1650,5627,7572,7277,1550,30,30
4,2.5,2990,9614,1,0,2,4,9,1740,1250,47.3424,-122.329,3370,12085,12604,15455,2990,43,43
4,2.5,2910,8596,2,0,0,3,8,2910,0,47.2596,-122.304,2770,8602,11506,11372,2910,15,15
3,1,970,7790,1,0,0,3,6,970,0,47.3165,-122.325,1150,8160,8760,9310,970,52,52
4,3.5,2770,8763,2,0,0,3,8,2100,670,47.2625,-122.308,2030,7242,11533,9272,2770,23,23
5,3,2100,9752,1,0,0,3,8,1200,900,47.3341,-122.304,1270,10200,11852,11470,2100,12,12
3,1.75,1380,8400,1,0,0,3,7,1380,0,47.3117,-122.321,1540,8400,9780,9940,1380,52,52
4,2.5,2360,9647,1,0,2,3,8,1530,830,47.3367,-122.332,2580,9680,12007,12260,2360,55,55
3,1.5,1380,7600,1,0,0,4,7,790,590,47.3489,-122.306,1570,7904,8980,9474,1380,48,48
3,1.75,1350,10125,1,0,0,3,8,1350,0,47.3334,-122.298,1520,9720,11475,11240,1350,52,52
4,2,1760,8400,1,0,0,3,7,1060,700,47.3258,-122.323,1280,8415,10160,9695,1760,57,57
3,3,2430,10500,1,0,0,4,8,2150,280,47.2579,-122.312,1670,9800,12930,11470,2430,36,36
3,2.25,1790,6930,1,0,0,3,7,1390,400,47.3536,-122.317,1810,7420,8720,9230,1790,45,45
3,1,910,11117,1,0,0,3,7,910,0,47.3432,-122.309,1490,8416,12027,9906,910,64,64
3,2.5,1510,10875,1,0,0,3,7,1150,360,47.3482,-122.3,1810,9916,12385,11726,1510,29,29
3,2,1450,9333,2,0,0,4,7,1450,0,47.346,-122.315,1910,7701,10783,9611,1450,47,47
3,2.5,1710,7230,2,0,0,3,7,1710,0,47.2778,-122.298,1720,6537,8940,8257,1710,23,23
5,2.5,2340,13713,1,0,0,2,8,1670,670,47.3307,-122.324,2080,11000,16053,13080,2340,52,52
3,2.5,2870,25663,2,0,0,3,10,2870,0,47.2769,-122.333,2950,24347,28533,27297,2870,31,31
3,1.75,1280,10016,1,0,0,4,7,1280,0,47.2823,-122.333,1670,9764,11296,11434,1280,44,44
3,1.5,1510,11200,1,0,0,4,8,1510,0,47.3347,-122.325,2110,12070,12710,14180,1510,59,59
3,1.5,1060,9225,1,0,0,4,7,1060,0,47.3217,-122.318,1270,9375,10285,10645,1060,64,64
4,2.5,2650,10459,2,0,0,4,8,2650,0,47.2739,-122.293,2340,8777,13109,11117,2650,30,30
2,1.75,1250,34395,1,0,0,4,7,1250,0,47.2802,-122.316,1910,26042,35645,27952,1250,69,69
4,2.25,1990,7350,1,0,0,4,8,1180,810,47.3258,-122.328,2030,7210,9340,9240,1990,41,41
2,2.5,1240,3649,2,0,0,3,7,1240,0,47.3241,-122.322,1400,3721,4889,5121,1240,33,33
4,2.5,3181,5831,2,0,0,3,8,3181,0,47.2716,-122.297,2056,24393,9012,26449,3181,5,5
2,1.75,2040,8600,1,0,0,4,6,1430,610,47.2755,-122.308,1310,7859,10640,9169,2040,34,34
3,2,2160,8091,1,0,0,3,8,2160,0,47.3474,-122.303,2190,8297,10251,10487,2160,19,19
3,2.5,1610,10022,2,0,0,3,7,1610,0,47.2583,-122.3,1820,10017,11632,11837,1610,23,23
3,2.5,2050,7205,2,0,0,3,8,2050,0,47.3487,-122.304,2050,7264,9255,9314,2050,19,19
4,2.5,2990,6145,2,0,0,3,8,2990,0,47.2612,-122.294,2590,6512,9135,9102,2990,16,16
3,2.5,2090,7163,2,0,0,3,8,2090,0,47.2735,-122.295,2320,8634,9253,10954,2090,30,30
2,1,990,8760,1,0,0,3,7,990,0,47.3302,-122.305,1560,11880,9750,13440,990,42,42
3,2.5,1730,6930,2,0,0,3,8,1730,0,47.2621,-122.308,1780,6930,8660,8710,1730,25,25
4,2.5,2770,19116,1,0,0,4,8,1600,1170,47.3386,-122.319,2730,18429,21886,21159,2770,58,58
5,2.5,2820,6305,2,0,0,3,8,2820,0,47.2616,-122.296,2610,6306,9125,8916,2820,16,16
3,1,910,10575,1,0,0,4,7,910,0,47.2741,-122.301,1470,10425,11485,11895,910,51,51
3,1.5,1490,7800,1,0,0,3,7,1010,480,47.3431,-122.304,1570,7800,9290,9370,1490,56,56
3,1,1370,56628,1,0,0,3,7,1370,0,47.3058,-122.306,1768,8702,57998,10470,1370,77,77
2,2,1470,2052,1,0,0,3,7,1470,0,47.3086,-122.328,1470,2052,3522,3522,1470,33,33
1,2.25,2060,10600,1,0,0,3,7,1560,500,47.3291,-122.304,2060,11880,12660,13940,2060,92,31
3,2,1460,7526,1,0,0,3,7,1460,0,47.3463,-122.304,1580,7526,8986,9106,1460,51,51
3,1.75,1090,7647,1,0,0,3,7,1090,0,47.2613,-122.302,1660,9219,8737,10879,1090,25,25
3,2.25,1650,7739,1,0,0,3,8,1290,360,47.3532,-122.304,1650,6033,9389,7683,1650,33,33
3,1,1690,7700,1,0,0,4,7,1690,0,47.3444,-122.304,1590,7700,9390,9290,1690,50,50
3,2,2210,6387,1,0,0,3,8,2210,0,47.265,-122.302,2570,6497,8597,9067,2210,16,16
3,2.25,1620,7772,2,0,0,4,8,1620,0,47.3521,-122.302,1710,6455,9392,8165,1620,31,31
3,1.5,1400,9600,1,0,0,4,7,1400,0,47.2878,-122.297,2210,15000,11000,17210,1400,55,55
4,2.5,2530,8169,2,0,0,3,8,2530,0,47.2634,-122.312,2220,8013,10699,10233,2530,26,26
3,2.75,1780,15114,1,0,0,3,7,1080,700,47.258,-122.305,1792,10155,16894,11947,1780,39,39
4,3,3080,9601,2,0,1,3,10,3080,0,47.334,-122.332,3200,9375,12681,12575,3080,29,29
3,2.5,1970,8426,2,0,0,3,8,1970,0,47.2674,-122.306,1970,9197,10396,11167,1970,27,27
3,1.75,1300,9856,1,0,0,4,7,1300,0,47.3448,-122.298,1400,9600,11156,11000,1300,57,57
3,1.75,1400,9546,1,0,0,4,7,1400,0,47.3179,-122.331,1660,8550,10946,10210,1400,35,35
2,2,1260,10200,1,0,0,3,7,1020,240,47.2593,-122.312,1560,10200,11460,11760,1260,36,36
4,2.5,2800,9538,2,0,0,3,8,2800,0,47.2675,-122.307,1970,7750,12338,9720,2800,26,26
3,2,1560,9635,1,0,0,3,7,1260,300,47.341,-122.309,1570,8276,11195,9846,1560,53,53
3,2.5,2040,15463,1,0,0,3,8,1340,700,47.3334,-122.322,2370,12672,17503,15042,2040,51,51
4,2.5,1720,8638,2,0,0,3,8,1720,0,47.2704,-122.313,1870,7455,10358,9325,1720,25,25
5,2.5,5067,13315,1,0,2,3,9,3154,1913,47.3391,-122.325,2860,13957,18382,16817,5067,51,51
3,2.25,2510,12013,2,0,0,3,8,2510,0,47.3473,-122.314,1870,8017,14523,9887,2510,31,31
3,2.25,1765,7652,2,0,0,3,7,1765,0,47.3072,-122.328,1765,7719,9417,9484,1765,23,23
3,2,1970,9600,1,0,0,4,7,1300,670,47.2824,-122.301,1710,7703,11570,9413,1970,52,52
2,1,760,7272,1,0,0,4,7,760,0,47.3205,-122.33,1370,7866,8032,9236,760,39,39
3,1.75,1580,8820,1,0,0,4,7,1580,0,47.317,-122.325,1280,8500,10400,9780,1580,52,52
3,1,1000,10560,1,0,0,3,7,1000,0,47.3217,-122.317,1190,9375,11560,10565,1000,64,64
3,1,1300,8284,1,0,0,3,7,1300,0,47.3327,-122.306,1360,7848,9584,9208,1300,51,51
4,2,2300,8400,1,0,0,4,6,1150,1150,47.3282,-122.332,1230,8400,10700,9630,2300,57,57
3,1,970,7742,1,0,0,4,6,970,0,47.3173,-122.327,970,7650,8712,8620,970,52,52
4,2.75,2210,13235,2,0,0,3,8,1730,480,47.3541,-122.303,1750,7542,15445,9292,2210,31,31
3,1.75,1300,8976,1,0,0,3,7,1300,0,47.3357,-122.305,1430,9750,10276,11180,1300,52,52
4,2.5,1830,7762,2,0,0,3,8,1830,0,47.267,-122.31,2109,8966,9592,11075,1830,26,26
3,1,1660,11060,1,0,0,4,7,1110,550,47.3311,-122.326,1890,11060,12720,12950,1660,57,57
3,1,1040,8125,1,0,0,3,7,1040,0,47.3171,-122.316,1200,9375,9165,10575,1040,63,63
4,1.75,2000,7350,1,0,0,3,7,1100,900,47.3428,-122.303,1720,7350,9350,9070,2000,56,56
3,1,1300,9880,1,0,0,4,7,1300,0,47.3352,-122.297,2140,9600,11180,11740,1300,60,60
4,2.5,2250,3916,2,0,0,3,8,2250,0,47.3413,-122.18,2156,3920,6166,6076,2250,5,5
4,1,1730,7350,1,0,0,4,6,1730,0,47.3467,-122.307,1440,7752,9080,9192,1730,49,49
2,2,1390,1302,2,0,0,3,7,1390,0,47.3089,-122.33,1390,1302,2692,2692,1390,33,33
4,1.75,1730,7210,1,0,0,4,7,1010,720,47.354,-122.315,1620,7210,8940,8830,1730,51,51
4,2.5,2420,9147,2,0,0,3,10,2420,0,47.3221,-122.322,1400,7200,11567,8600,2420,21,21
3,2.25,1640,7350,1,0,0,3,7,1140,500,47.2625,-122.3,1480,8041,8990,9521,1640,35,35
3,1,1700,11390,1,0,0,4,7,1700,0,47.3271,-122.323,1350,8164,13090,9514,1700,52,52
3,1.5,1780,12231,1,0,0,4,8,1780,0,47.335,-122.321,2460,12663,14011,15123,1780,63,63
2,1,1050,9000,1,0,0,4,7,1050,0,47.2887,-122.299,1550,9600,10050,11150,1050,35,35
3,1,1180,8240,1,0,0,4,7,1180,0,47.3325,-122.321,1180,7840,9420,9020,1180,52,52
4,2.5,2340,9748,1,0,1,3,8,1610,730,47.3363,-122.331,2070,8241,12088,10311,2340,38,38
4,1,1130,7400,1,0,0,4,7,1130,0,47.3437,-122.316,1540,7379,8530,8919,1130,50,50
3,2,1710,7920,1,0,0,3,8,1260,450,47.3473,-122.305,1760,8120,9630,9880,1710,51,51
4,2.5,2070,7800,2,0,0,3,8,2070,0,47.3487,-122.315,1950,7815,9870,9765,2070,30,30
3,2,1610,7575,1,0,0,4,7,1110,500,47.334,-122.3,1920,8400,9185,10320,1610,54,54
3,2,1390,10155,1,0,0,3,7,1130,260,47.2575,-122.305,1790,10155,11545,11945,1390,39,39
4,2.5,3390,10519,2,0,2,3,10,3390,0,47.332,-122.334,2830,10519,13909,13349,3390,29,29
3,1,1250,9774,1,0,0,4,7,1250,0,47.3343,-122.306,1280,8850,11024,10130,1250,50,50
3,2.25,2140,9990,1,0,0,4,8,2140,0,47.3484,-122.298,2060,9990,12130,12050,2140,57,57
4,2.25,1890,7616,1,0,0,4,8,1260,630,47.3275,-122.329,1890,7420,9506,9310,1890,40,40
3,1.5,1890,7650,1,0,0,5,7,1890,0,47.3454,-122.314,1510,7560,9540,9070,1890,53,53
2,1,1300,11400,1,0,0,3,7,1300,0,47.3459,-122.299,1360,9750,12700,11110,1300,58,58
4,2.5,2320,7379,2,0,0,3,8,2320,0,47.3432,-122.316,2230,7614,9699,9844,2320,32,32
3,2.5,2320,7140,2,0,0,3,8,2320,0,47.275,-122.295,2360,7955,9460,10315,2320,29,29
3,2,1370,8137,1,0,0,4,7,1370,0,47.2802,-122.303,1660,8840,9507,10500,1370,31,31
3,2.25,3280,79279,1,0,0,3,10,3280,0,47.3207,-122.293,1860,24008,82559,25868,3280,18,18
4,2,2150,14161,1,0,2,3,8,1330,820,47.3376,-122.323,2310,14034,16311,16344,2150,53,53
3,2.25,1470,7518,1,0,0,3,7,1160,310,47.2725,-122.3,1720,8300,8988,10020,1470,34,34
4,2.5,2420,11481,1,0,0,3,8,1370,1050,47.341,-122.318,2290,8985,13901,11275,2420,34,34
4,1,1730,7350,1,0,0,4,6,1730,0,47.3467,-122.307,1440,7752,9080,9192,1730,49,49
3,2.5,2240,7565,2,0,0,3,8,2240,0,47.3485,-122.301,2190,8254,9805,10444,2240,20,20
3,2.75,2190,7258,2,0,0,3,8,2190,0,47.3486,-122.301,2190,8645,9448,10835,2190,19,19
3,2.25,1700,7210,1,0,0,4,7,1250,450,47.3546,-122.318,2070,7300,8910,9370,1700,45,45
3,1,1510,9100,1,0,0,3,7,1510,0,47.3331,-122.319,1180,7220,10610,8400,1510,53,53
3,2.5,2910,17172,2,0,0,3,10,2910,0,47.2789,-122.331,2910,20048,20082,22958,2910,30,30
3,1,960,10125,1,0,0,4,7,960,0,47.3335,-122.305,1250,9769,11085,11019,960,67,67
4,2.5,2382,5899,2,0,0,3,8,2382,0,47.2793,-122.295,2382,5897,8281,8279,2382,8,8
4,2.5,2410,7846,2,0,0,3,8,2410,0,47.2641,-122.312,2380,7914,10256,10294,2410,27,27
3,1.5,1010,10000,1,0,0,4,7,1010,0,47.2881,-122.294,2420,34637,11010,37057,1010,46,46
3,1.75,1140,10400,1,0,0,4,7,1140,0,47.2598,-122.311,1280,9800,11540,11080,1140,36,36
3,2.5,1660,5250,2,0,0,4,8,1660,0,47.3541,-122.3,1630,5505,6910,7135,1660,31,31
3,2.5,3410,13809,1,0,3,4,10,2450,960,47.3424,-122.326,3410,14245,17219,17655,3410,46,46
3,1.5,1820,10608,1,0,0,4,7,1820,0,47.3366,-122.306,1380,8976,12428,10356,1820,57,57
3,1.75,1620,12825,1,0,0,3,8,1340,280,47.3321,-122.323,2076,11200,14445,13276,1620,57,57
3,1.75,1240,7560,1,0,0,3,8,1070,170,47.333,-122.3,1650,7560,8800,9210,1240,52,52
6,3.25,4250,23326,1,0,3,3,10,2150,2100,47.34,-122.327,3370,15983,27576,19353,4250,52,52
3,2.5,1540,7280,1,0,0,3,7,1080,460,47.3102,-122.322,1220,6440,8820,7660,1540,45,45
3,1.75,1700,8481,2,0,0,3,7,1700,0,47.2623,-122.305,1830,6600,10181,8430,1700,26,26
3,1,1010,7245,1,0,0,3,7,1010,0,47.3338,-122.306,1300,8236,8255,9536,1010,50,50
3,1,1250,9035,1,0,0,4,7,1250,0,47.275,-122.302,1350,10425,10285,11775,1250,49,49
3,2.5,1800,9000,2,0,0,3,7,1800,0,47.3186,-122.331,1670,8486,10800,10156,1800,36,36
4,2.5,2680,11998,1,0,3,3,8,1510,1170,47.337,-122.321,2680,12746,14678,15426,2680,59,59
4,2.25,2120,9680,2,0,2,4,8,2120,0,47.3367,-122.332,2360,9647,11800,12007,2120,54,54
3,2.25,1960,8875,1,0,0,3,7,1290,670,47.3344,-122.301,1890,8700,10835,10590,1960,54,54
4,2.25,1870,6693,2,0,0,3,7,1870,0,47.2774,-122.299,1650,6518,8563,8168,1870,23,23
3,1.75,1320,17390,1,0,0,4,7,1320,0,47.3257,-122.296,1550,19265,18710,20815,1320,63,63
3,2.5,2000,7205,2,0,0,3,8,2000,0,47.3499,-122.302,2180,7611,9205,9791,2000,21,21
3,1,1090,8520,1,0,0,3,7,1090,0,47.3364,-122.307,1190,8520,9610,9710,1090,52,52
3,2.5,1730,8076,2,0,0,3,8,1730,0,47.2619,-122.308,1780,6930,9806,8710,1730,25,25
3,2,1460,7740,1,0,0,3,7,1460,0,47.3467,-122.306,1540,7644,9200,9184,1460,51,51
4,2.5,3362,8601,2,0,0,3,8,3362,0,47.2592,-122.304,2770,8601,11963,11371,3362,15,15
3,1,1010,12705,1,0,0,4,7,1010,0,47.3348,-122.303,1490,10200,13715,11690,1010,60,60
3,1,1260,7920,1,0,0,3,7,1260,0,47.3452,-122.308,1300,7920,9180,9220,1260,53,53
3,1.75,1580,6620,1,0,0,3,7,1580,0,47.2798,-122.303,1580,8137,8200,9717,1580,31,31
3,2,1030,11118,1,0,0,5,7,1030,0,47.3463,-122.308,1300,7920,12148,9220,1030,49,49
3,2.5,2029,3906,2,0,0,3,9,2029,0,47.341,-122.18,2029,3920,5935,5949,2029,5,5
4,2.75,2030,9120,1,0,0,4,7,2030,0,47.282,-122.303,1790,7627,11150,9417,2030,31,31
3,2.5,1760,7601,2,0,0,3,8,1760,0,47.2672,-122.313,1920,6851,9361,8771,1760,27,27
3,1.5,1460,11100,1,0,0,3,7,1460,0,47.3253,-122.298,1460,11100,12560,12560,1460,63,63
3,2.75,2300,8000,1,0,0,3,7,1430,870,47.3293,-122.306,2070,10200,10300,12270,2300,54,54
4,2,1580,8000,1,0,0,3,7,1040,540,47.3467,-122.304,1550,8000,9580,9550,1580,52,52
4,2.5,2370,10631,2,0,0,3,8,2370,0,47.3473,-122.302,2200,8297,13001,10497,2370,20,20
3,2,1840,6755,1,0,2,3,8,1840,0,47.3512,-122.305,1790,6459,8595,8249,1840,30,30
4,2,2020,7767,1,0,0,3,8,2020,0,47.3391,-122.309,1940,8239,9787,10179,2020,24,24
4,1.75,2020,7840,1,0,0,3,7,1010,1010,47.3309,-122.299,1750,8140,9860,9890,2020,51,51
3,1,1010,8848,1,0,0,4,7,1010,0,47.2742,-122.299,1380,10650,9858,12030,1010,51,51
4,2,1760,7700,1,0,0,4,7,1760,0,47.3299,-122.318,1870,7316,9460,9186,1760,57,57
3,2.5,2020,26670,2,0,0,3,7,2020,0,47.2597,-122.31,1680,10939,28690,12619,2020,32,32
3,1.5,970,8400,1,0,0,3,7,970,0,47.3284,-122.331,1230,8400,9370,9630,970,53,53
3,2.25,1590,7748,2,0,0,4,7,1590,0,47.2857,-122.3,1590,7606,9338,9196,1590,28,28
3,3,2390,8993,2,0,0,3,8,1680,710,47.3532,-122.306,1820,10362,11383,12182,2390,31,31
5,1.75,1680,8400,1,0,0,4,7,1680,0,47.3035,-122.307,1800,8550,10080,10350,1680,40,40
3,2.25,2070,7800,1,0,0,3,7,1170,900,47.3431,-122.305,1570,8400,9870,9970,2070,55,55
3,1.5,1660,8797,1,0,0,4,7,1660,0,47.5892,-122.202,2350,10053,10457,12403,1660,63,63
4,2.25,2920,20400,1,0,0,4,11,2920,0,47.6237,-122.228,3080,20400,23320,23480,2920,53,53
3,2.5,2100,4097,2,0,0,3,9,2100,0,47.5983,-122.2,1820,4764,6197,6584,2100,11,11
4,2.75,2750,17789,1,0,0,3,8,1980,770,47.6141,-122.212,3060,11275,20539,14335,2750,105,23
5,2.75,2580,7630,1,0,0,4,7,1730,850,47.6226,-122.205,2040,7717,10210,9757,2580,65,65
4,3.25,3070,10375,2,0,0,3,10,2180,890,47.5862,-122.198,2500,11194,13445,13694,3070,57,9
3,1.75,1630,9000,1,0,0,3,7,960,670,47.6023,-122.205,1880,9000,10630,10880,1630,64,64
3,1.5,1700,14133,1,0,1,4,8,1700,0,47.6166,-122.22,2630,17376,15833,20006,1700,65,65
4,2.75,4020,18745,2,0,4,4,10,2830,1190,47.6042,-122.21,3150,20897,22765,24047,4020,30,30
3,2.5,2850,10474,1,0,0,4,8,1730,1120,47.6218,-122.209,2820,10474,13324,13294,2850,65,65
3,1.75,1610,10796,1,0,0,3,7,1070,540,47.6272,-122.208,1940,10796,12406,12736,1610,68,68
3,1.5,1820,12686,1,0,0,4,7,1820,0,47.5886,-122.195,3020,11550,14506,14570,1820,67,67
4,2.25,1960,8680,1,0,0,4,8,1290,670,47.6076,-122.192,2160,8680,10640,10840,1960,60,60
5,4.5,10040,37325,2,1,2,3,11,7680,2360,47.65,-122.214,3930,25449,47365,29379,10040,79,13
4,3.75,3490,9170,2,0,0,3,9,3490,0,47.5991,-122.2,1810,8470,12660,10280,3490,7,7
10,5.25,4590,10920,1,0,2,3,9,2500,2090,47.5861,-122.113,2730,10400,15510,13130,4590,11,11
3,1,940,8377,1,0,0,4,7,940,0,47.5974,-122.2,1710,6900,9317,8610,940,67,67
3,2.5,2620,14248,2,0,0,4,8,1830,790,47.6281,-122.194,2620,12343,16868,14963,2620,42,42
4,2.5,2170,8680,1,0,0,3,7,1220,950,47.6078,-122.192,2010,8680,10850,10690,2170,60,60
3,1.75,2140,9484,1,0,0,3,7,1290,850,47.6234,-122.191,1960,9630,11624,11590,2140,66,66
5,3.25,5370,14091,2,0,0,3,10,3850,1520,47.6499,-122.216,2410,12047,19461,14457,5370,101,7
3,2.5,2880,13500,1,0,4,5,8,1520,1360,47.6281,-122.216,3710,20486,16380,24196,2880,69,69
4,2.5,3680,13351,2,0,2,5,9,3680,0,47.6154,-122.214,3410,11700,17031,15110,3680,73,32
4,2.25,2290,10687,2,0,0,3,9,2290,0,47.5878,-122.202,2290,10300,12977,12590,2290,41,41
4,2.5,2660,11200,2,0,0,3,9,2660,0,47.5894,-122.197,3290,11275,13860,14565,2660,20,20
4,2.5,3980,16304,1,0,1,3,10,2480,1500,47.639,-122.21,3980,16304,20284,20284,3980,51,51
3,1.75,1590,8285,1,0,0,4,8,1590,0,47.5855,-122.194,1970,8970,9875,10940,1590,63,63
3,2.5,2030,1160,3,0,0,3,9,1970,60,47.6213,-122.2,1950,1160,3190,3110,2030,12,12
3,2.5,2430,10500,2,0,1,3,9,2430,0,47.5818,-122.198,3440,12842,12930,16282,2430,30,30
4,2.75,2970,12750,1,0,1,4,7,2130,840,47.6135,-122.213,1980,15300,15720,17280,2970,101,28
3,3,1950,1833,3,0,0,3,9,1610,340,47.6078,-122.202,2040,2131,3783,4171,1950,10,10
4,3,4750,21701,1,0,0,5,11,4750,0,47.6454,-122.218,3120,18551,26451,21671,4750,43,43
3,2.5,2100,4097,2,0,0,3,9,2100,0,47.5983,-122.2,1780,4764,6197,6544,2100,11,11
4,3.25,3980,10249,2,0,0,3,10,3980,0,47.5873,-122.196,2450,10912,14229,13362,3980,8,8
4,3.25,5050,20100,1,0,2,3,11,4750,300,47.6312,-122.223,3890,20060,25150,23950,5050,37,7
4,2.5,2480,12688,1,0,0,4,9,1820,660,47.6344,-122.205,2910,11979,15168,14889,2480,52,52
4,3.5,4020,13515,2,0,0,3,11,4020,0,47.6462,-122.212,3930,13515,17535,17445,4020,18,18
4,1.75,2150,9148,1,0,0,4,7,2150,0,47.5828,-122.197,2370,9148,11298,11518,2150,64,64
3,2,2310,21318,1,0,0,3,10,2310,0,47.6381,-122.224,2950,21814,23628,24764,2310,40,18
4,3.75,3480,14850,1,0,4,3,9,1870,1610,47.6227,-122.216,4780,18480,18330,23260,3480,68,2
3,1,1230,12305,1,0,0,3,7,1230,0,47.6095,-122.195,2100,7960,13535,10060,1230,64,24
5,2.75,2880,20274,1,0,3,4,9,1660,1220,47.6267,-122.222,3750,20220,23154,23970,2880,60,60
3,2.25,3330,20053,2,0,0,3,9,3330,0,47.6395,-122.214,2870,20053,23383,22923,3330,51,17
6,1,1430,20620,2,0,0,3,7,1430,0,47.6255,-122.209,2450,10080,22050,12530,1430,65,65
4,2,1780,15648,1,0,0,5,8,1780,0,47.5849,-122.198,2320,14963,17428,17283,1780,101,101
3,1,1060,9123,1,0,0,3,7,1060,0,47.6218,-122.193,1620,9121,10183,10741,1060,67,67
5,2.5,4250,20441,1,0,1,4,11,2490,1760,47.6377,-122.211,3620,16304,24691,19924,4250,35,35
5,3.5,4230,16526,2,0,0,3,10,4230,0,47.5933,-122.199,3000,12362,20756,15362,4230,11,11
5,2,1720,9972,1,0,0,4,8,1720,0,47.6368,-122.218,2700,9023,11692,11723,1720,68,68
3,1.75,2600,15064,1,0,0,4,8,1700,900,47.64,-122.204,2940,14984,17664,17924,2600,52,52
4,1.5,2220,9496,1,0,0,4,7,1490,730,47.6233,-122.206,1800,8286,11716,10086,2220,65,65
3,1.75,1690,8489,1,0,0,4,7,1690,0,47.6079,-122.192,1850,8536,10179,10386,1690,60,60
5,3.75,5020,8694,2,0,1,3,12,3970,1050,47.6146,-122.213,4190,11275,13714,15465,5020,12,12
4,3.5,2820,7809,2,0,0,3,10,2820,0,47.622,-122.195,2630,7904,10629,10534,2820,24,24
4,1.75,2780,11000,1,0,0,3,9,1560,1220,47.595,-122.203,2350,11700,13780,14050,2780,55,55
4,2,2840,13367,1,0,0,3,7,1420,1420,47.6237,-122.21,2840,12744,16207,15584,2840,67,67
5,3.5,4170,9090,2,0,0,3,10,4170,0,47.5918,-122.196,1930,13635,13260,15565,4170,11,11
4,3.5,4010,9654,2,0,0,3,10,4010,0,47.5891,-122.2,1870,9873,13664,11743,4010,12,12
4,2.25,2860,10702,2,0,0,3,10,2860,0,47.6451,-122.189,2890,10572,13562,13462,2860,37,37
4,2.25,3240,11131,1,0,0,4,9,2080,1160,47.6182,-122.215,2300,12150,14371,14450,3240,66,66
4,3.25,3950,10912,2,0,0,3,10,3950,0,47.5877,-122.196,3000,10998,14862,13998,3950,16,16
4,3.75,4350,7965,2,0,0,3,10,4350,0,47.6289,-122.205,2190,8557,12315,10747,4350,6,6
3,1,1480,6978,2,0,0,4,8,1480,0,47.6497,-122.217,2660,13062,8458,15722,1480,70,29
4,2.75,4280,12668,2,0,0,3,9,3900,380,47.6185,-122.219,3590,12670,16948,16260,4280,72,6
5,5,8000,23985,2,0,4,3,12,6720,1280,47.6232,-122.22,4600,21750,31985,26350,8000,10,10
5,3.5,4320,40816,2,0,0,4,11,4320,0,47.644,-122.185,4320,44584,45136,48904,4320,22,22
4,2,2630,16475,2,0,0,4,8,2630,0,47.639,-122.219,2670,15001,19105,17671,2630,66,66
3,1,1640,12855,1,0,0,5,6,1500,140,47.6169,-122.212,2190,11262,14495,13452,1640,99,99
5,3.5,3630,8100,2,0,0,3,10,3630,0,47.5951,-122.2,1730,8246,11730,9976,3630,11,11
2,1.5,1140,7800,1,0,0,4,6,1140,0,47.6142,-122.209,2020,7800,8940,9820,1140,72,72
4,2.5,2720,11049,2,0,0,3,10,2720,0,47.5815,-122.192,2750,11049,13769,13799,2720,30,30
3,1.75,1930,8442,1,0,0,4,7,1930,0,47.6313,-122.204,1790,8442,10372,10232,1930,66,66
7,4.75,5310,8816,2,0,0,3,10,3650,1660,47.6221,-122.208,2920,10610,14126,13530,5310,6,6
4,2.5,2700,17853,2,0,0,4,9,2700,0,47.6463,-122.219,3790,16672,20553,20462,2700,59,59
5,3.25,3730,10626,1,0,4,4,10,3730,0,47.624,-122.221,4180,19110,14356,23290,3730,56,56
3,1,1410,9656,1,0,0,3,7,960,450,47.6354,-122.208,2410,9384,11066,11794,1410,66,66
4,3.25,4280,20296,2,0,0,4,11,4280,0,47.6377,-122.212,3420,16351,24576,19771,4280,35,35
4,2.75,2930,25697,1,0,0,4,9,2310,620,47.6264,-122.226,3810,20681,28627,24491,2930,55,55
3,2.25,1940,7482,1,0,0,4,7,1240,700,47.6004,-122.195,2340,9310,9422,11650,1940,55,55
5,2.75,2520,18625,1,0,0,3,8,1660,860,47.6409,-122.207,3000,16624,21145,19624,2520,60,60
4,2.5,3140,11049,2,0,0,3,10,3140,0,47.5817,-122.192,2750,11049,14189,13799,3140,31,31
3,1.75,2130,20423,1,0,0,3,9,2130,0,47.6339,-122.192,2370,20875,22553,23245,2130,66,66
4,3.5,5050,9520,2,0,0,3,11,3610,1440,47.6364,-122.209,2430,9248,14570,11678,5050,12,12
5,2.25,1960,8592,1,0,0,4,8,1290,670,47.6066,-122.192,1720,8592,10552,10312,1960,61,61
3,1.75,1400,9900,1,0,0,3,7,1400,0,47.6272,-122.209,1810,10796,11300,12606,1400,68,68
3,2.25,2380,11200,1,0,0,4,8,2380,0,47.5873,-122.193,2010,11200,13580,13210,2380,56,56
3,2.25,2210,22040,1,0,0,5,8,1510,700,47.5904,-122.194,2470,14258,24250,16728,2210,43,43
3,2.25,3740,22464,2,0,0,5,8,2330,1410,47.6354,-122.196,2680,19564,26204,22244,3740,53,53
4,2,1610,8976,1,0,0,4,8,1610,0,47.6011,-122.192,1930,8976,10586,10906,1610,53,53
5,2.5,2900,9799,1,0,0,3,8,1450,1450,47.6255,-122.208,2810,9687,12699,12497,2900,60,60
4,3.5,4370,8510,2,0,1,3,10,3610,760,47.5876,-122.204,2960,10347,12880,13307,4370,16,16
4,2.75,2810,8570,2,0,0,3,10,2810,0,47.6159,-122.211,2810,9621,11380,12431,2810,26,26
3,3.25,4560,13363,1,0,4,3,11,2760,1800,47.6205,-122.214,4060,13362,17923,17422,4560,24,24
4,4,4360,12081,2,0,0,3,10,4360,0,47.6377,-122.219,2180,10800,16441,12980,4360,12,12
3,3.5,3110,14872,1,0,0,3,10,3110,0,47.6178,-122.209,3110,12433,17982,15543,3110,16,16
3,2,2300,13418,1,0,0,3,8,1430,870,47.6075,-122.2,2140,9380,15718,11520,2300,64,64
4,2.75,3190,14904,1,0,3,4,9,1940,1250,47.6178,-122.214,2600,11195,18094,13795,3190,70,22
4,1.75,2770,8521,1,0,0,4,7,1470,1300,47.6255,-122.199,1910,9380,11291,11290,2770,66,66
4,3.25,3820,8114,2,0,0,3,10,3820,0,47.5837,-122.194,2440,9195,11934,11635,3820,14,14
4,2.5,2570,6251,2,0,0,3,9,2570,0,47.593,-122.197,2570,9588,8821,12158,2570,19,19
5,2.5,2550,20875,1,0,0,4,9,1610,940,47.6336,-122.192,2510,21673,23425,24183,2550,66,66
5,2.5,2710,14989,1,0,0,3,8,1720,990,47.6411,-122.207,3180,16624,17699,19804,2710,60,60
4,2.5,3030,12590,1,0,0,4,10,3030,0,47.5806,-122.193,2980,11635,15620,14615,3030,31,31
4,2.25,2490,9864,1,0,0,4,8,1290,1200,47.6051,-122.195,2360,9864,12354,12224,2490,58,58
5,5.25,5090,23669,2,0,0,3,12,5090,0,47.6297,-122.216,3830,22605,28759,26435,5090,13,13
4,3.5,3410,10769,2,0,0,3,10,3410,0,47.6081,-122.198,2650,10058,14179,12708,3410,11,11
5,2.5,2350,14197,1,0,0,4,8,1220,1130,47.6005,-122.204,2470,11629,16547,14099,2350,57,57
3,2.75,3070,10739,2,0,0,3,10,2440,630,47.6444,-122.191,3490,11913,13809,15403,3070,32,32
4,1.75,2210,19025,1,0,0,4,7,1460,750,47.5927,-122.203,2640,14999,21235,17639,2210,67,67
3,1.75,1880,13300,1,0,0,3,7,1380,500,47.634,-122.204,3550,10883,15180,14433,1880,52,52
3,2,1760,16928,1,0,0,3,7,1760,0,47.6363,-122.202,3430,10059,18688,13489,1760,66,66
4,2,2850,14810,2,0,0,5,8,2490,360,47.5892,-122.203,2430,10454,17660,12884,2850,65,65
5,3,3910,16200,1,0,0,4,9,2890,1020,47.6326,-122.217,3620,16200,20110,19820,3910,59,59
3,1.75,1490,9800,1,0,0,4,7,1140,350,47.584,-122.198,2310,9800,11290,12110,1490,72,72
4,1.75,2520,8442,1,0,0,4,7,1640,880,47.6317,-122.205,2110,8442,10962,10552,2520,66,66
3,2.25,4320,19225,1,0,0,4,10,2160,2160,47.6368,-122.216,3430,18469,23545,21899,4320,47,47
3,1.5,1910,21374,1,0,0,1,8,1910,0,47.6453,-122.214,2850,16167,23284,19017,1910,64,64
5,4.5,4400,15580,2,0,0,3,11,3390,1010,47.6232,-122.207,2150,14249,19980,16399,4400,16,16
3,3.25,2620,7215,1,0,0,4,8,1770,850,47.5836,-122.2,2180,8931,9835,11111,2620,39,39
2,1.75,1490,9874,1,0,0,4,7,1490,0,47.6246,-122.199,2280,9869,11364,12149,1490,56,56
5,4,6670,16481,2,0,0,3,12,4960,1710,47.6409,-122.221,4800,16607,23151,21407,6670,12,12
4,3,3700,20570,1,0,0,4,10,1850,1850,47.6212,-122.224,3080,17595,24270,20675,3700,43,43
3,2.5,2660,13367,2,0,2,3,10,2660,0,47.6501,-122.217,2660,13367,16027,16027,2660,27,27
2,1,1050,8750,1,0,0,4,7,1050,0,47.6294,-122.215,3360,20115,9800,23475,1050,68,68
3,1,1520,10227,1,0,0,4,6,1520,0,47.5872,-122.196,2710,10912,11747,13622,1520,68,68
4,2.75,2220,11925,1,0,0,3,7,1560,660,47.6381,-122.205,2500,11377,14145,13877,2220,66,30
5,3.25,3890,20005,1,0,0,3,10,2260,1630,47.6312,-122.224,3450,20176,23895,23626,3890,42,42
4,2.5,3020,15164,1,0,0,4,8,1730,1290,47.5882,-122.192,2600,11556,18184,14156,3020,43,43
4,2.5,3450,17400,1,0,0,4,9,2180,1270,47.5969,-122.206,3770,19530,20850,23300,3450,55,55
5,3.5,4180,17935,2,0,0,3,11,4180,0,47.5873,-122.202,2950,13760,22115,16710,4180,15,15
3,2.25,2640,7544,1,0,0,3,10,2640,0,47.6224,-122.195,2650,7904,10184,10554,2640,24,24
4,3,6430,27517,2,0,0,3,12,6430,0,47.6208,-122.219,3720,14592,33947,18312,6430,18,18
4,2.25,2180,11056,1,0,0,3,8,1370,810,47.6042,-122.193,2090,8747,13236,10837,2180,56,56
4,4.25,4285,9345,2,0,0,3,10,4285,0,47.6332,-122.199,1570,8994,13630,10564,4285,6,6
4,3.25,3930,10929,2,0,0,3,10,3930,0,47.6259,-122.194,1780,9999,14859,11779,3930,13,13
4,3.5,3720,8301,2,0,0,3,10,2880,840,47.5885,-122.199,2080,9676,12021,11756,3720,11,11
2,1.75,1890,9466,2,0,0,3,8,1890,0,47.6144,-122.211,2180,12825,11356,15005,1890,32,32
4,3.25,4250,8570,2,0,0,3,9,4250,0,47.6154,-122.21,2830,12821,12820,15651,4250,15,15
4,2.5,2770,8879,2,0,0,3,9,2770,0,47.5831,-122.193,2770,8882,11649,11652,2770,18,18
5,2.5,3370,8113,2,0,0,3,9,3370,0,47.5812,-122.196,2470,8113,11483,10583,3370,14,14
3,1,1390,9112,1,0,0,4,7,1390,0,47.6071,-122.197,2290,9112,10502,11402,1390,68,68
3,1,1120,8549,1,0,0,3,7,1120,0,47.6294,-122.205,1440,8640,9669,10080,1120,67,67
5,1.75,2130,19180,1,0,0,3,8,1500,630,47.638,-122.213,3650,19180,21310,22830,2130,51,51
4,2.5,3560,11119,1,0,2,3,10,2290,1270,47.6456,-122.19,3290,11385,14679,14675,3560,33,33
4,1.75,2360,8286,1,0,0,3,7,1320,1040,47.6226,-122.205,1680,7630,10646,9310,2360,67,67
3,2,2160,15788,1,0,0,3,8,2160,0,47.6227,-122.207,2260,9787,17948,12047,2160,68,68
5,3.25,4020,4500,2,0,0,3,9,3120,900,47.6349,-122.204,3550,5775,8520,9325,4020,9,9
5,1.5,2680,28014,1,0,0,4,8,1450,1230,47.6348,-122.196,2900,22180,30694,25080,2680,56,56
3,1.5,1180,8545,1,0,0,3,8,1180,0,47.624,-122.2,1660,9000,9725,10660,1180,67,67
3,1.5,1250,8710,1,0,0,4,7,1250,0,47.6245,-122.198,1750,9185,9960,10935,1250,66,66
5,2.75,3810,9360,2,0,0,3,10,3810,0,47.6039,-122.194,2110,9870,13170,11980,3810,5,5
4,2.75,2390,9300,1,0,0,3,8,1430,960,47.6035,-122.206,1910,9348,11690,11258,2390,40,40
5,3.75,3940,13738,1,0,3,4,9,3940,0,47.6203,-122.212,2370,13320,17678,15690,3940,68,68
4,3.25,4140,20734,1,0,1,3,10,3300,840,47.6344,-122.215,4020,20008,24874,24028,4140,42,9
3,1.5,1170,7645,1,0,0,4,7,1170,0,47.6077,-122.194,1870,7678,8815,9548,1170,64,64
3,2,1880,8494,1,0,0,4,7,1200,680,47.6217,-122.192,1290,9128,10374,10418,1880,51,51
3,1,1175,10454,1,0,0,4,6,1175,0,47.6388,-122.218,2010,10800,11629,12810,1175,70,70
4,4.25,5540,15408,2,0,1,3,11,4280,1260,47.6071,-122.212,3570,14750,20948,18320,5540,13,13
2,1,1300,12000,1,0,0,4,8,1300,0,47.6366,-122.229,2420,15000,13300,17420,1300,60,60
3,1.75,1330,7500,1,0,0,3,8,1330,0,47.6074,-122.195,1690,7800,8830,9490,1330,58,58
2,1.75,1570,1207,3,0,0,3,9,1570,0,47.6215,-122.201,1570,1206,2777,2776,1570,12,12
4,2.75,4910,15139,1,0,0,4,10,2560,2350,47.6444,-122.22,3980,15139,20049,19119,4910,55,55
3,1.75,2200,14630,1,0,1,3,8,2200,0,47.6074,-122.213,2850,15803,16830,18653,2200,71,11
4,2.75,3480,19991,2,0,2,4,10,2630,850,47.6354,-122.214,3770,20271,23471,24041,3480,40,40
5,2.25,3120,16672,2,0,0,4,9,3120,0,47.6458,-122.219,3740,17853,19792,21593,3120,50,50
3,2.5,3160,12824,1,0,2,4,9,1820,1340,47.6151,-122.216,3390,11985,15984,15375,3160,53,53
5,4.25,4660,16200,2,0,2,3,11,4660,0,47.6326,-122.216,3340,16200,20860,19540,4660,14,14
4,2.25,2840,20242,1,0,0,3,8,2240,600,47.639,-122.216,2840,20372,23082,23212,2840,47,47
5,2.5,3090,16583,2,0,0,4,9,3090,0,47.6458,-122.218,3740,17853,19673,21593,3090,55,55
4,1.75,2610,21600,1,0,0,4,8,2610,0,47.6245,-122.227,2920,20330,24210,23250,2610,53,53
4,2.75,3300,12090,2,0,0,3,8,3300,0,47.6294,-122.218,3180,12239,15390,15419,3300,66,66
4,3.75,3250,10949,2,0,0,4,9,2940,310,47.639,-122.219,2340,15234,14199,17574,3250,89,26
5,4,4430,9000,2,0,0,3,10,4430,0,47.6168,-122.216,2470,9490,13430,11960,4430,6,6
2,2.25,2200,2043,2,0,0,3,9,1760,440,47.6213,-122.2,2020,1957,4243,3977,2200,12,12
4,2.5,4080,18362,2,0,2,4,11,4080,0,47.6344,-122.214,4080,19991,22442,24071,4080,36,36
3,2.75,3040,21052,2,0,0,4,10,3040,0,47.638,-122.225,2950,21052,24092,24002,3040,39,39
4,2,2290,11137,1,0,0,4,8,2290,0,47.5887,-122.201,2300,10463,13427,12763,2290,64,64
4,3.5,4280,9583,2,0,0,3,11,4280,0,47.5979,-122.197,2360,10031,13863,12391,4280,14,14
4,3.25,3860,17820,1,0,4,4,10,2630,1230,47.6224,-122.215,4590,23760,21680,28350,3860,44,44
5,3.75,4470,8088,2,0,0,3,11,4470,0,47.6321,-122.2,2780,8964,12558,11744,4470,11,11
5,2.5,2450,20805,2,0,0,4,9,2450,0,47.6275,-122.227,3020,20324,23255,23344,2450,56,56
4,2.25,2010,15375,1,0,0,4,8,2010,0,47.5956,-122.174,1930,15375,17385,17305,2010,62,62
5,2.5,3150,35283,1,0,0,3,10,1800,1350,47.6368,-122.157,3280,35283,38433,38563,3150,44,44
3,3.5,2440,3427,2,0,0,3,7,1990,450,47.589,-122.165,2440,2601,5867,5041,2440,19,19
4,2.75,2060,21344,1,0,0,2,8,1460,600,47.5934,-122.154,2060,16088,23404,18148,2060,41,41
4,2.5,3030,13068,2,0,0,3,9,3030,0,47.6313,-122.172,2940,11999,16098,14939,3030,41,41
3,2.25,1580,11680,1,0,0,4,7,1580,0,47.5872,-122.17,2270,10948,13260,13218,1580,61,61
3,1,980,10960,1,0,0,4,7,980,0,47.5908,-122.173,2100,10960,11940,13060,980,66,66
4,2.5,1780,11130,1,0,0,5,8,1780,0,47.5931,-122.178,2610,11130,12910,13740,1780,57,57
4,2.5,3070,8250,1,0,0,5,8,2100,970,47.5935,-122.172,2270,8800,11320,11070,3070,61,61
4,2.25,2510,9963,1,0,0,4,9,2200,310,47.5973,-122.177,3110,9963,12473,13073,2510,52,52
3,1.75,1660,8208,1,0,0,4,8,1660,0,47.5919,-122.154,2210,11000,9868,13210,1660,54,54
3,2.25,2760,40946,2,0,0,5,10,2760,0,47.6501,-122.164,3030,42253,43706,45283,2760,41,41
3,1.75,1760,12874,1,0,0,4,7,1230,530,47.5906,-122.167,1950,10240,14634,12190,1760,52,52
4,1.75,2350,18800,1,0,2,3,8,2350,0,47.5904,-122.177,3050,14640,21150,17690,2350,60,60
3,2.25,1820,8316,1,0,0,5,7,1320,500,47.5849,-122.169,1780,8400,10136,10180,1820,59,59
4,1.75,1870,10450,1,0,0,3,8,1620,250,47.5938,-122.154,2060,10450,12320,12510,1870,41,41
4,1.75,2570,8640,1,0,0,4,8,2570,0,47.5956,-122.172,2520,8800,11210,11320,2570,61,61
3,1.75,1680,10500,1,0,0,4,8,1680,0,47.6098,-122.169,2250,10400,12180,12650,1680,60,60
4,1.75,3620,10400,1,0,0,4,8,1820,1800,47.6069,-122.167,2410,10400,14020,12810,3620,54,54
3,2.25,1670,7416,1,0,0,4,7,1220,450,47.6028,-122.172,1710,7416,9086,9126,1670,45,45
5,2.5,2700,16570,1,0,0,4,8,1750,950,47.6144,-122.167,2570,11840,19270,14410,2700,52,52
4,2.25,1750,10160,1,0,0,3,8,1320,430,47.5909,-122.158,2170,11165,11910,13335,1750,47,47
4,4,4430,31353,2,0,0,3,12,4430,0,47.6422,-122.157,3900,35237,35783,39137,4430,21,21
4,2.25,2620,10920,1,0,0,3,9,2620,0,47.6117,-122.164,2370,11907,13540,14277,2620,54,54
6,3.5,6563,32670,2,0,0,3,10,5153,1410,47.6078,-122.157,2610,22651,39233,25261,6563,17,17
4,2.5,2990,8640,1,0,0,5,8,2100,890,47.5932,-122.172,2270,8800,11630,11070,2990,60,60
4,2.5,2120,10202,1,0,0,4,7,1620,500,47.5858,-122.17,1570,10762,12322,12332,2120,59,59
3,1,1140,8180,1,0,0,3,7,1140,0,47.5851,-122.172,1510,8588,9320,10098,1140,60,60
4,3.75,4490,34982,2,0,0,3,12,4490,0,47.6406,-122.156,4470,37525,39472,41995,4490,21,21
4,2.5,3430,43560,1,0,2,5,10,3430,0,47.6426,-122.18,3700,44431,46990,48131,3430,40,40
3,3.5,2440,3502,2,0,0,3,7,1970,470,47.589,-122.165,2440,3417,5942,5857,2440,19,19
3,2,3200,18184,1,0,0,5,8,2000,1200,47.6034,-122.172,1670,7416,21384,9086,3200,42,42
3,3.5,2490,2722,2,0,0,3,8,2020,470,47.5893,-122.165,2490,2755,5212,5245,2490,20,20
5,2.25,2510,35691,1,0,0,3,9,2510,0,47.6435,-122.154,3160,35037,38201,38197,2510,52,52
3,2.5,1730,2631,2,0,0,3,8,1730,0,47.5878,-122.165,1730,2751,4361,4481,1730,18,18
3,1.5,1240,8738,1,0,0,3,7,1240,0,47.5849,-122.17,1440,9344,9978,10784,1240,60,60
5,3,3690,10260,1,0,4,4,9,2070,1620,47.5919,-122.176,3160,14000,13950,17160,3690,52,52
3,2.5,2240,41339,1,0,0,4,9,2240,0,47.6483,-122.163,2900,45738,43579,48638,2240,74,22
4,1,2500,35802,1,0,0,3,7,2500,0,47.6488,-122.153,2880,40510,38302,43390,2500,64,64
3,1,1300,14138,1,0,0,4,7,1300,0,47.593,-122.165,2440,12196,15438,14636,1300,76,76
4,2.5,2650,18295,2,0,0,3,8,2650,0,47.6075,-122.154,2230,19856,20945,22086,2650,33,33
4,2,2530,15520,1,0,0,5,8,2220,310,47.613,-122.167,2500,13300,18050,15800,2530,55,55
5,3.25,3950,44431,1,0,0,3,10,2100,1850,47.6451,-122.173,3860,45870,48381,49730,3950,50,50
3,1.75,1760,10780,1,0,0,3,8,1760,0,47.5938,-122.154,2090,10780,12540,12870,1760,42,42
3,2.5,2040,10033,1,0,0,4,8,1420,620,47.6375,-122.173,2260,10115,12073,12375,2040,45,45
4,2.25,2590,13894,2,0,0,4,9,2590,0,47.6351,-122.165,2720,13894,16484,16614,2590,44,44
5,3.25,2900,12160,1,0,0,4,8,1890,1010,47.6154,-122.168,2590,12160,15060,14750,2900,52,52
4,3.25,4130,112521,2,0,0,3,11,4130,0,47.6392,-122.165,3140,26147,116651,29287,4130,41,41
6,2.25,3140,10250,1,0,0,4,8,1570,1570,47.6116,-122.169,2320,10250,13390,12570,3140,60,60
3,1.5,1040,10323,1,0,0,4,7,1040,0,47.5882,-122.155,1580,7200,11363,8780,1040,61,61
4,2.5,2840,12866,1,0,0,4,9,1780,1060,47.6388,-122.167,2840,13209,15706,16049,2840,42,42
3,2.25,2120,54014,2,0,0,4,9,2120,0,47.6482,-122.159,3280,50690,56134,53970,2120,55,55
4,2.5,2420,18470,1,0,0,3,8,920,1500,47.6001,-122.176,2690,13800,20890,16490,2420,51,51
3,2,2330,26571,2,0,0,3,8,2330,0,47.6009,-122.158,2030,20037,28901,22067,2330,32,32
3,1.75,1560,16194,1,0,0,3,8,1560,0,47.5966,-122.175,2430,16193,17754,18623,1560,58,58
3,1.75,1510,11120,1,0,0,4,8,1510,0,47.5931,-122.158,2660,10800,12630,13460,1510,35,35
4,2.5,2240,9934,1,0,0,4,8,1490,750,47.6147,-122.166,2640,11622,12174,14262,2240,51,51
6,2.75,3970,9500,1,0,0,4,10,2180,1790,47.5956,-122.178,2490,9775,13470,12265,3970,49,49
5,3.25,4770,50094,1,0,0,4,11,3070,1700,47.6525,-122.16,3530,38917,54864,42447,4770,46,46
3,2.25,2260,33080,1,0,0,5,9,1690,570,47.6386,-122.183,3020,35291,35340,38311,2260,45,45
4,3.25,2880,35315,1,0,0,3,11,2270,610,47.6587,-122.163,1910,167378,38195,169288,2880,37,37
4,2,2250,7500,1,0,0,5,7,1200,1050,47.5877,-122.157,1440,7500,9750,8940,2250,63,63
3,3,2990,9773,2,0,0,4,8,2990,0,47.6344,-122.174,2230,11553,12763,13783,2990,46,46
4,2.5,3160,39960,1,0,0,3,10,3160,0,47.6418,-122.157,3900,36444,43120,40344,3160,39,39
4,2.25,2480,36974,2,0,0,4,9,2480,0,47.6441,-122.154,3160,35070,39454,38230,2480,46,46
4,2,2230,9900,1,0,0,5,9,2230,0,47.5979,-122.173,2510,11041,12130,13551,2230,60,60
4,5,4110,43560,2,0,0,4,11,4110,0,47.6353,-122.18,3650,43995,47670,47645,4110,41,41
3,1.75,1760,10349,1,0,0,3,8,1760,0,47.6347,-122.173,1970,10933,12109,12903,1760,62,62
3,1.75,1680,7770,1,0,0,4,7,1680,0,47.6028,-122.167,1880,7770,9450,9650,1680,52,52
4,2.25,1330,8400,1,0,0,3,8,1330,0,47.6078,-122.169,2270,10146,9730,12416,1330,57,57
5,2.5,3020,24750,1,0,0,3,8,1650,1370,47.5897,-122.179,2930,16062,27770,18992,3020,54,54
3,2.25,2370,10289,1,0,0,4,9,1590,780,47.592,-122.166,2500,10004,12659,12504,2370,42,42
3,1.75,2080,11866,1,0,0,3,8,2080,0,47.5872,-122.173,2240,10696,13946,12936,2080,59,59
3,1.75,2210,16200,1,0,0,3,8,1390,820,47.5924,-122.175,2050,16200,18410,18250,2210,61,61
3,2,1580,14398,1,0,0,3,7,1080,500,47.6328,-122.174,1650,14407,15978,16057,1580,38,38
3,2.5,2730,5832,2,0,0,3,9,2730,0,47.6216,-122.161,2360,5832,8562,8192,2730,21,21
5,2.5,2700,21208,1,0,0,4,8,1950,750,47.6078,-122.154,2550,20409,23908,22959,2700,64,64
5,4,4850,36450,2,0,0,3,10,4850,0,47.6426,-122.158,3850,35325,41300,39175,4850,42,42
6,3.75,4090,49542,2,0,0,3,9,3100,990,47.6408,-122.153,2980,43357,53632,46337,4090,35,35
2,3.25,3000,24004,1,0,0,3,10,2410,590,47.611,-122.157,4270,24506,27004,28776,3000,67,67
3,2.5,2640,13775,1,0,0,3,8,1550,1090,47.5875,-122.177,2120,12432,16415,14552,2640,41,41
3,2.25,2240,8800,1,0,0,5,8,2240,0,47.5937,-122.172,2240,8800,11040,11040,2240,62,62
4,2.5,2230,7200,1,0,0,4,7,1220,1010,47.589,-122.156,1920,7200,9430,9120,2230,62,62
4,2.5,2120,9163,1,0,0,4,8,1450,670,47.5551,-122.172,2120,9166,11283,11286,2120,58,58
4,2.5,2720,10455,2,0,2,3,10,2500,220,47.5564,-122.158,3240,12348,13175,15588,2720,38,38
4,2.25,3310,8540,1,0,4,4,9,1660,1650,47.5603,-122.158,3450,9566,11850,13016,3310,46,46
4,2.25,2650,8149,1,0,0,4,8,1610,1040,47.5624,-122.176,2290,8019,10799,10309,2650,44,44
2,2.5,1414,1960,2,0,0,3,8,1414,0,47.5423,-122.189,1414,2511,3374,3925,1414,33,33
4,3.5,4660,17398,2,0,2,3,11,4660,0,47.5422,-122.112,5080,24913,22058,29993,4660,16,16
3,1,1210,9473,1,0,0,5,7,1210,0,47.5637,-122.139,1700,11465,10683,13165,1210,64,64
4,3.25,3470,11843,1,0,3,3,11,2270,1200,47.5513,-122.135,3910,13247,15313,17157,3470,30,30
4,2.25,2260,16188,1,0,0,3,10,2260,0,47.5637,-122.112,2840,10158,18448,12998,2260,35,35
3,1.5,1220,8400,1,0,0,4,7,1220,0,47.5467,-122.173,2110,9119,9620,11229,1220,57,57
5,3,3650,16600,1,0,3,4,9,1860,1790,47.56,-122.144,3150,10400,20250,13550,3650,41,41
4,4,3650,18223,2,0,3,3,9,3330,320,47.5442,-122.116,3220,11022,21873,14242,3650,6,6
4,2.5,2660,8469,2,0,0,3,10,2660,0,47.5529,-122.12,2920,10697,11129,13617,2660,25,25
3,2.25,2340,14279,1,0,0,3,8,1340,1000,47.5715,-122.124,2340,13600,16619,15940,2340,54,54
3,1.75,2580,11000,1,0,0,4,7,1290,1290,47.5646,-122.181,2280,17643,13580,19923,2580,68,68
4,2.5,3220,15600,1,0,0,5,9,1680,1540,47.5697,-122.182,2990,15600,18820,18590,3220,46,46
5,3.25,3490,23400,1,0,0,4,8,1890,1600,47.5701,-122.124,2660,12400,26890,15060,3490,62,62
2,2.5,3180,9400,2,0,4,5,10,2610,570,47.5617,-122.158,3760,9450,12580,13210,3180,34,34
3,2.25,1400,6970,2,0,0,3,8,1400,0,47.542,-122.184,1800,8140,8370,9940,1400,35,35
5,2.75,2930,31411,1,0,0,4,9,1520,1410,47.5576,-122.186,3070,12378,34341,15448,2930,44,44
4,2.5,3190,8684,1,0,3,5,9,1680,1510,47.5619,-122.162,3160,8684,11874,11844,3190,52,52
4,2.5,2190,11500,1,0,0,4,8,1430,760,47.5668,-122.147,2580,9700,13690,12280,2190,47,47
3,1,1620,30736,1,0,0,4,7,1620,0,47.5719,-122.119,2440,28826,32356,31266,1620,108,37
4,2.5,4040,11350,2,0,2,4,10,3690,350,47.559,-122.162,3770,12382,15390,16152,4040,35,35
3,1.75,1520,7875,1,0,0,5,8,1520,0,47.5569,-122.176,2150,9428,9395,11578,1520,50,50
4,3.5,3550,11000,1,0,2,3,11,2260,1290,47.5506,-122.134,4100,10012,14550,14112,3550,20,20
5,4,4770,31570,2,0,0,3,12,4770,0,47.5468,-122.123,4520,32070,36340,36590,4770,29,29
5,6,7120,40806,2,0,4,3,12,5480,1640,47.5451,-122.114,3440,36859,47926,40299,7120,12,12
4,1,1750,9600,1,0,0,4,7,1750,0,47.5759,-122.137,1750,10530,11350,12280,1750,65,65
4,2.75,3410,23000,2,0,0,4,10,3410,0,47.5559,-122.149,2490,15512,26410,18002,3410,37,37
3,1,1120,9656,1,0,0,5,7,1120,0,47.567,-122.139,1720,9908,10776,11628,1120,64,64
5,1.75,1910,9720,1,0,0,4,7,1390,520,47.5772,-122.159,1750,9720,11630,11470,1910,64,64
5,2.25,2900,10300,1,0,0,3,8,1450,1450,47.5461,-122.151,2310,10300,13200,12610,2900,34,34
3,1,1210,9622,1,0,1,3,8,1210,0,47.5728,-122.179,1580,9714,10832,11294,1210,64,5
4,3.5,4410,12426,2,0,2,3,12,3420,990,47.5518,-122.107,4090,12127,16836,16217,4410,23,23
3,2,1990,7405,1,0,0,5,7,1990,0,47.5421,-122.172,2120,6462,9395,8582,1990,48,48
4,3.5,3500,43560,2,0,0,3,9,2850,650,47.5481,-122.103,3640,40545,47060,44185,3500,5,5
4,2.75,2810,10300,1,0,0,4,9,1810,1000,47.5626,-122.149,2710,9900,13110,12610,2810,41,41
6,2.75,5700,20000,1,0,4,4,10,2850,2850,47.5601,-122.16,3690,15700,25700,19390,5700,42,42
6,2.75,2660,8400,1,0,0,5,8,1550,1110,47.549,-122.173,2280,8400,11060,10680,2660,57,57
3,1.75,1110,10402,1,0,0,4,7,1110,0,47.5676,-122.177,2050,9660,11512,11710,1110,52,52
5,2.5,2820,9375,1,0,0,4,8,1550,1270,47.5707,-122.128,2820,9375,12195,12195,2820,51,51
4,2.5,2030,9905,1,0,0,4,8,2030,0,47.5518,-122.184,2130,10008,11935,12138,2030,60,60
4,2.5,2810,10613,2,0,0,3,9,2810,0,47.5424,-122.141,2800,9933,13423,12733,2810,30,30
5,4.5,4690,6705,2,0,0,3,10,3450,1240,47.5539,-122.108,4070,11505,11395,15575,4690,24,24
3,2.5,2970,9600,2,0,0,3,9,2970,0,47.5422,-122.132,2970,9707,12570,12677,2970,25,25
4,1.75,1920,9500,1,0,0,4,7,1470,450,47.5683,-122.177,1820,10091,11420,11911,1920,53,53
5,2.25,2370,15512,2,0,0,4,9,2370,0,47.5555,-122.15,2380,15100,17882,17480,2370,38,38
3,2.5,2290,4203,2,0,0,3,9,2290,0,47.5441,-122.172,2290,5089,6493,7379,2290,18,18
3,2.5,2770,9136,2,0,0,3,10,2770,0,47.5605,-122.115,2890,8442,11906,11332,2770,28,28
4,2,2790,8793,1,0,0,4,8,1640,1150,47.5509,-122.16,2400,9286,11583,11686,2790,42,42
3,2.25,1640,8400,1,0,0,4,8,1640,0,47.5484,-122.172,2110,8400,10040,10510,1640,57,57
4,2.25,2220,8872,1,0,0,4,8,1110,1110,47.5491,-122.17,2220,9106,11092,11326,2220,58,58
3,2.25,2090,45535,1,0,2,5,8,1280,810,47.5538,-122.191,3090,12889,47625,15979,2090,67,67
3,2.75,2690,8890,2,1,4,4,10,2690,0,47.5487,-122.197,2940,8890,11580,11830,2690,44,24
4,2.5,3320,7644,2,0,0,3,10,3320,0,47.5541,-122.106,3320,9472,10964,12792,3320,24,24
5,2.5,2360,10081,1,0,0,4,7,1180,1180,47.5552,-122.178,2200,10461,12441,12661,2360,58,58
4,2.5,2910,9000,2,0,0,3,9,2910,0,47.5451,-122.142,2530,9000,11910,11530,2910,30,30
4,2.5,4280,12796,2,0,0,3,11,3400,880,47.5588,-122.124,3520,9593,17076,13113,4280,20,20
4,1.75,1940,11500,1,0,0,4,7,1090,850,47.5774,-122.147,1700,8360,13440,10060,1940,64,64
3,2.75,2850,14800,1,0,0,4,9,1920,930,47.559,-122.146,3300,10809,17650,14109,2850,43,43
3,2,1490,9000,1,0,0,4,8,1490,0,47.5455,-122.184,2190,9000,10490,11190,1490,42,42
3,0.75,1300,72309,1,0,0,3,6,680,620,47.567,-122.124,3080,8395,73609,11475,1300,69,28
2,2.25,1860,2670,2,0,0,4,8,1860,0,47.5436,-122.187,1860,2531,4530,4391,1860,33,33
5,3.5,4600,8764,2,0,0,3,10,3180,1420,47.5491,-122.19,3210,9431,13364,12641,4600,12,12
5,6,7440,21540,2,0,0,3,12,5550,1890,47.5692,-122.189,4740,19329,28980,24069,7440,16,16
3,2.25,1580,11580,1,0,0,4,8,1580,0,47.5503,-122.155,2630,10009,13160,12639,1580,40,40
4,2.25,2430,10050,2,0,0,4,8,2430,0,47.5563,-122.163,2390,10250,12480,12640,2430,40,40
4,2.5,3830,13800,1,0,4,4,9,2030,1800,47.5671,-122.157,3460,9875,17630,13335,3830,50,50
4,2.5,3860,10361,2,0,2,4,10,2940,920,47.5517,-122.147,3720,13155,14221,16875,3860,34,34
4,2.25,2290,9546,1,0,0,4,8,1780,510,47.5617,-122.13,2360,8864,11836,11224,2290,43,43
4,2.5,2070,10244,1,0,0,3,8,1370,700,47.5592,-122.178,2070,9683,12314,11753,2070,50,50
6,2.5,3180,9375,1,0,0,4,8,1590,1590,47.5707,-122.129,2670,9625,12555,12295,3180,52,52
4,3.75,7620,29536,2,0,3,3,11,5980,1640,47.5571,-122.14,2840,20809,37156,23649,7620,14,14
3,1.75,1530,8829,1,0,0,5,8,1530,0,47.545,-122.171,2060,9226,10359,11286,1530,47,47
4,2.5,3090,10730,2,0,0,5,8,2420,670,47.5458,-122.141,2220,7875,13820,10095,3090,34,34
3,1,1030,10480,1,0,0,4,7,1030,0,47.5742,-122.139,1480,12200,11510,13680,1030,65,65
3,1,1040,9800,1,0,0,4,7,1040,0,47.5765,-122.155,1280,8880,10840,10160,1040,64,64
3,2,1830,9152,1,0,0,5,8,1830,0,47.5531,-122.181,1770,9220,10982,10990,1830,60,60
3,2.5,3530,9753,2,0,0,3,10,3530,0,47.5539,-122.103,3220,9234,13283,12454,3530,22,22
3,2.25,1950,26500,1,0,0,4,8,1570,380,47.5784,-122.179,2160,12751,28450,14911,1950,54,54
4,2.5,2790,10289,2,0,0,3,9,2790,0,47.5483,-122.158,2650,10126,13079,12776,2790,32,32
4,2.75,3360,9100,1,0,0,4,8,1760,1600,47.5641,-122.149,2620,8925,12460,11545,3360,46,46
3,1.5,2220,8994,1,0,0,4,8,1110,1110,47.5473,-122.172,2220,8994,11214,11214,2220,57,57
3,2.5,2150,15304,2,0,0,4,9,2150,0,47.5573,-122.136,2540,10507,17454,13047,2150,40,40
4,2.75,3800,12200,2,0,3,4,10,3800,0,47.5689,-122.156,3710,14796,16000,18506,3800,33,33
5,4.25,3920,11412,2,0,0,3,7,3920,0,47.5766,-122.151,1400,9750,15332,11150,3920,64,10
3,3.25,4110,20900,2,0,0,3,9,2630,1480,47.5506,-122.187,2640,14700,25010,17340,4110,17,17
3,2.5,2480,7428,2,0,0,3,9,2480,0,47.5489,-122.185,2600,8322,9908,10922,2480,29,29
3,2.5,2120,9307,2,0,0,4,9,2120,0,47.5477,-122.141,2290,11524,11427,13814,2120,35,35
2,1.75,3490,88909,1,0,3,3,10,2320,1170,47.5462,-122.112,3490,40185,92399,43675,3490,39,39
3,2.25,2230,13100,1,0,0,4,8,1510,720,47.5413,-122.174,2010,10650,15330,12660,2230,45,45
4,2.5,2870,8995,1,0,0,5,8,1870,1000,47.5678,-122.128,2670,9672,11865,12342,2870,51,51
3,2.25,1790,9580,2,0,0,3,8,1790,0,47.5541,-122.162,2060,9995,11370,12055,1790,35,35
5,3.25,5790,12739,2,0,3,3,10,4430,1360,47.538,-122.114,5790,13928,18529,19718,5790,5,5
5,1.75,1240,8936,1,0,0,3,7,1240,0,47.5738,-122.136,1600,9341,10176,10941,1240,65,65
3,1.75,1430,20193,1,0,0,3,7,1430,0,47.5619,-122.183,2140,18364,21623,20504,1430,64,64
4,2.75,2820,13193,1,0,0,3,8,1860,960,47.5579,-122.174,2580,13193,16013,15773,2820,54,54
4,2.25,2030,8517,1,0,0,4,8,1380,650,47.5495,-122.174,2230,8824,10547,11054,2030,58,58
3,2.25,3440,44374,2,0,3,4,10,2190,1250,47.547,-122.111,3470,40185,47814,43655,3440,40,40
3,1,1350,10000,1,0,0,4,7,1350,0,47.5741,-122.133,1450,10000,11350,11450,1350,65,65
4,2.25,2100,8290,2,0,0,4,8,2100,0,47.5595,-122.129,2100,8290,10390,10390,2100,41,41
5,2.25,2830,7738,2,0,0,4,8,2830,0,47.5582,-122.136,2300,9840,10568,12140,2830,42,42
3,2.25,1920,8412,1,0,2,3,8,1460,460,47.5578,-122.132,2490,8700,10332,11190,1920,42,42
3,2.75,3640,10300,1,0,0,4,9,2060,1580,47.5612,-122.146,3110,10625,13940,13735,3640,40,40
4,2.25,2270,10000,1,0,0,5,8,1720,550,47.5599,-122.142,2270,10148,12270,12418,2270,45,45
3,1,1020,9835,1,0,0,5,7,1020,0,47.5728,-122.179,1210,9622,10855,10832,1020,64,64
3,1.75,1680,9460,1,0,0,4,7,1680,0,47.5525,-122.182,1690,9448,11140,11138,1680,60,60
5,3.5,4800,14984,2,0,2,3,11,3480,1320,47.5543,-122.148,4050,19009,19784,23059,4800,21,21
4,3.5,3700,13175,2,0,0,4,11,3700,0,47.5471,-122.133,3880,15508,16875,19388,3700,30,30
4,3,3900,9750,1,0,4,5,10,2520,1380,47.5605,-122.158,3410,9450,13650,12860,3900,47,47
3,2.5,1780,11000,1,0,0,4,8,1210,570,47.5574,-122.149,2310,9700,12780,12010,1780,39,39
3,2.5,2560,9825,2,0,0,4,9,2560,0,47.5497,-122.145,2710,12034,12385,14744,2560,31,31
4,2.5,2870,11304,2,0,0,3,9,2870,0,47.5547,-122.154,2690,9940,14174,12630,2870,39,39
4,1.75,1900,8250,1,0,0,4,7,950,950,47.5765,-122.147,1480,8360,10150,9840,1900,64,64
4,3,3900,9750,1,0,4,5,10,2520,1380,47.5605,-122.158,3410,9450,13650,12860,3900,47,47
6,3.75,2930,14980,2,0,3,3,9,2930,0,47.5441,-122.117,3210,10787,17910,13997,2930,6,6
3,2.75,2370,8900,1,0,4,4,9,1670,700,47.5648,-122.156,2840,8956,11270,11796,2370,48,48
4,2.5,3350,11688,1,0,2,3,10,1760,1590,47.5507,-122.133,4240,10804,15038,15044,3350,24,24
5,2.5,3020,9648,1,0,2,4,9,1980,1040,47.5586,-122.134,2890,12598,12668,15488,3020,42,42
4,5.25,4670,43950,2,0,0,3,12,4670,0,47.5456,-122.126,4900,35000,48620,39900,4670,30,30
4,1.75,1520,9600,1,0,0,4,7,1000,520,47.5763,-122.154,1510,9000,11120,10510,1520,64,64
5,3.25,5790,13726,2,0,3,3,10,4430,1360,47.5388,-122.114,5790,13726,19516,19516,5790,5,5
3,1.75,1600,9135,1,0,0,5,7,1600,0,47.5724,-122.179,1580,9800,10735,11380,1600,64,64
5,2.25,3060,13630,2,0,0,3,10,3060,0,47.5585,-122.117,3430,10700,16690,14130,3060,30,30
3,2.5,2060,10650,1,0,0,5,8,1050,1010,47.5627,-122.137,2690,8850,12710,11540,2060,43,43
3,1.5,1690,9708,1,0,0,5,7,1690,0,47.5732,-122.136,1570,9858,11398,11428,1690,65,65
3,2.5,1940,7415,2,0,0,3,8,1940,0,47.542,-122.176,1940,8425,9355,10365,1940,54,54
3,2.5,2750,10000,1,0,3,3,8,1650,1100,47.5644,-122.153,2490,10000,12750,12490,2750,52,52
5,3.25,5180,19606,1,0,0,3,11,2610,2570,47.555,-122.114,4050,15296,24786,19346,5180,26,26
4,2.5,2350,8001,2,0,0,4,8,2350,0,47.5478,-122.153,2460,8001,10351,10461,2350,32,32
3,1.75,1930,10183,1,0,0,4,8,1480,450,47.5624,-122.135,2320,10000,12113,12320,1930,44,44
3,2.5,3830,48743,2,0,0,3,11,3830,0,47.5663,-122.125,2950,8299,52573,11249,3830,28,28
4,2,1210,11100,1,0,0,4,7,1210,0,47.5747,-122.145,1280,11100,12310,12380,1210,64,64
4,3,3130,12381,2,0,0,3,9,3130,0,47.5599,-122.118,3250,10049,15511,13299,3130,24,24
3,2.5,2410,34848,1,0,0,3,8,2410,0,47.5694,-122.12,2420,16424,37258,18844,2410,43,43
3,2.25,3070,9645,2,0,0,3,10,2110,960,47.5522,-122.144,3130,9450,12715,12580,3070,32,32
4,2.25,2910,10189,2,0,0,3,9,2910,0,47.5465,-122.155,2780,10125,13099,12905,2910,31,31
5,2.25,3480,9200,2,0,0,3,8,3480,0,47.5585,-122.153,3130,9200,12680,12330,3480,40,40
4,2.5,3320,9380,2,0,3,3,10,3320,0,47.5655,-122.114,2870,11779,12700,14649,3320,31,31
6,3.5,4860,11793,2,0,0,3,11,3860,1000,47.5521,-122.137,3600,11793,16653,15393,4860,21,21
3,2.5,2979,17313,2,0,2,3,11,2979,0,47.5503,-122.118,3890,14797,20292,18687,2979,26,26
3,2.25,3060,12095,2,0,0,3,10,3060,0,47.5611,-122.106,3060,11455,15155,14515,3060,36,36
4,2.5,3090,9238,1,0,3,4,8,1680,1410,47.5654,-122.163,2690,8500,12328,11190,3090,52,52
2,2,2640,13939,1,0,1,5,8,1640,1000,47.5647,-122.165,2880,14810,16579,17690,2640,56,56
4,2.5,3110,11397,2,0,3,4,10,3110,0,47.5623,-122.106,3110,11586,14507,14696,3110,35,35
3,1,950,10080,1,0,0,4,7,950,0,47.572,-122.139,1060,10000,11030,11060,950,65,65
4,2.5,2120,10841,1,0,0,4,8,1500,620,47.556,-122.156,3130,10950,12961,14080,2120,40,40
3,2.5,4190,9624,2,0,0,3,10,4190,0,47.5642,-122.127,3650,8321,13814,11971,4190,20,20
3,2.25,2490,8800,2,0,0,4,8,2490,0,47.5666,-122.132,2690,10000,11290,12690,2490,44,44
3,2.5,1500,3060,2,0,0,3,7,1500,0,47.5605,-122.117,2700,7734,4560,10434,1500,25,25
4,3.25,5640,35006,2,0,2,3,11,4900,740,47.5491,-122.104,4920,35033,40646,39953,5640,4,4
3,3.25,3870,33980,2,0,0,3,10,3150,720,47.5589,-122.117,3590,10750,37850,14340,3870,28,28
4,2.5,3490,7494,2,0,3,3,11,3490,0,47.559,-122.127,3260,8437,10984,11697,3490,19,19
3,1.75,1330,9143,1,0,0,3,7,1330,0,47.5538,-122.176,1950,10384,10473,12334,1330,59,59
4,2.5,2370,9135,1,0,0,4,8,1600,770,47.5564,-122.177,2050,9468,11505,11518,2370,52,52
3,2.75,2000,7204,1,0,0,5,7,1250,750,47.565,-122.116,2480,17633,9204,20113,2000,59,59
4,2.5,2270,9247,1,0,0,5,8,1500,770,47.5602,-122.176,2270,9163,11517,11433,2270,47,47
4,4.5,4490,24767,2,0,2,3,11,3800,690,47.5544,-122.147,3370,32700,29257,36070,4490,21,21
4,2.5,2730,10753,2,0,0,3,9,2730,0,47.5414,-122.133,3090,10740,13483,13830,2730,28,28
3,1,1340,13750,1,0,0,4,7,1340,0,47.5771,-122.151,1430,11400,15090,12830,1340,64,64
3,1.75,1260,10065,1,0,0,3,7,1260,0,47.5727,-122.138,1320,10278,11325,11598,1260,65,0
4,2.25,2590,12600,2,0,0,3,9,2590,0,47.5566,-122.162,2620,11050,15190,13670,2590,40,40
5,2.5,3040,9570,1,0,2,4,8,1640,1400,47.5651,-122.164,2920,8800,12610,11720,3040,53,53
3,2.5,2290,5089,2,0,0,3,9,2290,0,47.5443,-122.172,2290,7984,7379,10274,2290,18,18
4,3.5,4560,16643,1,0,3,3,12,2230,2330,47.5521,-122.115,4060,15177,21203,19237,4560,24,24
3,1.5,1000,13991,1,0,0,4,7,1000,0,47.5643,-122.138,1520,11465,14991,12985,1000,63,63
4,3.5,4080,14450,2,0,2,3,12,3210,870,47.5519,-122.106,4080,12114,18530,16194,4080,21,21
3,2.5,2660,10928,2,0,0,3,9,1830,830,47.5442,-122.141,2800,10025,13588,12825,2660,31,31
6,3,3420,22421,1,0,0,5,9,2270,1150,47.5508,-122.189,2430,15560,25841,17990,3420,71,71
4,3.5,3450,7832,2,0,0,3,10,3450,0,47.5637,-122.123,3220,8567,11282,11787,3450,12,12
3,2.5,2880,11443,2,0,0,4,9,2880,0,47.5633,-122.111,2840,12530,14323,15370,2880,33,33
3,1,950,9400,1,0,0,4,7,950,0,47.5746,-122.136,1260,9400,10350,10660,950,65,65
3,1.5,1360,11250,1,0,0,4,7,1360,0,47.5697,-122.177,1440,11250,12610,12690,1360,64,64
4,2.25,2020,8400,1,0,0,4,8,1350,670,47.5488,-122.171,2060,8400,10420,10460,2020,58,58
4,1,1450,8800,1,0,0,4,7,1450,0,47.5746,-122.135,1260,8942,10250,10202,1450,65,65
3,2.75,1800,9550,1,0,0,4,7,1320,480,47.5679,-122.178,1890,9902,11350,11792,1800,53,53
4,2.5,2040,8400,1,0,0,3,8,1420,620,47.5512,-122.17,2540,8925,10440,11465,2040,56,56
4,2.5,1710,9627,1,0,0,3,9,1440,270,47.559,-122.164,2140,9131,11337,11271,1710,43,0
5,3,3070,9804,1,0,0,4,9,1740,1330,47.5702,-122.128,2550,9689,12874,12239,3070,51,51
6,2.5,2820,8600,1,0,0,5,8,1430,1390,47.565,-122.144,2070,8900,11420,10970,2820,52,52
4,2.25,2330,7020,1,0,0,4,8,1450,880,47.562,-122.139,2330,8500,9350,10830,2330,46,46
3,2.25,2000,18099,1,0,0,4,8,1250,750,47.5443,-122.18,2060,12000,20099,14060,2000,41,41
4,2.5,2750,10159,2,0,0,3,10,2750,0,47.5426,-122.135,3160,10159,12909,13319,2750,28,28
4,2.75,3400,7081,2,0,0,3,9,3400,0,47.5661,-122.123,3060,7081,10481,10141,3400,18,18
4,3.5,4870,39190,2,0,0,3,12,4870,0,47.5447,-122.124,5000,33880,44060,38880,4870,24,24
4,3,3140,9058,1,0,0,3,9,2140,1000,47.5462,-122.154,2760,10018,12198,12778,3140,30,30
4,1.75,1830,9600,1,0,0,4,7,1010,820,47.5728,-122.125,1910,11100,11430,13010,1830,53,53
4,3.25,5010,34460,2,0,0,3,12,5010,0,47.5469,-122.127,4760,34460,39470,39220,5010,31,31
5,3,3620,12778,1,0,2,5,8,1900,1720,47.5512,-122.191,2930,10669,16398,13599,3620,55,55
4,2.75,2890,7821,2,0,0,3,9,2890,0,47.554,-122.189,2890,10108,10711,12998,2890,5,5
4,2.5,2680,8778,2,0,0,4,8,2680,0,47.5516,-122.161,2680,10020,11458,12700,2680,42,42
3,2.75,2590,12063,2,0,0,3,10,2590,0,47.5527,-122.12,2850,8469,14653,11319,2590,26,26
4,1.75,1700,10642,1,0,0,4,7,850,850,47.5674,-122.142,1610,11200,12342,12810,1700,65,65
4,2.25,2590,8190,2,0,0,4,8,2590,0,47.5619,-122.125,2260,8335,10780,10595,2590,39,39
3,1.75,1480,8667,1,0,0,5,7,740,740,47.5718,-122.136,1600,10644,10147,12244,1480,65,65
4,2.5,2380,9614,2,0,0,4,10,2380,0,47.5623,-122.116,2560,9770,11994,12330,2380,28,28
3,2,1410,11995,1,0,0,4,8,1410,0,47.5718,-122.127,2690,12650,13405,15340,1410,54,54
4,2.75,2310,10232,1,0,0,5,8,1310,1000,47.5515,-122.153,2820,9886,12542,12706,2310,39,39
3,2,1800,10950,1,0,0,4,8,1800,0,47.557,-122.163,2400,11300,12750,13700,1800,37,37
4,2.25,2200,9163,1,0,0,4,8,1430,770,47.5653,-122.146,2420,9163,11363,11583,2200,48,48
6,3,2860,17853,1,0,0,3,8,1430,1430,47.546,-122.175,1920,13452,20713,15372,2860,57,0
3,2.5,2290,5089,2,0,0,3,9,2290,0,47.5443,-122.172,2290,7984,7379,10274,2290,18,18
4,3,3540,10202,2,0,0,3,8,2720,820,47.5471,-122.155,2780,10714,13742,13494,3540,31,31
3,2.5,3300,11570,2,0,0,3,9,3300,0,47.5599,-122.121,3280,11446,14870,14726,3300,25,25
5,4.5,5130,43123,2,0,0,3,11,5130,0,47.544,-122.126,4670,43560,48253,48230,5130,23,23
4,5.5,6930,45100,1,0,0,4,11,4310,2620,47.5547,-122.144,2560,37766,52030,40326,6930,69,23
4,4,3330,24354,1,0,0,4,10,3330,0,47.5708,-122.192,3880,25493,27684,29373,3330,58,58
5,3.5,3330,3705,2,0,0,3,9,2610,720,47.5567,-122.124,2810,3971,7035,6781,3330,11,11
4,4.25,5180,13077,2,0,3,3,12,4280,900,47.5513,-122.109,5030,15069,18257,20099,5180,21,21
4,2.5,2010,9075,1,0,0,4,8,1310,700,47.553,-122.182,1850,9220,11085,11070,2010,60,60
5,3.5,2770,9305,2,0,0,3,9,2770,0,47.5628,-122.114,2520,9773,12075,12293,2770,34,34
4,4.5,3850,13551,2,0,2,3,10,3000,850,47.5522,-122.103,3480,10737,17401,14217,3850,21,21
4,2.75,2200,9778,1,0,0,4,8,1100,1100,47.5472,-122.176,2140,11321,11978,13461,2200,57,57
3,1.5,1340,10224,1,0,0,4,7,1340,0,47.5752,-122.157,1340,10440,11564,11780,1340,63,63
4,2.5,2980,9235,1,0,0,4,8,1690,1290,47.5513,-122.162,2690,10046,12215,12736,2980,42,42
4,2.5,2780,6737,2,0,0,3,9,2780,0,47.5656,-122.122,2750,7950,9517,10700,2780,17,17
3,2.5,2060,8893,2,0,0,3,8,2060,0,47.5615,-122.165,2650,8500,10953,11150,2060,32,32
4,2.5,3680,11648,2,0,0,3,10,3680,0,47.5604,-122.107,2830,11251,15328,14081,3680,33,33
4,2.25,2130,10650,2,0,0,4,8,2130,0,47.5567,-122.159,3380,10050,12780,13430,2130,42,42
4,2.25,2600,10660,2,0,0,4,8,2600,0,47.5533,-122.156,3150,10660,13260,13810,2600,40,40
3,1,1230,9877,1,0,0,3,7,1230,0,47.5745,-122.136,1240,9965,11107,11205,1230,65,65
3,2,1890,29185,1,0,0,3,7,1470,420,47.5621,-122.168,2580,11600,31075,14180,1890,70,1
4,2.75,2510,11880,1,0,0,5,8,1630,880,47.5427,-122.181,2390,11211,14390,13601,2510,41,41
5,3,2500,11779,1,0,0,4,8,1550,950,47.5696,-122.127,2580,12055,14279,14635,2500,48,48
5,2.75,3710,13874,1,0,3,4,9,2340,1370,47.5686,-122.154,3370,13874,17584,17244,3710,42,42
3,1.75,2200,9840,1,0,0,5,8,1500,700,47.559,-122.136,2410,9623,12040,12033,2200,41,41
3,2.25,2800,17300,1,0,0,4,8,1420,1380,47.5716,-122.128,2140,12650,20100,14790,2800,48,48
3,1.75,1890,11141,1,0,0,4,8,1890,0,47.5697,-122.163,2720,11144,13031,13864,1890,51,51
4,1.75,2360,11300,1,0,0,4,9,2360,0,47.5728,-122.163,2290,11951,13660,14241,2360,45,45
4,2.25,2920,17023,1,0,0,4,9,1690,1230,47.5585,-122.134,2710,10681,19943,13391,2920,42,42
4,2.25,2460,8001,2,0,0,4,8,2460,0,47.548,-122.154,2460,9126,10461,11586,2460,35,35
4,3.5,4270,12305,2,0,2,3,10,4270,0,47.5489,-122.118,4190,13137,16575,17327,4270,25,25
4,2.5,3700,21755,1,0,4,3,11,2620,1080,47.5662,-122.108,3480,13786,25455,17266,3700,31,31
4,1.5,1820,12327,1,0,0,4,7,1380,440,47.5767,-122.144,1450,9256,14147,10706,1820,64,64
4,3.25,4290,12103,1,0,3,3,11,2690,1600,47.5503,-122.102,3860,11244,16393,15104,4290,22,22
5,3.5,3750,9612,1,0,2,4,9,2030,1720,47.5511,-122.157,3270,9688,13362,12958,3750,38,38
3,1.75,2140,13286,1,0,0,4,8,1220,920,47.5722,-122.128,2250,13286,15426,15536,2140,55,55
4,3.5,3500,8547,2,0,0,3,9,2500,1000,47.5613,-122.126,2350,10270,12047,12620,3500,25,25
4,2.5,2930,5000,2,0,0,3,9,2760,170,47.5424,-122.12,3230,5778,7930,9008,2930,12,12
4,2.5,2980,4930,2,0,0,3,9,2890,90,47.5445,-122.12,2980,6099,7910,9079,2980,19,19
4,1.75,1990,8900,1,0,0,4,8,1990,0,47.5639,-122.149,2620,8925,10890,11545,1990,47,47
4,4.5,3860,15246,2,0,4,3,11,2940,920,47.56,-122.161,3750,14790,19106,18540,3860,15,15
4,2.25,2550,12918,2,0,0,3,9,2550,0,47.5623,-122.109,2550,11036,15468,13586,2550,32,32
5,2.5,4170,33310,2,0,0,4,11,4170,0,47.5455,-122.126,4670,37960,37480,42630,4170,28,28
4,1.5,1920,10000,1,0,0,4,7,1070,850,47.5725,-122.133,1450,10836,11920,12286,1920,65,65
4,2.25,2220,8125,1,0,0,4,8,1450,770,47.5429,-122.177,1980,8700,10345,10680,2220,54,54
3,2.5,3090,10940,2,0,2,3,10,3090,0,47.5492,-122.119,3410,12157,14030,15567,3090,27,27
3,1.75,1880,10032,1,0,0,4,8,1880,0,47.5527,-122.16,2430,9732,11912,12162,1880,35,35
3,2.5,2630,10100,1,0,0,4,9,1580,1050,47.5638,-122.153,2400,9700,12730,12100,2630,52,52
4,1.75,1990,12950,1,0,0,4,8,1850,140,47.5434,-122.166,2090,12850,14940,14940,1990,51,51
3,2.5,2110,9773,1,0,0,3,9,2110,0,47.5628,-122.115,2560,11787,11883,14347,2110,33,33
3,2.75,3280,10558,1,0,2,4,9,2040,1240,47.5606,-122.133,3150,9998,13838,13148,3280,40,40
4,3.25,3800,19798,2,0,0,3,10,3800,0,47.5684,-122.19,3940,18975,23598,22915,3800,50,5
5,3.5,3180,14000,2,0,0,5,10,3180,0,47.5501,-122.128,3670,14450,17180,18120,3180,22,22
3,1.5,1960,8815,1,0,0,4,7,1020,940,47.5765,-122.159,1760,9534,10775,11294,1960,61,61
5,3.25,3740,11536,2,0,0,4,9,2540,1200,47.5599,-122.108,2920,11258,15276,14178,3740,35,35
4,2.5,2540,11500,1,0,0,4,8,1640,900,47.5609,-122.15,2820,9800,14040,12620,2540,40,40
3,2.5,2610,8481,2,0,0,3,10,2610,0,47.5535,-122.115,3140,10008,11091,13148,2610,26,26
4,2.25,2530,9200,1,0,0,5,9,1570,960,47.5612,-122.152,3030,9400,11730,12430,2530,43,43
4,3.5,3990,5267,2,0,0,3,10,3990,0,47.5641,-122.124,3230,6481,9257,9711,3990,11,11
5,2.75,2910,15118,1,0,0,5,9,1780,1130,47.5696,-122.183,2880,15253,18028,18133,2910,47,47
5,3.5,3130,4797,2,0,0,3,9,2570,560,47.5664,-122.129,3440,5439,7927,8879,3130,5,5
4,2.75,3460,11350,1,0,4,4,9,1780,1680,47.568,-122.153,3200,13874,14810,17074,3460,45,45
4,2.25,2170,9665,1,0,0,4,8,1300,870,47.5444,-122.165,2170,12054,11835,14224,2170,43,43
4,2.5,4500,35200,1,0,0,3,13,4500,0,47.5477,-122.126,4760,35200,39700,39960,4500,31,31
4,3.25,3520,19354,1,0,2,4,9,2010,1510,47.5572,-122.147,2630,19354,22874,21984,3520,41,41
4,2.5,2250,10696,2,0,0,3,8,2250,0,47.5715,-122.128,2340,13286,12946,15626,2250,23,23
5,3,3640,28531,2,0,0,3,10,3640,0,47.5502,-122.13,3330,17186,32171,20516,3640,23,23
4,2.75,3720,9450,1,0,4,5,10,1960,1760,47.5627,-122.156,2900,8605,13170,11505,3720,57,57
4,3.25,3780,10099,1,0,1,3,11,2240,1540,47.5508,-122.192,3120,10669,13879,13789,3780,13,13
4,2.5,2170,9796,1,0,0,4,8,1650,520,47.5505,-122.152,2350,9796,11966,12146,2170,39,39
5,2.75,3190,16920,1,0,3,3,9,1690,1500,47.5641,-122.16,3100,13100,20110,16200,3190,43,43
3,2,2410,13300,2,0,0,3,9,1840,570,47.5632,-122.148,2930,10900,15710,13830,2410,34,34
4,2.5,2110,10100,1,0,2,3,8,2110,0,47.567,-122.151,2230,10100,12210,12330,2110,51,9
3,2.5,3220,54160,2,0,2,4,9,2690,530,47.5468,-122.109,3460,44374,57380,47834,3220,38,38
3,2.25,4470,22518,2,0,2,3,9,3240,1230,47.574,-122.18,2930,21837,26988,24767,4470,66,10
4,1.75,1700,14756,1,0,0,3,7,850,850,47.5762,-122.143,1680,10250,16456,11930,1700,64,64
3,1.75,1670,10798,1,0,0,4,8,1670,0,47.549,-122.17,2290,10798,12468,13088,1670,57,57
4,2.75,2310,7851,1,0,0,4,8,1790,520,47.5473,-122.187,2230,7359,10161,9589,2310,30,30
4,1.75,1700,8640,1,0,0,3,7,850,850,47.5772,-122.153,1620,9000,10340,10620,1700,64,64
3,1.75,1410,9150,1,0,0,5,7,1410,0,47.5683,-122.178,1800,9940,10560,11740,1410,60,60
5,2.75,3040,10257,2,0,0,3,10,3040,0,47.5531,-122.119,2860,9327,13297,12187,3040,26,26
4,2.25,3550,13900,1,0,0,3,8,1830,1720,47.5681,-122.127,2770,12200,17450,14970,3550,9,9
6,4.25,5720,10213,2,0,0,3,10,4170,1550,47.5464,-122.116,4300,10224,15933,14524,5720,15,15
4,2.25,2060,8470,1,0,0,3,8,1440,620,47.5605,-122.124,2180,8978,10530,11158,2060,36,36
2,1,930,36478,1,0,2,3,6,930,0,47.5699,-122.164,2800,11141,37408,13941,930,68,68
5,2.75,2920,9163,1,0,0,4,8,1520,1400,47.5668,-122.169,2250,9163,12083,11413,2920,43,43
3,2.75,3860,12786,2,0,0,4,10,3860,0,47.549,-122.141,2820,14636,16646,17456,3860,35,35
5,3,2460,7240,1,0,0,3,9,1840,620,47.5486,-122.189,2530,7885,9700,10415,2460,28,28
4,1.5,1100,11824,1,0,0,4,7,1100,0,47.5704,-122.141,1380,11796,12924,13176,1100,65,65
3,2.25,2120,9297,2,0,0,4,8,2120,0,47.5561,-122.154,2620,10352,11417,12972,2120,38,38
3,2.75,2750,18029,1,0,2,5,9,1810,940,47.5617,-122.134,2850,10021,20779,12871,2750,41,41
4,2.5,3320,11901,2,0,0,5,9,2650,670,47.554,-122.16,2700,11114,15221,13814,3320,42,42
4,3,2450,10117,1,0,0,5,8,1580,870,47.5694,-122.132,2530,10125,12567,12655,2450,52,52
3,2.75,3060,13554,2,0,0,3,10,3060,0,47.5609,-122.106,3060,11455,16614,14515,3060,35,35
3,2.5,2090,9847,2,0,2,3,9,2090,0,47.5651,-122.114,2860,11483,11937,14343,2090,36,36
4,5,5310,16909,1,0,4,3,12,3090,2220,47.5515,-122.113,5220,15701,22219,20921,5310,27,27
4,3.5,4680,9700,2,0,0,3,10,3360,1320,47.5703,-122.165,2800,12343,14380,15143,4680,14,14
3,2.5,2900,23550,1,0,0,3,10,1490,1410,47.5708,-122.153,2900,19604,26450,22504,2900,32,32
3,2.25,3230,17833,2,0,0,4,9,3230,0,47.5683,-122.188,3690,17162,21063,20852,3230,46,46
6,4.25,5860,13928,2,0,3,3,10,4150,1710,47.5382,-122.114,5790,13928,19788,19718,5860,6,6
3,2.75,2390,9966,1,0,0,5,8,1360,1030,47.5433,-122.185,2140,10713,12356,12853,2390,42,42
4,3,5520,8313,2,0,3,3,9,3570,1950,47.5655,-122.129,3770,8278,13833,12048,5520,11,11
4,1.75,1740,8800,1,0,0,4,8,1740,0,47.6232,-122.142,2180,8436,10540,10616,1740,54,54
4,2.25,2460,44431,1,0,0,4,9,2460,0,47.6042,-122.147,2830,44431,46891,47261,2460,62,62
5,2.25,2700,9000,2,0,0,5,9,2700,0,47.6599,-122.146,2630,9000,11700,11630,2700,32,32
4,2.5,2100,8886,2,0,0,4,7,2100,0,47.5947,-122.134,1840,9058,10986,10898,2100,55,55
3,1.75,1420,8250,1,0,0,4,7,1420,0,47.6112,-122.133,2020,8250,9670,10270,1420,59,59
3,2.5,2540,6762,2,0,0,3,10,2540,0,47.6239,-122.144,2870,6631,9302,9501,2540,21,21
5,2,1870,7344,1,0,0,3,7,1870,0,47.5951,-122.144,1870,7650,9214,9520,1870,59,59
5,2,1910,12264,1,0,0,4,7,1010,900,47.601,-122.134,1700,9179,14174,10879,1910,56,56
5,2.5,1710,7700,1,0,0,3,7,1710,0,47.5922,-122.146,1530,7700,9410,9230,1710,57,57
3,1.5,1120,6900,1,0,0,5,7,1120,0,47.6023,-122.132,1300,7000,8020,8300,1120,63,63
7,4,3150,34830,1,0,0,3,9,3150,0,47.6029,-122.147,2390,12054,37980,14444,3150,62,9
4,2.25,2250,13500,2,0,0,4,9,2250,0,47.621,-122.151,2730,13500,15750,16230,2250,39,39
5,2.75,3030,13640,2,0,0,4,8,3030,0,47.6186,-122.146,2500,13225,16670,15725,3030,39,39
5,2.25,2180,6000,1,0,0,4,8,1430,750,47.6235,-122.143,2160,8800,8180,10960,2180,53,53
7,3.5,3470,16264,2,0,0,4,9,3470,0,47.6203,-122.149,3040,13500,19734,16540,3470,39,39
3,1.75,1420,5170,1,0,0,4,7,1420,0,47.6151,-122.145,2250,7700,6590,9950,1420,56,56
5,4,4420,36342,2,0,0,5,10,2740,1680,47.6468,-122.151,3720,37034,40762,40754,4420,37,37
5,2.25,2530,8250,2,0,0,4,7,2530,0,47.6117,-122.134,2020,8250,10780,10270,2530,58,58
3,1.5,1510,8360,1,0,0,3,7,1120,390,47.6119,-122.133,1700,8360,9870,10060,1510,59,59
4,2.5,2460,9296,2,0,0,3,9,2460,0,47.6125,-122.152,2730,9900,11756,12630,2460,41,41
4,2.5,2430,14400,1,0,0,5,8,1670,760,47.6202,-122.138,2140,9048,16830,11188,2430,56,56
4,2.5,3180,31931,1,0,0,4,10,2390,790,47.6388,-122.149,3180,35007,35111,38187,3180,41,41
3,1.5,1170,4950,1,0,0,4,7,1170,0,47.6057,-122.135,1570,7700,6120,9270,1170,59,59
4,2.25,2440,9320,1,0,0,4,7,1880,560,47.5933,-122.135,1530,9335,11760,10865,2440,62,62
3,1.25,2350,6200,1,0,0,4,7,1320,1030,47.5979,-122.135,2140,9543,8550,11683,2350,53,53
4,2,1570,7320,1,0,0,4,7,1570,0,47.5967,-122.14,1530,8800,8890,10330,1570,59,59
3,1,1270,8000,1,0,0,4,7,1270,0,47.5874,-122.136,1470,8000,9270,9470,1270,62,62
6,3,2480,9720,2,0,0,3,8,2480,0,47.6127,-122.145,2480,9200,12200,11680,2480,47,47
3,1.75,1590,14766,1,0,0,3,8,1590,0,47.5902,-122.147,2040,10190,16356,12230,1590,56,56
5,2.5,3210,12000,1,0,0,4,8,1830,1380,47.6205,-122.148,2450,12000,15210,14450,3210,51,51
6,3,2470,9267,2,0,0,3,8,2470,0,47.6025,-122.152,2470,9151,11737,11621,2470,37,37
3,1.75,1950,8480,1,0,0,4,8,1250,700,47.5893,-122.15,1740,8480,10430,10220,1950,57,57
3,1.5,1120,7000,1,0,0,3,7,1120,0,47.5987,-122.146,1470,7950,8120,9420,1120,64,64
3,2.5,1460,7573,2,0,0,3,8,1460,0,47.6012,-122.141,1910,7668,9033,9578,1460,36,36
4,2.5,2690,8036,2,0,0,4,9,2690,0,47.6596,-122.144,2420,8087,10726,10507,2690,32,32
3,2.25,2230,9053,2,0,0,4,9,2230,0,47.6594,-122.144,2390,8038,11283,10428,2230,32,32
3,2.5,3560,9796,1,0,0,3,8,1860,1700,47.6007,-122.145,2210,8925,13356,11135,3560,54,54
4,2.25,3070,13720,2,0,0,3,9,3070,0,47.6133,-122.152,3010,9657,16790,12667,3070,41,41
3,1.5,1240,12400,1,0,0,3,7,1240,0,47.607,-122.132,1640,9600,13640,11240,1240,61,61
4,1.75,2120,7725,1,0,0,3,8,1220,900,47.6003,-122.144,2160,7725,9845,9885,2120,54,54
4,3.25,2590,3889,3,0,0,3,9,2590,0,47.6259,-122.142,2590,4062,6479,6652,2590,6,6
4,2,2260,10800,1,0,0,3,9,2260,0,47.6124,-122.153,2650,9900,13060,12550,2260,41,41
3,2.5,2420,9000,2,0,0,4,9,2420,0,47.6599,-122.146,2630,9000,11420,11630,2420,32,32
4,2.5,2090,7290,1,0,0,5,8,1420,670,47.624,-122.142,2110,8436,9380,10546,2090,53,53
4,2.5,2720,13500,1,0,0,3,8,1510,1210,47.6191,-122.145,2510,12350,16220,14860,2720,50,50
4,1.75,2140,8000,1,0,0,4,8,1410,730,47.622,-122.139,2080,8000,10140,10080,2140,54,54
4,2.5,2770,8642,2,0,0,4,9,2770,0,47.6599,-122.146,2670,9000,11412,11670,2770,32,32
4,1.75,1820,6600,1,0,0,5,7,1820,0,47.606,-122.135,1430,8800,8420,10230,1820,59,59
3,2.5,1910,4488,2,0,0,3,8,1910,0,47.6176,-122.14,1530,3696,6398,5226,1910,21,21
3,2.25,1640,7200,2,0,0,4,8,1640,0,47.5948,-122.153,1830,8372,8840,10202,1640,34,34
4,3,2120,7650,2,0,0,3,8,2120,0,47.6214,-122.14,2260,7885,9770,10145,2120,55,55
4,3.5,3770,37034,2,0,0,3,10,2830,940,47.6463,-122.151,3200,36342,40804,39542,3770,30,30
3,2.25,1640,7200,2,0,0,4,8,1640,0,47.5948,-122.153,1830,8372,8840,10202,1640,34,34
4,1.75,1710,8947,1,0,0,4,7,1710,0,47.5947,-122.135,1360,10133,10657,11493,1710,63,63
4,2.5,2550,10000,1,0,0,3,8,1290,1260,47.6208,-122.141,2270,8640,12550,10910,2550,55,55
5,2.75,2580,7865,1,0,0,4,8,1480,1100,47.6208,-122.139,2140,8400,10445,10540,2580,55,55
5,1.75,1880,16617,1,0,0,3,7,960,920,47.6003,-122.132,1720,8400,18497,10120,1880,56,56
3,2.5,1990,15985,1,0,0,3,8,1540,450,47.6205,-122.141,2470,10125,17975,12595,1990,55,55
3,3,4910,43560,2,0,0,4,10,4000,910,47.5911,-122.131,3540,12288,48470,15828,4910,30,30
3,1.5,1450,7000,1,0,0,3,7,1450,0,47.5983,-122.15,1490,7245,8450,8735,1450,64,64
7,2.25,2620,6890,2,0,0,4,7,2620,0,47.6123,-122.134,2070,7910,9510,9980,2620,58,58
5,2,2700,10875,1,0,0,4,7,1540,1160,47.6163,-122.138,2040,7464,13575,9504,2700,57,57
3,2.5,1880,3054,2,0,0,3,8,1880,0,47.6091,-122.147,1840,3815,4934,5655,1880,31,31
4,2.5,3210,8532,2,0,0,3,10,3210,0,47.625,-122.144,2950,6753,11742,9703,3210,21,21
4,1.75,1430,10500,1,0,0,4,7,1130,300,47.6083,-122.132,2070,8640,11930,10710,1430,59,59
4,3,3580,9316,2,0,0,3,10,2370,1210,47.595,-122.133,2580,9242,12896,11822,3580,28,28
3,1.5,1430,8000,1,0,0,4,7,1430,0,47.5874,-122.136,1450,8000,9430,9450,1430,63,63
3,2.5,2670,10338,2,0,0,3,9,2670,0,47.6599,-122.146,2670,8866,13008,11536,2670,32,32
3,1,1060,7638,1,0,0,5,7,1060,0,47.5941,-122.142,1470,8097,8698,9567,1060,53,53
4,2.5,3170,9900,2,0,0,4,8,3170,0,47.6181,-122.147,2540,12400,13070,14940,3170,40,40
3,2.5,2590,7720,2,0,0,3,9,2590,0,47.659,-122.146,2600,9490,10310,12090,2590,31,31
3,1.5,1420,7520,1,0,0,4,7,1420,0,47.601,-122.134,2000,7520,8940,9520,1420,63,63
3,1.5,1570,6700,1,0,0,4,7,1570,0,47.6022,-122.134,1570,7300,8270,8870,1570,63,63
2,1.5,1510,2001,2,0,0,4,8,1510,0,47.6211,-122.153,1510,2055,3511,3565,1510,34,34
4,2.5,3810,13579,2,0,0,3,10,3810,0,47.6006,-122.153,3310,9270,17389,12580,3810,16,16
3,1,1520,9030,1,0,0,3,7,1520,0,47.587,-122.134,1470,8712,10550,10182,1520,63,63
4,2.5,2330,14289,2,0,0,4,8,2330,0,47.5916,-122.148,2210,12823,16619,15033,2330,41,41
4,1.5,2040,8800,1,0,0,4,7,1020,1020,47.5965,-122.139,1490,8800,10840,10290,2040,58,58
3,1.5,1200,4800,1,0,0,4,7,1200,0,47.6084,-122.136,1510,7668,6000,9178,1200,57,57
3,1,1200,5252,1,0,0,3,7,1200,0,47.6075,-122.134,1800,7920,6452,9720,1200,57,57
5,2.75,2580,9242,2,0,2,4,8,1720,860,47.5943,-122.133,2240,9316,11822,11556,2580,52,52
2,2.5,1470,2034,2,0,0,4,8,1470,0,47.6213,-122.153,1510,2055,3504,3565,1470,34,34
6,3,2480,12000,2,0,0,3,8,2480,0,47.6131,-122.145,2220,8580,14480,10800,2480,47,47
3,1,1250,7700,1,0,0,4,7,1250,0,47.5974,-122.149,1520,7700,8950,9220,1250,64,64
4,1.75,1730,7980,1,0,0,4,8,1730,0,47.6219,-122.138,2080,8400,9710,10480,1730,54,54
3,1.75,1630,8400,1,0,0,4,7,1060,570,47.5983,-122.149,1630,7245,10030,8875,1630,64,64
4,2.5,1900,9240,1,0,0,3,7,1900,0,47.6167,-122.137,2040,8052,11140,10092,1900,57,57
5,1.75,2040,5280,1,0,0,4,7,1020,1020,47.5941,-122.144,1720,7344,7320,9064,2040,58,58
3,1,1420,11040,1,0,0,4,7,1420,0,47.5969,-122.14,1530,8208,12460,9738,1420,58,58
4,2,1770,7700,1,0,0,4,7,1770,0,47.5916,-122.146,1710,7700,9470,9410,1770,57,57
4,2.25,2500,8866,2,0,0,4,9,2500,0,47.6604,-122.146,2630,8847,11366,11477,2500,32,32
3,2,1940,55756,1,0,0,5,9,1940,0,47.5913,-122.149,2330,10018,57696,12348,1940,65,65
3,1.5,1800,10050,1,0,0,3,7,1800,0,47.6344,-122.126,1610,10050,11850,11660,1800,64,64
5,3,2750,10000,1,0,0,4,7,1730,1020,47.5878,-122.13,2520,10000,12750,12520,2750,62,62
5,2.5,2650,11455,1,0,0,3,7,1400,1250,47.6141,-122.116,1960,9880,14105,11840,2650,58,58
5,2.25,1950,8025,1,0,2,3,7,1150,800,47.6159,-122.114,1780,8560,9975,10340,1950,59,59
5,2.25,2720,8800,1,0,0,4,7,1500,1220,47.5976,-122.118,2110,8800,11520,10910,2720,61,61
4,2.5,2290,10186,2,0,0,3,8,2290,0,47.6353,-122.124,2150,10186,12476,12336,2290,34,34
3,1.5,1390,9680,1,0,0,4,7,1390,0,47.634,-122.125,1460,10050,11070,11510,1390,63,63
4,2.25,2060,12155,1,0,0,4,8,2060,0,47.6378,-122.117,2360,8625,14215,10985,2060,51,51
4,2,2100,8880,1,0,0,4,7,2100,0,47.6115,-122.124,1280,9102,10980,10382,2100,61,61
4,2.25,3220,8436,2,0,0,3,8,3220,0,47.6381,-122.116,2500,7632,11656,10132,3220,51,51
3,1.75,1430,8400,1,0,0,4,7,1430,0,47.6073,-122.127,1570,7800,9830,9370,1430,58,58
3,2.75,2660,10350,1,0,4,4,8,1330,1330,47.5868,-122.116,2820,10043,13010,12863,2660,48,48
3,1,1310,7000,1,0,0,4,7,1310,0,47.6019,-122.123,1280,7300,8310,8580,1310,61,61
3,1.75,1800,16026,1,0,0,3,8,1390,410,47.5815,-122.121,2210,13959,17826,16169,1800,47,47
5,2.5,2090,8712,1,0,0,3,8,1420,670,47.5968,-122.127,2490,8712,10802,11202,2090,53,53
4,1.75,2640,8215,1,0,0,4,7,1500,1140,47.5819,-122.125,2070,7875,10855,9945,2640,53,53
4,3,2900,15535,1,0,2,4,7,1870,1030,47.612,-122.119,2330,10217,18435,12547,2900,58,58
5,1.5,1420,9900,1,0,0,3,7,1050,370,47.6348,-122.118,1580,8075,11320,9655,1420,55,55
4,1.75,1760,7300,1,0,0,3,7,880,880,47.6034,-122.125,1680,7500,9060,9180,1760,63,63
4,2.25,2530,8736,1,0,0,4,7,1210,1320,47.6049,-122.126,1720,8500,11266,10220,2530,61,61
3,1.75,2150,8925,1,0,0,4,7,2150,0,47.6253,-122.119,1100,7875,11075,8975,2150,59,59
5,3.5,5150,12230,2,0,2,3,10,3700,1450,47.6249,-122.09,2940,13462,17380,16402,5150,12,12
4,2.5,2300,11165,2,0,0,4,8,2300,0,47.5794,-122.118,2170,11165,13465,13335,2300,40,40
3,2.25,1680,9090,1,0,0,4,7,1130,550,47.6068,-122.13,1960,9090,10770,11050,1680,60,60
5,2,2500,15250,2,1,4,5,8,2500,0,47.5883,-122.111,1880,18782,17750,20662,2500,77,77
3,1,1220,7771,1,0,0,3,7,1220,0,47.6326,-122.119,1420,7674,8991,9094,1220,56,56
5,2.5,2960,8968,1,0,0,4,8,1640,1320,47.6233,-122.102,1890,9077,11928,10967,2960,54,54
4,2.25,2660,22194,1,0,0,4,8,2180,480,47.6142,-122.107,2660,18135,24854,20795,2660,42,42
2,1.5,1290,1749,1,0,0,3,8,660,630,47.6118,-122.116,1860,1749,3039,3609,1290,50,50
5,2.75,2830,11795,1,0,0,4,7,1710,1120,47.5828,-122.118,2460,10880,14625,13340,2830,59,59
3,2.25,1410,1340,2,0,0,3,8,1370,40,47.6108,-122.113,1730,2748,2750,4478,1410,52,52
3,1.75,1770,7875,1,0,0,4,7,1170,600,47.606,-122.125,1670,8000,9645,9670,1770,61,61
3,1.75,1550,8134,1,0,0,4,7,1550,0,47.6136,-122.121,1360,8000,9684,9360,1550,60,60
3,3.25,4220,41300,1,1,4,4,11,2460,1760,47.6083,-122.11,3810,30401,45520,34211,4220,61,27
3,1.75,1510,8250,1,0,0,4,8,1510,0,47.6183,-122.113,1770,8250,9760,10020,1510,57,57
3,1.75,1250,9605,1,0,0,3,7,1250,0,47.6325,-122.121,1570,9605,10855,11175,1250,55,55
4,2,1420,9301,1,0,0,4,7,1420,0,47.6325,-122.121,1530,8075,10721,9605,1420,56,56
3,1.5,1250,8004,1,0,0,3,7,1250,0,47.6285,-122.117,1450,7931,9254,9381,1250,54,54
4,2.25,2410,8400,2,0,0,5,8,2410,0,47.626,-122.119,1910,8056,10810,9966,2410,54,54
3,2.5,3350,7752,1,0,0,3,9,2180,1170,47.6263,-122.099,2570,7988,11102,10558,3350,10,10
4,2.5,2550,7312,2,0,0,3,9,2550,0,47.6441,-122.113,2330,7480,9862,9810,2550,31,31
4,3,1780,7260,1,0,0,4,8,1780,0,47.627,-122.114,1810,7920,9040,9730,1780,55,55
5,2.5,2530,10190,1,0,0,4,7,1290,1240,47.616,-122.115,2040,8560,12720,10600,2530,59,59
4,1.75,1680,7800,1,0,0,3,7,1330,350,47.6286,-122.118,1680,7210,9480,8890,1680,53,53
5,2.25,2400,13450,1,0,0,5,7,1200,1200,47.6007,-122.117,1950,10361,15850,12311,2400,62,62
5,1.75,2040,8996,1,0,2,4,7,1020,1020,47.588,-122.118,1950,8270,11036,10220,2040,57,57
3,1.75,1600,7232,1,0,0,3,8,1600,0,47.6293,-122.121,1970,8120,8832,10090,1600,53,53
5,2,2030,9804,1,0,0,3,7,1110,920,47.6297,-122.114,1930,7990,11834,9920,2030,56,56
4,1.75,2060,7900,1,0,0,4,7,1070,990,47.6028,-122.12,1830,8000,9960,9830,2060,62,62
2,1,1120,7500,1,0,2,4,7,1120,0,47.619,-122.096,3040,16940,8620,19980,1120,48,48
3,2.5,3870,46609,2,0,3,3,9,3870,0,47.5966,-122.112,4030,17880,50479,21910,3870,22,22
3,2.75,3130,19530,1,1,4,3,8,1690,1440,47.5895,-122.111,2980,18782,22660,21762,3130,72,31
4,1.5,1280,7400,1,0,0,3,7,1280,0,47.6023,-122.123,1310,7400,8680,8710,1280,61,61
3,1.75,1900,11165,1,0,0,4,7,1900,0,47.5789,-122.118,2030,11165,13065,13195,1900,60,60
4,1.75,1770,9848,1,0,0,3,8,1370,400,47.6208,-122.099,2040,9587,11618,11627,1770,52,52
4,2.25,2160,9593,1,0,0,3,8,2160,0,47.5883,-122.112,2820,9628,11753,12448,2160,50,50
3,1.75,1440,8957,1,0,0,4,7,1440,0,47.6008,-122.118,1340,8780,10397,10120,1440,62,62
3,1,940,7590,1,0,0,4,6,940,0,47.6231,-122.12,1250,7590,8530,8840,940,60,60
4,2.5,2540,11100,1,0,0,5,7,2540,0,47.6317,-122.124,1560,11100,13640,12660,2540,62,62
4,3,3060,50002,1,0,2,4,8,2460,600,47.6205,-122.096,2740,16181,53062,18921,3060,62,62
3,1.5,1240,7735,1,0,0,4,7,1240,0,47.601,-122.122,1260,7500,8975,8760,1240,62,62
4,3.25,4420,7850,2,1,4,3,11,3150,1270,47.572,-122.102,2760,8525,12270,11285,4420,18,18
5,2.5,2810,14207,1,0,3,3,9,1540,1270,47.5742,-122.11,3190,14000,17017,17190,2810,40,40
3,2.5,2350,9648,1,0,0,4,9,2350,0,47.6156,-122.108,2320,10512,11998,12832,2350,53,53
3,2.5,1740,13750,2,0,0,4,9,1740,0,47.6264,-122.092,2540,14300,15490,16840,1740,44,44
3,1.75,1710,9707,1,0,0,4,8,1710,0,47.623,-122.105,1820,8700,11417,10520,1710,53,53
4,2.25,1650,7200,1,0,0,3,8,1650,0,47.6384,-122.116,2180,7950,8850,10130,1650,52,52
4,2,1470,10291,1,0,0,4,7,1470,0,47.6316,-122.121,1460,9601,11761,11061,1470,56,56
4,2,1690,8208,1,0,0,4,7,1210,480,47.6052,-122.126,1620,8496,9898,10116,1690,61,61
4,1.75,2120,7420,1,0,0,4,7,1060,1060,47.6019,-122.13,1540,7420,9540,8960,2120,63,63
5,3.5,3100,10200,1,0,4,3,9,1660,1440,47.6134,-122.112,2700,10455,13300,13155,3100,49,49
3,1.75,1750,7200,1,0,0,3,7,1750,0,47.6289,-122.119,1810,7590,8950,9400,1750,53,53
4,1,2070,7519,1,0,0,3,7,1160,910,47.632,-122.119,1730,7519,9589,9249,2070,56,56
3,1.75,1430,12632,1,0,0,3,7,1430,0,47.6371,-122.123,1750,10350,14062,12100,1430,60,60
5,3,3655,51836,1,0,0,5,8,2174,1481,47.6434,-122.115,2530,8606,55491,11136,3655,64,64
4,1.75,1840,10720,1,0,0,3,7,960,880,47.6074,-122.125,1840,9044,12560,10884,1840,61,61
6,3,2600,9350,1,0,0,4,8,1340,1260,47.6198,-122.105,2090,9102,11950,11192,2600,56,56
3,1.75,2260,11781,1,0,0,4,8,1520,740,47.5982,-122.128,2530,10176,14041,12706,2260,51,51
3,2.75,1890,2614,2,0,0,4,9,1890,0,47.6102,-122.114,1800,2769,4504,4569,1890,40,40
4,2.5,2800,10786,1,0,0,3,8,1420,1380,47.5959,-122.116,2140,10788,13586,12928,2800,49,49
4,2,1790,7800,1,0,0,5,8,1790,0,47.6266,-122.103,2150,7838,9590,9988,1790,47,47
3,1.5,1340,8856,1,0,0,4,7,1340,0,47.6094,-122.126,1850,8740,10196,10590,1340,60,60
4,2.25,1740,8449,1,0,0,4,7,1170,570,47.6079,-122.123,1980,11175,10189,13155,1740,61,61
4,1.5,1770,6650,1,0,0,3,7,1770,0,47.6011,-122.124,1600,7000,8420,8600,1770,61,61
5,1.75,2870,9680,1,0,4,5,9,1440,1430,47.6122,-122.111,2940,9729,12550,12669,2870,53,53
3,1.75,1300,8800,1,0,0,4,8,1300,0,47.6199,-122.116,1350,8800,10100,10150,1300,56,56
4,2.25,2050,9720,2,0,0,3,8,2050,0,47.5911,-122.119,2310,9680,11770,11990,2050,52,52
5,1.75,2000,8713,1,0,2,3,7,1000,1000,47.5882,-122.117,2040,8449,10713,10489,2000,57,57
3,1.75,1550,10050,1,0,0,5,7,1550,0,47.6345,-122.123,1720,10050,11600,11770,1550,62,62
4,1,1330,9715,1,0,0,4,7,970,360,47.6038,-122.122,1590,8400,11045,9990,1330,62,62
3,2.5,1090,7700,1,0,0,4,7,1090,0,47.607,-122.12,1740,7700,8790,9440,1090,62,62
4,2.25,1850,9911,1,0,0,4,7,1850,0,47.6019,-122.116,1650,8670,11761,10320,1850,62,62
3,2.25,1640,12000,1,0,0,3,7,1180,460,47.6252,-122.104,1620,12000,13640,13620,1640,52,52
3,1,1160,8800,1,0,0,4,7,1160,0,47.6112,-122.128,1750,8400,9960,10150,1160,60,60
3,1.75,1560,8968,1,0,0,4,8,1560,0,47.6243,-122.1,1990,8034,10528,10024,1560,47,47
4,2.5,2490,8750,2,0,0,3,8,2040,450,47.5931,-122.116,2120,10240,11240,12360,2490,43,43
3,2.75,2030,7700,1,0,0,5,8,1400,630,47.626,-122.112,1780,8160,9730,9940,2030,54,54
4,1.75,1880,7953,1,0,0,4,7,1880,0,47.5838,-122.123,1750,8591,9833,10341,1880,54,54
3,1.75,1670,7210,1,0,0,5,8,1670,0,47.6344,-122.116,2200,7210,8880,9410,1670,52,52
3,3.5,2620,11148,2,0,4,4,9,2060,560,47.5845,-122.115,2590,10796,13768,13386,2620,42,42
3,2,1400,7293,1,0,0,4,7,1400,0,47.586,-122.12,1600,7960,8693,9560,1400,56,56
4,1.5,1550,9176,1,0,0,3,7,1000,550,47.6005,-122.129,1730,8539,10726,10269,1550,63,63
3,1.75,1580,9147,1,0,1,4,7,1210,370,47.6069,-122.112,2600,23564,10727,26164,1580,52,52
3,2.5,2770,10773,2,0,2,3,9,2770,0,47.5754,-122.12,2530,10423,13543,12953,2770,27,27
4,2.25,2380,5250,1,0,0,4,7,1410,970,47.6164,-122.115,2150,8560,7630,10710,2380,58,58
4,1.75,2260,11000,1,0,0,3,8,1620,640,47.6224,-122.109,1960,10000,13260,11960,2260,43,43
3,1.75,1980,13503,1,0,2,4,9,1320,660,47.5867,-122.111,2450,10890,15483,13340,1980,67,67
3,2.5,2960,9350,2,0,2,4,9,2960,0,47.6218,-122.094,2960,11745,12310,14705,2960,41,41
4,2.5,1320,7000,1,0,0,4,7,1320,0,47.6007,-122.127,1550,8610,8320,10160,1320,63,63
5,2.5,2260,10087,1,0,0,3,8,1520,740,47.5982,-122.128,2500,9440,12347,11940,2260,52,52
3,2.75,2870,6600,2,0,2,3,8,2870,0,47.5745,-122.113,2570,7925,9470,10495,2870,35,35
3,1,1220,7200,1,0,0,4,7,1220,0,47.6218,-122.116,1320,7200,8420,8520,1220,54,54
4,2.25,2080,8000,1,0,0,3,8,1390,690,47.6264,-122.113,1800,7700,10080,9500,2080,55,55
5,2.5,1900,7843,2,0,0,5,7,1900,0,47.6273,-122.123,1900,7350,9743,9250,1900,53,53
4,1.75,1460,9750,1,0,0,4,7,1460,0,47.6205,-122.102,1820,9840,11210,11660,1460,52,52
3,2,2290,9450,1,0,0,3,9,1670,620,47.5692,-122.1,2750,11700,11740,14450,2290,40,40
5,3.5,5960,13703,2,0,2,3,10,4770,1190,47.6151,-122.107,2810,17320,19663,20130,5960,35,35
2,2.25,1800,2819,2,0,2,4,9,1800,0,47.6104,-122.113,1800,2755,4619,4555,1800,40,40
4,1.75,1930,9310,1,0,0,4,9,1930,0,47.6158,-122.108,2110,10290,11240,12400,1930,51,51
3,2.25,1960,10682,1,0,0,3,7,1960,0,47.6319,-122.124,1540,10682,12642,12222,1960,62,62
3,1,1210,6650,1,0,0,3,6,1210,0,47.6214,-122.12,990,7590,7860,8580,1210,60,60
3,1.5,1260,10350,1,0,0,3,7,1260,0,47.6357,-122.123,1800,10350,11610,12150,1260,60,60
5,3,3640,8239,2,0,3,3,10,2540,1100,47.5842,-122.111,3330,10643,11879,13973,3640,37,37
5,2.5,3240,9960,1,0,1,3,8,2020,1220,47.5858,-122.112,2730,10400,13200,13130,3240,61,61
3,1.5,1510,7642,1,0,0,3,7,1510,0,47.5978,-122.116,2180,8357,9152,10537,1510,60,60
4,2.75,2650,8610,2,0,0,3,8,2650,0,47.6155,-122.121,1680,8316,11260,9996,2650,60,8
3,2.75,1310,7300,1,0,0,3,7,1310,0,47.6016,-122.123,1310,7030,8610,8340,1310,62,62
3,1.75,1150,7700,1,0,0,3,7,1150,0,47.6048,-122.121,1650,8000,8850,9650,1150,62,62
4,2.5,2110,13939,1,0,0,3,8,1270,840,47.6431,-122.113,2140,8882,16049,11022,2110,41,41
3,1.75,1810,7950,1,0,0,4,7,1810,0,47.6236,-122.117,1680,7725,9760,9405,1810,51,51
4,2.25,2130,7210,1,0,0,5,7,1330,800,47.629,-122.117,1310,7896,9340,9206,2130,54,54
3,2,2020,8118,1,0,0,3,7,1020,1000,47.5866,-122.118,1670,8118,10138,9788,2020,56,56
3,2.5,2850,19593,1,1,4,3,10,1790,1060,47.5894,-122.111,2850,18782,22443,21632,2850,41,41
4,2.25,2340,5300,1,0,0,5,8,1700,640,47.6202,-122.112,1890,8250,7640,10140,2340,56,56
5,2.5,2070,12000,1,0,0,4,7,1340,730,47.626,-122.104,2090,12000,14070,14090,2070,52,52
3,1.75,1800,8000,1,0,0,3,8,1800,0,47.6357,-122.119,1950,8500,9800,10450,1800,47,47
4,2.25,2820,9602,1,0,1,3,8,1950,870,47.5881,-122.113,2890,9602,12422,12492,2820,45,45
3,1.75,1250,7030,1,0,0,3,7,1250,0,47.6285,-122.118,1460,7210,8280,8670,1250,54,54
4,2,1660,12377,1,0,0,3,8,1660,0,47.6231,-122.102,1820,8968,14037,10788,1660,53,53
4,1.75,2330,8800,1,0,2,4,7,1260,1070,47.6148,-122.113,2270,8800,11130,11070,2330,58,58
4,1.75,1980,7840,1,0,0,4,7,990,990,47.6226,-122.115,1520,8400,9820,9920,1980,58,58
4,2.25,1890,8034,1,0,0,4,8,1890,0,47.6338,-122.117,1920,7210,9924,9130,1890,52,52
4,1,1550,7260,1,0,0,4,6,1550,0,47.6229,-122.121,1210,7260,8810,8470,1550,60,60
3,1.75,1220,7370,1,0,0,4,7,1220,0,47.6334,-122.12,1580,8213,8590,9793,1220,55,55
4,2.25,1890,7210,1,0,0,3,8,1890,0,47.6342,-122.117,1920,7210,9100,9130,1890,52,52
3,1.75,1230,10005,1,0,0,4,7,1230,0,47.621,-122.114,1530,8560,11235,10090,1230,56,56
4,1.5,1340,6200,1,0,0,5,6,1340,0,47.6214,-122.119,1210,7178,7540,8388,1340,60,60
4,1.75,2230,7957,1,0,0,4,7,2230,0,47.5859,-122.122,2230,8040,10187,10270,2230,52,52
4,2.75,1950,6930,1,0,2,4,7,1250,700,47.616,-122.113,1950,8560,8880,10510,1950,59,59
3,2,1910,9001,1,0,0,4,7,1910,0,47.6037,-122.119,2040,8700,10911,10740,1910,62,62
4,1.75,1680,6758,1,0,0,3,8,1680,0,47.641,-122.113,1910,7000,8438,8910,1680,45,45
4,1.75,1910,8250,1,0,0,4,7,1910,0,47.6131,-122.123,1500,8250,10160,9750,1910,60,60
6,2.5,2890,8122,1,0,0,3,8,1630,1260,47.5886,-122.113,2730,9915,11012,12645,2890,42,42
3,1.75,1830,7371,1,0,0,3,7,1830,0,47.6059,-122.121,1600,7700,9201,9300,1830,62,62
3,2.5,1670,8023,1,0,0,5,7,1170,500,47.615,-122.117,1960,8964,9693,10924,1670,59,59
3,1.75,1360,5445,1,0,0,4,7,1360,0,47.6071,-122.123,1570,7840,6805,9410,1360,62,62
5,3,2520,13001,2,0,1,3,8,2010,510,47.6385,-122.114,2170,8215,15521,10385,2520,46,46
4,2.5,2810,11560,1,0,0,5,7,1740,1070,47.5846,-122.12,1970,11560,14370,13530,2810,57,57
5,2.25,2070,10488,1,0,0,4,7,1080,990,47.6095,-122.122,1740,9225,12558,10965,2070,61,61
4,2.5,2280,9491,1,0,0,4,7,1290,990,47.6297,-122.117,1560,8050,11771,9610,2280,53,53
3,1,940,7910,1,0,0,4,6,940,0,47.6181,-122.117,1000,7700,8850,8700,940,60,60
3,2.25,1880,10880,1,0,0,3,8,1480,400,47.5937,-122.116,2120,10240,12760,12360,1880,44,44
3,1.75,1520,8835,1,0,0,4,7,1520,0,47.6054,-122.118,1760,8580,10355,10340,1520,62,62
6,2.75,2040,8560,1,0,2,4,7,1100,940,47.616,-122.115,2230,8560,10600,10790,2040,58,58
3,1.75,1820,9875,1,0,0,4,8,1820,0,47.6243,-122.094,2670,10000,11695,12670,1820,53,53
4,1.75,2070,9120,1,0,0,4,7,1250,820,47.6045,-122.123,1650,8400,11190,10050,2070,61,61
3,1.75,1850,8823,1,0,0,4,8,1370,480,47.6379,-122.112,1880,7580,10673,9460,1850,46,46
3,2.5,2200,11000,2,0,2,3,9,2200,0,47.5916,-122.112,2200,12851,13200,15051,2200,41,41
4,2.5,3320,244807,2,0,0,3,9,3320,0,47.3637,-121.955,2530,217800,248127,220330,3320,18,18
3,1.75,1250,10122,1,0,0,3,7,1250,0,47.3277,-122.001,1980,10175,11372,12155,1250,25,25
3,2,2090,42689,1,0,0,3,7,2090,0,47.3497,-121.944,1890,18276,44779,20166,2090,60,16
3,1.75,1850,26445,1,0,0,4,7,1850,0,47.3412,-122.051,2110,23280,28295,25390,1850,57,38
3,2,2420,208652,1,0,0,3,8,2420,0,47.3666,-121.978,3180,212137,211072,215317,2420,14,14
3,1.75,1580,19998,1,0,0,4,7,1580,0,47.3299,-122.046,1860,19998,21578,21858,1580,51,51
4,3,3350,199253,2,0,0,3,10,3350,0,47.3602,-121.988,3350,183897,202603,187247,3350,15,15
3,2.5,2680,327135,2,0,0,3,8,2680,0,47.3783,-122.003,2020,60080,329815,62100,2680,24,24
3,2,1420,9828,1,0,0,4,7,1420,0,47.3287,-122.011,1550,7227,11248,8777,1420,29,29
3,1,1250,18616,1,0,0,4,6,1250,0,47.3414,-122.047,1920,15654,19866,17574,1250,47,47
3,2,1190,10299,1,0,0,3,7,1190,0,47.314,-122,1700,9849,11489,11549,1190,25,25
4,2.5,3400,247421,2,0,0,3,9,3400,0,47.3623,-121.971,3180,222156,250821,225336,3400,18,18
3,1,1360,9948,1,0,0,3,6,1360,0,47.3422,-122.053,1670,8475,11308,10145,1360,42,42
3,1,1360,13000,1,0,0,5,6,1360,0,47.3359,-122.033,1890,19650,14360,21540,1360,74,74
5,2.5,2200,8500,1,0,0,4,7,1400,800,47.3073,-122.006,1360,8855,10700,10215,2200,48,48
3,1,960,10815,1,0,0,5,5,960,0,47.3091,-122.006,1330,10815,11775,12145,960,119,119
2,1,1300,11867,1,0,0,4,6,1300,0,47.3221,-121.903,820,11867,13167,12687,1300,44,44
4,2.5,3420,222156,2,0,0,3,9,3420,0,47.3608,-121.97,3340,222156,225576,225496,3420,17,17
1,1,850,6567,1,0,0,4,6,850,0,47.327,-122.039,2160,9794,7417,11954,850,79,79
4,1.5,1470,70800,1,0,0,3,7,1470,0,47.3458,-121.948,1810,72337,72270,74147,1470,43,43
2,1,1220,7250,1,0,0,4,6,1220,0,47.3585,-121.975,1350,20250,8470,21600,1220,105,105
4,2.5,2990,7928,2,0,0,3,9,2990,0,47.3139,-122.024,2810,7401,10918,10211,2990,8,8
3,1.75,1740,46580,1,0,0,4,7,1740,0,47.3583,-121.927,1576,54685,48320,56261,1740,39,39
3,2.5,1690,10336,2,0,0,4,7,1690,0,47.311,-122.003,1580,7700,12026,9280,1690,30,30
3,2,1300,9644,1,0,0,3,7,1300,0,47.3131,-121.998,1430,9656,10944,11086,1300,25,25
4,2.5,1904,8200,2,0,0,5,7,1904,0,47.3107,-122.001,1560,12426,10104,13986,1904,20,20
3,1,1570,9650,1,0,0,5,5,1570,0,47.3531,-121.982,1330,9650,11220,10980,1570,97,97
3,1.75,1750,7020,2,0,0,3,7,1750,0,47.3264,-122.038,1170,9546,8770,10716,1750,85,36
4,2.5,2610,7227,2,0,0,3,9,2610,0,47.314,-122.023,2630,7421,9837,10051,2610,8,8
3,2.5,2235,43560,1,0,0,5,7,990,1245,47.3326,-122.046,1460,29621,45795,31081,2235,44,44
3,1.75,2600,7668,1,0,0,4,8,1300,1300,47.3402,-122.046,1980,13664,10268,15644,2600,51,51
3,1.75,2700,18893,1,0,0,4,7,2110,590,47.3397,-122.048,2260,17494,21593,19754,2700,71,32
5,3,2680,9624,2,0,0,3,7,1870,810,47.3279,-122.006,1860,9921,12304,11781,2680,24,24
4,2.25,3060,48787,2,0,0,3,8,3060,0,47.3397,-121.918,2090,48787,51847,50877,3060,27,27
4,2.5,3600,155509,2,0,0,3,9,3600,0,47.3538,-121.986,3410,34412,159109,37822,3600,15,15
3,2.5,2390,15084,2,0,0,3,8,2390,0,47.3389,-122.048,1850,17494,17474,19344,2390,19,19
4,3.5,3420,49223,2,0,0,3,9,3420,0,47.3534,-121.992,3580,49223,52643,52803,3420,15,15
2,0.75,520,6862,1,0,0,4,4,520,0,47.326,-122.037,1170,8756,7382,9926,520,95,34
4,2.5,3410,179419,2,0,0,3,10,3410,0,47.3602,-121.986,3350,175421,182829,178771,3410,15,15
3,1,1020,9147,1,0,0,4,6,1020,0,47.3127,-122.002,1600,9700,10167,11300,1020,119,49
3,1.5,1980,10203,1,0,0,4,7,1680,300,47.3402,-122.046,1980,13664,12183,15644,1980,73,73
3,1.75,1070,7200,1,0,0,3,7,1070,0,47.3129,-122.023,1280,7200,8270,8480,1070,25,25
2,1,840,12252,1,0,0,3,6,840,0,47.3069,-122.013,1010,11876,13092,12886,840,25,25
3,2.5,1680,10300,2,0,0,4,7,1680,0,47.314,-122.001,1680,9849,11980,11529,1680,25,25
3,2.5,3160,286181,2,0,3,3,9,3160,0,47.3401,-121.946,2110,94663,289341,96773,3160,17,17
3,1.75,1340,196020,1,0,0,4,7,1340,0,47.2931,-121.992,2250,232230,197360,234480,1340,32,32
4,2.75,2950,49658,1,0,0,4,8,2950,0,47.3596,-121.922,1720,54672,52608,56392,2950,59,16
2,1.5,1750,19709,1,0,0,4,8,1440,310,47.3351,-122.044,1950,21075,21459,23025,1750,41,41
4,2.75,3110,49765,1,0,0,4,8,3110,0,47.3343,-122.044,1880,19709,52875,21589,3110,61,42
3,1.75,1500,11968,1,0,0,3,6,1500,0,47.3095,-122.002,1320,11303,13468,12623,1500,5,5
4,1.75,2020,16120,1,0,0,3,7,2020,0,47.3413,-122.048,1940,16350,18140,18290,2020,50,50
3,2.75,2480,209199,1,0,0,3,8,1870,610,47.3085,-121.888,2040,219229,211679,221269,2480,19,19
2,1,1160,32251,1,0,0,3,6,580,580,47.3537,-121.939,1160,33656,33411,34816,1160,56,14
4,2.75,2490,9714,1,0,0,4,8,1400,1090,47.7496,-122.201,2060,15300,12204,17360,2490,36,36
3,3.25,2960,39370,2,0,0,3,10,2960,0,47.7452,-122.202,2960,56628,42330,59588,2960,30,30
4,1.75,2250,8580,1,0,0,4,7,1330,920,47.7633,-122.199,2250,10032,10830,12282,2250,61,61
4,1.75,2410,8400,1,0,0,3,7,1600,810,47.7341,-122.2,1850,8400,10810,10250,2410,41,41
4,1.75,2160,19283,2,0,0,3,8,2160,0,47.7603,-122.169,1990,9744,21443,11734,2160,38,38
3,2.5,1970,12205,2,0,0,4,8,1970,0,47.7397,-122.209,2640,9636,14175,12276,1970,29,29
2,2,2260,9604,1,0,0,3,9,2260,0,47.7718,-122.208,2260,10747,11864,13007,2260,29,29
5,2.25,2480,12614,1,0,0,4,8,1860,620,47.7393,-122.2,2470,12392,15094,14862,2480,40,40
3,2.5,2430,12997,2,0,0,3,9,2430,0,47.744,-122.194,2720,12500,15427,15220,2430,27,27
3,1.75,1120,9730,1,0,0,3,7,1120,0,47.7372,-122.221,2530,8717,10850,11247,1120,75,25
3,1.75,1950,8325,1,0,0,4,7,1950,0,47.7685,-122.2,1950,8325,10275,10275,1950,57,57
5,3.5,3160,5175,2,0,0,3,9,3160,0,47.755,-122.216,2100,9351,8335,11451,3160,5,5
5,1.75,1550,10500,1,0,0,3,7,1100,450,47.7573,-122.22,1420,9823,12050,11243,1550,58,58
2,2,1380,5840,1,0,0,3,7,1380,0,47.7732,-122.172,1810,5035,7220,6845,1380,31,31
2,1,1400,10800,1,0,0,4,7,1400,0,47.7726,-122.21,1560,11280,12200,12840,1400,45,45
3,2.25,1650,4859,2,0,0,3,7,1650,0,47.7729,-122.172,1890,5018,6509,6908,1650,31,31
3,2,1910,11576,1,0,0,3,7,1410,500,47.7356,-122.198,2040,8750,13486,10790,1910,41,41
3,1.75,1970,9135,1,0,0,4,7,1370,600,47.7603,-122.215,1880,9650,11105,11530,1970,58,58
3,1.75,1270,8422,1,0,0,3,7,1270,0,47.7601,-122.197,1470,8500,9692,9970,1270,52,52
3,2.5,2660,10637,2,0,0,3,9,2660,0,47.7383,-122.22,2590,8637,13297,11227,2660,28,28
3,1.5,1540,7200,1,0,0,3,7,1540,0,47.7357,-122.195,1560,7500,8740,9060,1540,51,51
3,2.5,2280,18241,1,0,0,3,9,960,1320,47.7453,-122.213,3100,12465,20521,15565,2280,24,24
4,2.25,2210,8862,1,0,0,4,8,1270,940,47.7725,-122.198,2030,8862,11072,10892,2210,42,42
4,2,2070,10800,2,0,0,3,7,2070,0,47.7264,-122.237,1880,10800,12870,12680,2070,37,37
5,1,2170,65340,1,0,0,4,7,1670,500,47.7555,-122.204,3170,12884,67510,16054,2170,89,89
4,2.25,2200,6967,2,0,0,3,8,2200,0,47.7355,-122.202,1970,7439,9167,9409,2200,33,33
3,2.5,1630,11592,2,0,0,3,8,1630,0,47.7574,-122.228,1700,8850,13222,10550,1630,32,32
4,2.5,3350,6605,2,0,0,3,8,2670,680,47.7498,-122.181,2730,5962,9955,8692,3350,29,29
2,1,1180,10800,1,0,0,3,7,1180,0,47.7273,-122.236,1600,10800,11980,12400,1180,35,35
4,2.25,2570,9503,2,0,0,3,8,2570,0,47.764,-122.167,1950,9600,12073,11550,2570,39,39
3,1.75,2200,8036,1,0,0,3,7,1270,930,47.7763,-122.209,1850,7563,10236,9413,2200,41,41
4,2.75,2910,6308,1,0,0,3,8,1640,1270,47.7352,-122.201,1970,7127,9218,9097,2910,34,34
3,2.5,2090,8653,2,0,0,3,8,2090,0,47.7498,-122.184,2090,6396,10743,8486,2090,30,30
3,2.75,2020,9505,1,0,0,3,7,1260,760,47.7399,-122.197,2080,11901,11525,13981,2020,50,50
4,2.5,2590,8483,2,0,0,3,9,2590,0,47.738,-122.221,2660,8717,11073,11377,2590,28,28
3,2.5,2550,10355,2,0,0,3,9,2550,0,47.739,-122.203,2550,10084,12905,12634,2550,29,29
4,1.75,1570,8268,1,0,0,3,7,1570,0,47.7373,-122.197,1870,8190,9838,10060,1570,40,40
3,3,2410,12183,2,0,0,3,9,2410,0,47.747,-122.177,2540,9979,14593,12519,2410,31,31
3,1.75,2030,13700,1,0,0,3,8,1630,400,47.7726,-122.197,2120,11200,15730,13320,2030,43,43
4,2.5,2830,10677,2,0,0,3,9,2830,0,47.742,-122.208,2970,9619,13507,12589,2830,26,26
3,2.5,1870,5449,2,0,0,3,8,1870,0,47.7557,-122.22,2000,7687,7319,9687,1870,16,16
3,2.5,2530,8116,2,0,0,3,8,2530,0,47.7597,-122.167,2280,8791,10646,11071,2530,18,18
3,2.5,1900,7984,2,0,0,3,8,1900,0,47.7433,-122.194,2650,9352,9884,12002,1900,26,26
4,2.5,1910,8947,1,0,0,4,8,1160,750,47.7374,-122.183,1920,7350,10857,9270,1910,49,49
5,2.5,2210,9655,1,0,0,3,8,1460,750,47.7698,-122.222,2080,8633,11865,10713,2210,43,43
2,1.5,1140,14373,1,0,0,3,7,1140,0,47.7354,-122.219,2140,9860,15513,12000,1140,70,18
4,2.5,2940,6000,2,0,0,3,8,2940,0,47.7533,-122.198,2510,6600,8940,9110,2940,19,19
4,2.5,2360,4367,2,0,0,3,8,2360,0,47.7731,-122.167,2360,4868,6727,7228,2360,16,16
4,2.5,2090,4196,2,0,0,3,8,2090,0,47.7453,-122.192,2640,4503,6286,7143,2090,13,13
3,2,1700,10000,2,0,0,3,8,1700,0,47.7661,-122.205,1460,9621,11700,11081,1700,27,27
4,2.5,2590,9354,2,0,0,4,9,2590,0,47.7703,-122.193,2730,9264,11944,11994,2590,26,26
3,2,3000,21883,2,0,0,3,7,1970,1030,47.7599,-122.214,2280,14025,24883,16305,3000,21,21
3,1.75,1780,8085,1,0,0,3,7,1210,570,47.7357,-122.197,1780,8085,9865,9865,1780,43,43
4,2.25,2230,8440,2,0,0,4,8,2230,0,47.7558,-122.217,2160,9412,10670,11572,2230,51,51
4,2.75,2150,9820,1,0,0,4,8,1220,930,47.7758,-122.2,2060,9830,11970,11890,2150,40,40
3,2.5,2270,9600,2,0,0,3,9,2270,0,47.7388,-122.206,2580,9617,11870,12197,2270,29,29
3,2.5,2120,4512,2,0,0,3,8,2120,0,47.75,-122.183,2000,4553,6632,6553,2120,31,31
4,2.25,2330,19436,2,0,0,3,8,2330,0,47.7663,-122.215,1910,10055,21766,11965,2330,32,32
3,1.75,2560,8400,1,0,0,3,7,1970,590,47.7668,-122.197,1970,8400,10960,10370,2560,60,60
3,2.5,2180,4533,2,0,0,3,7,2180,0,47.754,-122.215,2180,7347,6713,9527,2180,9,9
3,2.5,1980,39932,2,0,0,3,8,1980,0,47.7433,-122.196,2610,12769,41912,15379,1980,25,25
4,2.5,2450,5280,2,0,0,3,8,2450,0,47.7734,-122.224,2300,4674,7730,6974,2450,16,16
5,2.5,2990,15085,2,0,0,3,9,2990,0,47.746,-122.218,3150,13076,18075,16226,2990,12,12
3,1.75,4000,11894,1,0,0,3,9,2190,1810,47.7738,-122.203,2530,8650,15894,11180,4000,32,32
3,2,1540,8011,1,0,0,3,7,1540,0,47.7342,-122.202,1630,7141,9551,8771,1540,31,31
3,2.5,1960,9535,2,0,0,3,8,1960,0,47.7371,-122.215,2520,9206,11495,11726,1960,30,30
3,2.25,2550,8588,1,0,4,3,9,2550,0,47.7711,-122.195,3050,8588,11138,11638,2550,30,30
5,1.5,1700,7200,1,0,0,3,7,1700,0,47.7614,-122.203,1460,7194,8900,8654,1700,82,82
5,3,3490,6091,2,0,0,3,9,3490,0,47.7744,-122.225,2870,5932,9581,8802,3490,10,10
4,2.25,2800,10800,1,0,0,3,8,1680,1120,47.7448,-122.177,2260,9800,13600,12060,2800,42,42
3,1.75,2590,8384,1,0,0,4,8,1590,1000,47.7739,-122.199,2590,8800,10974,11390,2590,48,48
5,3.5,3150,10542,1,0,0,5,9,1620,1530,47.7469,-122.217,3150,11807,13692,14957,3150,45,45
3,1,1270,8400,1,0,0,3,7,1270,0,47.7604,-122.198,1390,8400,9670,9790,1270,64,64
2,1,990,15120,1,0,0,4,6,990,0,47.7669,-122.206,1300,11500,16110,12800,990,66,66
3,2,1530,8925,1,0,0,3,7,1530,0,47.736,-122.199,2040,8856,10455,10896,1530,42,42
5,2.75,3360,12080,2,0,0,3,9,3360,0,47.7757,-122.173,3360,9724,15440,13084,3360,5,5
3,2.25,1580,8659,1,0,0,4,7,1220,360,47.7599,-122.215,1970,9650,10239,11620,1580,58,58
4,2,2120,9442,1,0,0,5,7,1060,1060,47.7675,-122.226,1290,9600,11562,10890,2120,51,51
6,2.5,3610,12033,2,0,0,3,8,3210,400,47.7692,-122.219,2210,8577,15643,10787,3610,49,49
3,3.25,3050,12700,2,0,0,3,8,2240,810,47.7445,-122.214,3050,12386,15750,15436,3050,29,29
4,2.25,2350,7210,1,0,0,4,7,2350,0,47.7407,-122.183,1930,7519,9560,9449,2350,47,47
4,2.5,2329,9436,2,0,0,3,9,2329,0,47.7366,-122.204,2660,10252,11765,12912,2329,24,24
4,2.25,2190,6800,1,0,0,5,7,1340,850,47.7367,-122.195,1560,7611,8990,9171,2190,50,50
3,2.25,1600,7620,1,0,0,3,7,1280,320,47.774,-122.208,1600,8215,9220,9815,1600,32,32
5,3.5,4495,10079,2,0,0,3,9,3580,915,47.7339,-122.209,4495,10079,14574,14574,4495,6,6
4,2.5,2190,3855,2,0,0,3,8,2190,0,47.7705,-122.169,2190,3600,6045,5790,2190,9,9
4,2.75,2310,7350,1,0,0,3,8,1670,640,47.7505,-122.182,2600,6077,9660,8677,2310,30,30
3,1.75,1620,8085,1,0,0,3,7,1210,410,47.7349,-122.197,1700,8085,9705,9785,1620,43,43
5,2.75,3360,9200,2,0,0,3,9,3360,0,47.7754,-122.173,3360,9713,12560,13073,3360,5,5
3,1.75,2020,8531,1,0,0,3,7,2020,0,47.7691,-122.199,1950,8449,10551,10399,2020,54,54
4,2.5,2180,7210,1,0,0,3,7,1190,990,47.7419,-122.181,2070,7210,9390,9280,2180,47,47
3,2.5,2810,4607,2,0,0,3,8,2810,0,47.7735,-122.227,2540,4871,7417,7411,2810,15,15
4,2.25,3070,9210,2,0,0,3,8,2740,330,47.7638,-122.196,2580,9660,12280,12240,3070,9,9
3,1.5,1200,8560,1,0,0,4,7,1200,0,47.7392,-122.194,1550,7800,9760,9350,1200,44,44
3,2.25,1650,7313,1,0,0,3,7,1220,430,47.7375,-122.194,1690,7252,8963,8942,1650,44,44
3,2.5,2250,7752,2,0,0,4,8,2250,0,47.7489,-122.185,2080,7033,10002,9113,2250,31,31
4,3,2010,8171,2,0,0,3,8,2010,0,47.7688,-122.218,2090,8203,10181,10293,2010,46,46
4,2.25,2240,8300,2,0,0,3,8,2240,0,47.7746,-122.197,2340,8500,10540,10840,2240,41,41
3,3.25,3800,13995,2,0,3,3,9,3800,0,47.7741,-122.203,2480,8434,17795,10914,3800,36,36
5,2.25,2710,22120,1,0,0,3,7,1410,1300,47.7642,-122.195,2850,12224,24830,15074,2710,64,64
4,2.5,2730,12261,2,0,0,3,9,2730,0,47.7419,-122.205,2730,10872,14991,13602,2730,28,28
3,2.25,1650,7800,1,0,0,3,7,1260,390,47.7377,-122.197,1760,8268,9450,10028,1650,50,50
4,1.75,1310,9690,1,0,0,4,7,1310,0,47.7559,-122.226,2280,9618,11000,11898,1310,52,52
5,2.5,3090,23265,1,0,0,3,8,2990,100,47.7709,-122.212,2560,18773,26355,21333,3090,62,62
3,1.75,1220,9732,1,0,0,3,7,1220,0,47.7736,-122.214,1630,10007,10952,11637,1220,54,54
4,2.25,2680,4673,2,0,0,3,7,2680,0,47.7539,-122.219,2460,4645,7353,7105,2680,20,20
5,2.75,3160,10059,2,0,0,3,10,1740,1420,47.7477,-122.217,3120,11557,13219,14677,3160,41,41
3,1.5,1200,7236,1,0,0,3,7,1200,0,47.739,-122.194,1680,7800,8436,9480,1200,44,44
6,2.5,2270,11970,1,0,0,3,7,1470,800,47.7722,-122.204,2270,10640,14240,12910,2270,55,55
3,2,1540,7947,1,0,0,3,7,1120,420,47.7605,-122.217,1910,7950,9487,9860,1540,58,58
3,2.5,2800,10603,2,0,0,3,9,2800,0,47.7528,-122.195,2580,10603,13403,13183,2800,18,18
4,2.5,2640,3899,2,0,0,3,7,2640,0,47.754,-122.217,2460,4057,6539,6517,2640,19,19
3,2.5,2600,7465,2,0,0,3,9,2600,0,47.7387,-122.217,2660,7683,10065,10343,2600,31,31
4,2,2400,6000,2,0,0,3,6,2400,0,47.7607,-122.209,1780,8732,8400,10512,2400,106,69
3,2.75,1820,9490,2,0,0,3,7,1820,0,47.7481,-122.178,1950,8851,11310,10801,1820,25,25
3,2.5,2830,56628,2,0,0,3,11,2830,0,47.7409,-122.198,2830,16430,59458,19260,2830,18,18
3,1,1010,10168,1,0,0,3,6,1010,0,47.6453,-121.912,1180,10318,11178,11498,1010,40,40
5,1.75,1930,501376,2,0,0,3,7,1930,0,47.6294,-121.911,1710,87120,503306,88830,1930,89,89
3,2,2350,266151,1,0,0,3,7,2350,0,47.6609,-121.892,2270,222156,268501,224426,2350,36,36
3,2.5,1778,147823,2,0,0,3,7,1778,0,47.6811,-121.915,2840,43676,149601,46516,1778,20,20
3,1,1140,3240,1,0,0,4,6,1140,0,47.7093,-121.364,1140,4700,4380,5840,1140,109,109
4,2.5,3130,60467,2,0,0,3,9,3130,0,47.6618,-121.962,2780,44224,63597,47004,3130,23,23
4,2,2180,17180,2,0,0,4,7,2180,0,47.698,-121.92,1880,14043,19360,15923,2180,42,42
3,1,1090,10000,1,0,0,3,6,1090,0,47.6503,-121.911,1040,7500,11090,8540,1090,58,58
4,2.5,2940,156988,2,0,2,3,9,1870,1070,47.6214,-121.946,2940,71002,159928,73942,2940,23,23
4,1.5,1220,9600,1,0,0,3,6,1220,0,47.6462,-121.909,1180,9000,10820,10180,1220,39,39
3,2.75,1840,68479,1,0,2,3,8,1340,500,47.6802,-121.908,2060,61903,70319,63963,1840,30,30
3,2.5,2840,48716,1,0,3,3,9,1870,970,47.6832,-121.915,2710,43676,51556,46386,2840,25,25
4,2.5,2430,42646,1,0,0,3,7,1450,980,47.6164,-121.953,2000,38159,45076,40159,2430,30,30
3,2.25,2020,21010,2,0,0,3,7,2020,0,47.6988,-121.915,1850,18151,23030,20001,2020,24,24
3,2.5,3360,218235,1,0,0,3,8,3360,0,47.6601,-121.946,2650,220849,221595,223499,3360,30,30
3,2.5,2630,185130,2,0,0,3,9,2630,0,47.7035,-121.894,2630,210394,187760,213024,2630,28,28
3,2.75,2150,31238,2,0,0,3,9,2150,0,47.6596,-121.96,2650,38307,33388,40957,2150,23,23
3,2.25,2750,219542,2,0,0,3,7,1870,880,47.6367,-121.948,2430,219542,222292,221972,2750,38,38
1,0.75,430,5050,1,0,0,2,4,430,0,47.6499,-121.909,1200,7500,5480,8700,430,107,107
3,1.75,1410,16105,1,0,0,3,7,1410,0,47.6927,-121.913,1550,18615,17515,20165,1410,37,37
3,2.5,2840,216493,2,0,0,3,9,2840,0,47.702,-121.892,2820,175111,219333,177931,2840,28,28
3,1.75,1730,15003,1,0,0,3,7,1150,580,47.6923,-121.92,1900,15483,16733,17383,1730,39,39
3,3.5,3600,37982,2,0,0,4,8,3600,0,47.6982,-121.917,2050,18019,41582,20069,3600,23,23
3,1.75,1790,66250,1,0,0,3,7,1790,0,47.7179,-121.403,1440,59346,68040,60786,1790,16,16
3,1,1260,5000,1,0,0,4,6,1260,0,47.6492,-121.915,1180,7500,6260,8680,1260,51,51
3,2,1670,17071,1,0,0,3,7,1100,570,47.69,-121.913,1660,15593,18741,17253,1670,31,31
3,1.75,1950,15037,1,0,0,3,7,1950,0,47.6892,-121.913,1760,15181,16987,16941,1950,30,30
2,1,900,7500,1,0,0,4,6,900,0,47.6481,-121.916,1190,10000,8400,11190,900,58,58
3,2,1570,14992,1,0,0,3,8,1570,0,47.6965,-121.922,1640,15000,16562,16640,1570,18,18
4,1.5,1530,9000,1,0,0,4,6,1530,0,47.6492,-121.908,1520,8500,10530,10020,1530,43,43
3,2.5,2560,16420,2,0,0,4,8,2560,0,47.6916,-121.916,2120,16298,18980,18418,2560,30,30
2,2,2100,58488,2,0,0,3,9,2100,0,47.72,-121.402,1440,59346,60588,60786,2100,14,14
2,1,930,12724,1,0,0,4,6,930,0,47.6567,-121.909,1240,21828,13654,23068,930,107,107
3,1,890,6488,1,0,0,3,5,890,0,47.7087,-121.352,1330,16250,7378,17580,890,91,91
3,2.5,1676,18778,2,0,0,3,7,1676,0,47.6521,-121.905,1410,18778,20454,20188,1676,22,22
3,2.5,1860,21876,2,0,0,3,8,1860,0,47.6455,-121.901,2450,21876,23736,24326,1860,27,27
3,2.5,2010,57934,1,0,0,3,7,2010,0,47.6262,-121.96,2040,55527,59944,57567,2010,41,41
4,2.5,2040,21781,2,0,0,3,8,2040,0,47.6458,-121.904,2410,21781,23821,24191,2040,25,25
5,3.5,3610,52595,2,0,0,4,7,3610,0,47.6832,-121.907,1620,60112,56205,61732,3610,30,30
3,3.25,3710,38509,2,0,0,3,10,3710,0,47.693,-121.868,1680,25865,42219,27545,3710,21,21
3,2,1850,16535,1,0,0,3,7,1850,0,47.6565,-121.912,1528,13295,18385,14823,1850,27,27
3,1,1300,6098,1,0,0,3,7,1300,0,47.7074,-121.364,1300,6849,7398,8149,1300,6,6
2,1.75,1160,2500,2,0,0,3,7,1160,0,47.6489,-121.911,970,7500,3660,8470,1160,11,11
4,2.5,2800,246114,2,0,0,3,9,2800,0,47.6586,-121.962,2750,60351,248914,63101,2800,20,20
2,1,1040,20524,1,0,3,3,6,1040,0,47.6981,-121.875,1880,38996,21564,40876,1040,70,25
3,1.75,1800,23103,1,0,0,3,7,1800,0,47.6517,-121.906,1410,18163,24903,19573,1800,51,51
3,2.5,3150,21893,2,0,0,3,9,3150,0,47.6455,-121.901,2280,21886,25043,24166,3150,13,13
3,2.75,2990,207781,2,0,0,3,9,2990,0,47.662,-121.944,2590,218671,210771,221261,2990,19,19
3,1,1710,19115,1,0,0,3,6,1710,0,47.656,-121.913,1650,15144,20825,16794,1710,33,33
4,4,5545,871200,2,0,0,3,11,3605,1940,47.676,-121.882,3420,871200,876745,874620,5545,16,16
4,2,1880,14653,2,0,0,3,8,1880,0,47.6959,-121.921,1750,14858,16533,16608,1880,41,41
3,1.75,1660,16275,2,0,0,3,7,1660,0,47.6903,-121.915,1520,16275,17935,17795,1660,29,29
3,2.5,3550,136343,2,0,0,3,10,3550,0,47.6223,-121.869,3080,215186,139893,218266,3550,42,42
2,1,960,87991,1,0,0,3,5,960,0,47.63,-121.9,1940,392040,88951,393980,960,73,73
3,1.75,2720,149410,1,0,0,3,9,2720,0,47.7092,-121.892,2560,149410,152130,151970,2720,31,31
3,2,2100,31550,1,0,0,3,8,2100,0,47.6907,-121.917,1860,18452,33650,20312,2100,9,9
3,1,1010,25000,1,0,0,3,6,1010,0,47.6927,-121.901,2020,101494,26010,103514,1010,53,53
3,0.75,490,38500,1,0,0,4,5,490,0,47.7112,-121.315,800,18297,38990,19097,490,60,60
2,1.75,1070,9750,1,0,0,3,7,1070,0,47.7131,-121.319,970,9750,10820,10720,1070,24,24
3,3,4120,60392,2,0,2,3,9,3180,940,47.6804,-121.913,2770,64033,64512,66803,4120,25,25
3,1.75,2930,266587,2,0,0,3,8,2440,490,47.6991,-121.947,2700,438213,269517,440913,2930,24,24
3,2.5,1450,11480,2,0,0,3,7,1450,0,47.672,-121.864,2080,87991,12930,90071,1450,29,29
3,2,2350,209088,1,0,0,3,7,2350,0,47.6527,-121.949,2300,209088,211438,211388,2350,26,26
2,1,1000,31505,1,0,0,3,6,1000,0,47.7659,-121.899,1560,22597,32505,24157,1000,59,59
3,2.5,2830,9972,2,0,0,3,9,2830,0,47.7382,-121.975,3557,9159,12802,12716,2830,13,13
3,2,2860,24046,1,0,0,3,9,1700,1160,47.7718,-121.904,1460,13648,26906,15108,2860,34,34
3,2.5,2370,5353,2,0,0,3,8,2370,0,47.7333,-121.975,2130,6850,7723,8980,2370,10,10
3,2.5,4040,8653,2,0,0,3,9,2900,1140,47.7378,-121.975,3360,8653,12693,12013,4040,13,13
4,2.5,2800,12831,2,0,0,3,8,2800,0,47.7392,-121.966,2810,10235,15631,13045,2800,18,18
3,2.5,2300,9521,2,0,0,3,8,2300,0,47.7447,-121.976,3020,10042,11821,13062,2300,16,16
4,2.5,3220,9328,2,0,0,3,8,3220,0,47.7273,-121.958,3020,9300,12548,12320,3220,13,13
3,1.5,2320,7500,1,0,0,3,7,2320,0,47.7413,-121.979,1480,10000,9820,11480,2320,43,43
2,1,1120,217800,1,0,0,3,6,1120,0,47.7378,-121.912,1480,217800,218920,219280,1120,43,43
4,2.5,2480,5100,2,0,0,3,8,2480,0,47.7383,-121.969,2270,5115,7580,7385,2480,12,12
4,2.5,1820,3134,2,0,0,3,7,1820,0,47.7351,-121.985,1820,3751,4954,5571,1820,20,20
3,2.5,2530,13446,2,0,0,3,9,2530,0,47.7345,-121.961,2450,13446,15976,15896,2530,26,26
5,2.5,2890,13104,2,0,0,3,8,2890,0,47.7277,-121.958,3020,9300,15994,12320,2890,13,13
4,2.5,2750,7200,2,0,0,3,8,2750,0,47.7327,-121.966,2750,7200,9950,9950,2750,8,8
3,2.25,1530,4580,2,0,0,3,7,1530,0,47.7342,-121.968,2110,4094,6110,6204,1530,8,8
4,2.75,2530,14178,2,0,0,3,8,2530,0,47.737,-121.955,2530,14055,16708,16585,2530,22,22
3,2.5,1870,5333,2,0,0,3,8,1870,0,47.7447,-121.984,2100,3730,7203,5830,1870,7,7
4,2.5,2860,14000,2,0,0,3,8,2860,0,47.7306,-121.973,2650,14564,16860,17214,2860,24,24
4,2.5,3040,20682,2,0,0,3,7,3040,0,47.7245,-121.959,2670,9742,23722,12412,3040,19,19
3,2,1400,218252,1,0,0,3,7,1400,0,47.7576,-121.934,2230,218222,219652,220452,1400,22,22
3,2.25,1760,7023,2,0,0,3,7,1760,0,47.7468,-121.98,1760,7082,8783,8842,1760,24,24
2,1.5,1440,22081,2,0,0,3,7,1440,0,47.7698,-121.896,1440,19544,23521,20984,1440,29,29
4,2.5,2850,6809,2,0,0,3,9,2850,0,47.7353,-121.973,2820,7500,9659,10320,2850,16,16
3,1.75,1720,5000,1,0,0,3,8,1720,0,47.738,-121.983,1410,8300,6720,9710,1720,87,5
3,2,1050,10072,1,0,0,3,7,1050,0,47.7341,-121.976,1130,10087,11122,11217,1050,33,33
3,2.25,1680,9766,2,0,0,3,7,1680,0,47.7341,-121.981,1590,9757,11446,11347,1680,30,30
1,1,1390,60984,1,0,0,3,6,1390,0,47.7652,-121.903,1620,24225,62374,25845,1390,59,59
3,2.25,1370,5000,2,0,0,3,7,1370,0,47.7372,-121.981,1600,7724,6370,9324,1370,29,29
2,1,1100,17817,1,0,0,3,7,620,480,47.7728,-121.9,1790,20009,18917,21799,1100,39,39
4,2.5,2303,16801,2,0,0,3,8,2303,0,47.7266,-121.966,2080,14013,19104,16093,2303,24,24
3,2.25,1550,5401,2,0,0,3,7,1550,0,47.737,-121.967,1740,4485,6951,6225,1550,19,19
3,3.25,2780,4002,2,0,0,3,8,2780,0,47.7348,-121.966,1890,4090,6782,5980,2780,10,10
3,1,1010,25277,1,0,0,5,5,1010,0,47.7242,-121.951,1570,213879,26287,215449,1010,58,58
4,2.5,2980,4074,2,0,0,3,8,2980,0,47.734,-121.965,2320,4255,7054,6575,2980,8,8
4,3.5,3080,118918,2,0,0,3,9,3080,0,47.7721,-121.924,1830,434728,121998,436558,3080,11,11
3,2.5,1800,14036,2,0,0,3,8,1800,0,47.7334,-121.97,2450,14025,15836,16475,1800,26,26
2,1.5,2730,19877,1,0,0,4,8,1570,1160,47.7698,-121.898,1450,19509,22607,20959,2730,43,43
3,2.5,1920,15260,2,0,0,3,7,1920,0,47.7317,-121.964,2370,15235,17180,17605,1920,29,29
4,2.5,3040,12522,2,0,0,3,7,3040,0,47.7247,-121.959,2490,9742,15562,12232,3040,19,19
3,1.75,2160,22702,1,0,0,4,7,2160,0,47.7355,-121.982,1820,22687,24862,24507,2160,38,38
3,1,1010,7838,1,0,0,4,6,1010,0,47.7422,-121.981,1380,8128,8848,9508,1010,42,42
4,2.5,2120,6497,2,0,0,3,7,2120,0,47.7241,-121.957,2230,6300,8617,8530,2120,16,16
5,3.5,3530,218472,2,0,0,3,7,2380,1150,47.7309,-121.905,2110,211404,222002,213514,3530,20,20
5,2.5,2630,9216,2,0,0,3,8,2630,0,47.7379,-121.966,2020,4980,11846,7000,2630,16,16
3,2.5,3090,384634,2,0,0,3,8,3090,0,47.7072,-121.927,2200,292645,387724,294845,3090,12,12
4,3,1930,3031,1,0,0,3,7,1200,730,47.7457,-121.985,1930,2611,4961,4541,1930,13,13
3,1.75,1830,10000,2,0,0,4,7,1830,0,47.741,-121.979,1480,10000,11830,11480,1830,106,50
4,2.5,2640,11816,2,0,0,3,8,2640,0,47.733,-121.968,2400,11816,14456,14216,2640,20,20
3,1.75,1220,216332,1,0,0,3,7,1220,0,47.7224,-121.926,1540,61419,217552,62959,1220,38,38
4,3.5,2730,5707,2,0,0,3,8,2000,730,47.7327,-121.965,2430,5899,8437,8329,2730,8,8
4,2.75,2280,5013,2,0,0,3,8,2280,0,47.7333,-121.976,2130,5121,7293,7251,2280,10,10
3,1.5,2700,24539,2,0,0,3,7,2120,580,47.7348,-121.984,1830,11000,27239,12830,2700,42,1
4,2.5,1770,13168,2,0,0,3,7,1770,0,47.7306,-121.966,2050,14859,14938,16909,1770,29,29
3,2,2220,209523,1,0,0,3,7,2220,0,47.7586,-121.911,1600,210830,211743,212430,2220,28,28
4,2.75,2520,14021,2,0,0,3,9,2520,0,47.7344,-121.957,2330,14007,16541,16337,2520,20,20
4,2.5,2260,6300,2,0,0,3,7,2260,0,47.7235,-121.958,2300,6300,8560,8600,2260,18,18
3,2.5,3380,7074,2,0,0,3,8,2200,1180,47.7462,-121.978,2060,6548,10454,8608,3380,20,20
2,2,2370,155130,1,0,0,3,7,2370,0,47.7388,-121.972,1860,14475,157500,16335,2370,49,49
3,2.75,2090,8354,2,0,0,3,8,2090,0,47.7336,-121.965,2280,6348,10444,8628,2090,7,7
4,2,1590,8779,1,0,0,3,8,1590,0,47.7408,-121.974,2090,9600,10369,11690,1590,18,18
5,3,2795,15101,2,0,0,3,8,2795,0,47.7301,-121.972,2750,14567,17896,17317,2795,23,23
4,2.75,3100,14568,2,0,0,3,8,3100,0,47.7302,-121.974,2860,14396,17668,17256,3100,24,24
3,2.5,1640,10424,2,0,0,3,7,1640,0,47.7345,-121.977,1560,10101,12064,11661,1640,31,31
4,2.5,2050,14724,2,0,0,3,7,2050,0,47.73,-121.969,1920,12841,16774,14761,2050,30,30
3,1,1640,26127,2,0,0,3,6,1640,0,47.7656,-121.905,1620,25788,27767,27408,1640,44,44
4,2.5,2755,11612,2,0,0,3,8,2755,0,47.7394,-121.965,2820,12831,14367,15651,2755,18,18
3,2.5,1970,3655,2,0,0,3,7,1970,0,47.7453,-121.984,1970,2952,5625,4922,1970,16,16
4,2.75,3470,212639,2,0,0,3,7,2070,1400,47.7066,-121.968,2370,233917,216109,236287,3470,26,26
3,2.5,1590,3359,2,0,0,3,7,1590,0,47.7349,-121.986,1820,3383,4949,5203,1590,19,19
3,1,1340,306848,1,0,0,3,5,1340,0,47.7534,-121.912,1800,128066,308188,129866,1340,66,66
1,1.5,1200,44866,1,0,0,3,7,1200,0,47.7205,-121.93,1480,67082,46066,68562,1200,36,36
4,2.5,2840,18001,2,0,0,3,9,2840,0,47.7359,-121.962,2500,18001,20841,20501,2840,25,25
3,2.5,1860,15457,2,0,0,3,8,1860,0,47.7383,-121.955,2040,14055,17317,16095,1860,22,22
3,2.5,1570,2577,2,0,0,3,7,1570,0,47.7456,-121.984,1970,2952,4147,4922,1570,14,14
3,2,2010,251341,2,0,0,3,8,1510,500,47.7416,-121.91,1780,108900,253351,110680,2010,16,16
4,2.5,2980,10459,2,0,0,3,9,2980,0,47.7354,-121.974,2920,7700,13439,10620,2980,18,18
4,2.5,2650,9065,2,0,0,3,7,2650,0,47.7258,-121.959,2590,13218,11715,15808,2650,19,19
3,2.25,1660,5128,2,0,0,3,7,1660,0,47.7362,-121.967,1680,4652,6788,6332,1660,18,18
1,1.75,1010,10900,1,0,0,4,6,1010,0,47.7391,-121.982,1410,8359,11910,9769,1010,51,51
4,2.75,2250,14149,2,0,0,3,9,2250,0,47.7353,-121.962,2450,14027,16399,16477,2250,27,27
3,2.25,1550,4411,2,0,0,3,7,1550,0,47.7373,-121.966,1620,4621,5961,6241,1550,18,18
3,1.75,1480,383328,1,0,0,3,8,1480,0,47.7192,-121.932,1480,67082,384808,68562,1480,39,39
3,2.25,1860,5028,2,0,0,3,8,1860,0,47.7318,-121.982,2320,5465,6888,7785,1860,7,7
1,0.75,850,5600,1,0,2,3,6,850,0,47.7654,-121.48,900,12250,6450,13150,850,116,21
4,2.25,1930,6508,2,0,0,3,8,1930,0,47.7458,-121.977,2170,6548,8438,8718,1930,23,23
4,3.75,4133,361548,2,0,0,3,11,4133,0,47.7479,-121.972,1970,291416,365681,293386,4133,19,19
3,2.5,1620,5992,2,0,0,3,7,1620,0,47.736,-121.965,1620,4644,7612,6264,1620,18,18
3,1.5,2605,12030,1,0,0,3,8,1355,1250,47.7725,-121.899,1590,15242,14635,16832,2605,16,16
5,2.5,2570,9962,2,0,0,3,8,2570,0,47.7275,-121.957,2890,9075,12532,11965,2570,13,13
3,2.25,1800,4500,2,0,0,3,7,1800,0,47.7462,-121.98,1760,6589,6300,8349,1800,24,24
4,2.5,2520,8515,2,0,0,3,7,2520,0,47.7233,-121.959,2130,6930,11035,9060,2520,20,20
4,4.25,5660,193593,2,0,0,3,10,4100,1560,47.7064,-121.981,3620,207141,199253,210761,5660,18,18
6,2,2840,228690,1,0,0,3,6,2720,120,47.7158,-121.966,2330,228690,231530,231020,2840,71,71
3,2.5,2040,14071,2,0,0,3,7,2040,0,47.7278,-121.963,1890,14040,16111,15930,2040,24,24
3,2.5,2130,5088,2,0,0,3,8,1840,290,47.7329,-121.976,2130,5762,7218,7892,2130,8,8
4,2.5,2200,6018,2,0,0,3,8,2200,0,47.7338,-121.966,2480,5899,8218,8379,2200,9,9
3,2.5,2100,3574,2,0,0,3,7,1690,410,47.7453,-121.984,1970,2962,5674,4932,2100,14,14
3,2.5,2370,12753,2,0,0,3,7,2370,0,47.7359,-121.984,2280,16808,15123,19088,2370,18,18
4,2.5,2340,12080,2,0,0,3,8,2340,0,47.7325,-121.969,2200,12403,14420,14603,2340,20,20
1,0.75,940,87120,1,0,0,3,6,940,0,47.7182,-121.956,1930,165528,88060,167458,940,75,75
3,3,2090,7634,1,0,0,3,8,1450,640,47.7408,-121.974,2090,9600,9724,11690,2090,18,18
3,1,1410,47916,1,0,0,3,7,1410,0,47.7149,-121.96,1810,215622,49326,217432,1410,38,38
4,3.25,2550,11524,2,0,0,3,8,2550,0,47.7324,-121.963,2370,14001,14074,16371,2550,29,29
4,2,1900,8160,1,0,0,3,7,1900,0,47.2114,-121.986,1280,6532,10060,7812,1900,44,44
4,2.25,1800,9018,2,0,0,3,7,1800,0,47.2126,-121.984,1670,9380,10818,11050,1800,27,27
3,1,1250,8276,1,0,0,5,6,1250,0,47.2092,-121.997,1250,8792,9526,10042,1250,80,80
4,2.5,1810,13000,1,0,0,4,8,1470,340,47.2202,-121.993,1850,13000,14810,14850,1810,42,42
3,1.75,1350,217852,1,0,0,3,8,1100,250,47.2628,-122.03,2190,217800,219202,219990,1350,66,66
3,2.5,1970,106722,1,0,4,3,9,1970,0,47.2498,-122.003,2910,101494,108692,104404,1970,34,34
4,2.5,3060,27251,1,0,0,3,8,3060,0,47.1967,-121.966,1760,27251,30311,29011,3060,11,11
3,2,1270,7198,1,0,0,3,7,1270,0,47.2086,-121.996,1160,7198,8468,8358,1270,103,1
4,2.5,2230,8500,2,0,0,3,8,2230,0,47.2082,-122.009,2270,8770,10730,11040,2230,25,25
3,2,1553,6550,1,0,0,3,7,1553,0,47.2056,-121.994,1010,10546,8103,11556,1553,119,14
3,1.5,1610,10291,1,0,0,4,7,1610,0,47.2025,-121.999,1410,7729,11901,9139,1610,58,58
3,2,1140,11161,1,0,0,4,7,1140,0,47.209,-122.012,1720,8587,12301,10307,1140,21,21
3,1.5,1670,10800,1,0,0,4,8,1670,0,47.2004,-122.003,1670,9169,12470,10839,1670,63,63
2,1,1140,74052,1,0,0,4,6,1140,0,47.2093,-121.962,1730,43560,75192,45290,1140,51,51
2,1.75,1280,37373,1,0,0,4,7,1280,0,47.2631,-122.019,2180,48351,38653,50531,1280,23,23
3,2.5,1980,9907,2,0,0,3,8,1980,0,47.1903,-122.013,2050,9907,11887,11957,1980,28,28
3,1,1000,223462,1,0,2,4,6,1000,0,47.2099,-122.043,1710,105850,224462,107560,1000,86,86
3,1,1510,4350,1,0,0,5,6,1510,0,47.2052,-121.987,1210,5500,5860,6710,1510,106,106
3,2.5,2440,71002,1,0,0,4,9,2440,0,47.2689,-122.01,3170,84000,73442,87170,2440,23,23
2,1.75,1130,276170,1,0,0,3,8,1130,0,47.2673,-122.027,2092,217800,277300,219892,1130,13,13
3,2,1390,6005,2,0,0,3,8,1390,0,47.2117,-121.99,1264,5550,7395,6814,1390,14,14
3,1.5,1420,9081,1,0,0,4,6,1420,0,47.1948,-121.999,1090,8410,10501,9500,1420,29,29
3,1.5,1790,229125,2,0,3,3,7,1790,0,47.2309,-122.009,1970,216928,230915,218898,1790,32,32
3,2,1590,87120,1,0,3,3,8,1590,0,47.2241,-122.072,2780,183161,88710,185941,1590,21,21
3,2.5,1430,8470,1,0,0,3,7,1190,240,47.1943,-121.991,1670,8418,9900,10088,1430,27,27
3,2,1670,4438,1,0,0,3,7,1670,0,47.1948,-121.974,1670,4558,6108,6228,1670,5,5
3,1,1170,9000,1,0,0,4,6,1170,0,47.2109,-121.987,1280,8160,10170,9440,1170,101,101
3,2.75,1360,542322,1,0,2,4,7,1140,220,47.2069,-122.024,1700,60548,543682,62248,1360,64,64
3,1.75,1160,7006,1,0,0,4,7,1160,0,47.1937,-121.98,1670,7750,8166,9420,1160,27,27
3,2,1680,8487,1,0,0,3,7,1680,0,47.1959,-122.01,2080,8560,10167,10640,1680,26,26
2,1.75,1020,10346,1,0,0,4,6,1020,0,47.1958,-122.002,1160,8610,11366,9770,1020,36,36
3,2,1990,203861,1,0,0,3,7,1990,0,47.2507,-122.039,2760,217800,205851,220560,1990,70,70
4,1.75,2140,11651,2,0,0,3,8,2140,0,47.196,-122.006,2030,10978,13791,13008,2140,89,13
2,1,800,5280,1,0,0,5,6,800,0,47.205,-121.995,1240,7670,6080,8910,800,101,101
2,1,1480,5325,1,0,0,4,7,1120,360,47.2079,-121.993,1670,5800,6805,7470,1480,94,94
4,1.75,1550,50094,1,0,3,4,6,1550,0,47.2194,-122.059,1720,50094,51644,51814,1550,52,52
4,2.5,2480,176418,1,0,3,5,8,2480,0,47.1941,-122.038,1640,112384,178898,114024,2480,92,92
3,2,1680,8424,1,0,0,3,7,1680,0,47.1969,-122.011,1990,8545,10104,10535,1680,26,26
3,2,1400,8821,1,0,0,3,7,1400,0,47.1949,-121.989,1450,8721,10221,10171,1400,28,28
3,2.5,2350,715690,1,0,0,4,9,2350,0,47.1622,-121.971,1280,325393,718040,326673,2350,40,40
4,2.5,2840,8746,2,0,0,3,8,2840,0,47.19,-122.013,2630,9900,11586,12530,2840,18,18
3,1,1260,7897,1,0,0,3,7,1260,0,47.1946,-122.003,1560,8285,9157,9845,1260,40,40
3,1,1140,8528,1,0,0,5,7,1140,0,47.2098,-122.004,1140,8112,9668,9252,1140,52,52
3,2.5,1820,8722,1,0,0,3,7,1820,0,47.2137,-121.989,1480,12285,10542,13765,1820,93,7
3,1,960,9633,1,0,0,5,6,960,0,47.1951,-122.001,1080,8610,10593,9690,960,37,37
4,2,1540,10212,1,0,0,5,7,1540,0,47.2056,-121.999,1480,10212,11752,11692,1540,71,71
3,1.75,3320,478288,1,0,3,4,8,2260,1060,47.2407,-121.953,2960,217800,481608,220760,3320,86,32
3,2,2010,33090,1,0,2,5,8,2010,0,47.2133,-122.007,1840,22620,35100,24460,2010,33,33
2,1,860,6000,1,0,0,3,6,860,0,47.2109,-121.985,1300,6000,6860,7300,860,74,74
4,2.5,2810,10433,2,0,0,3,8,2810,0,47.1895,-122.015,2640,9240,13243,11880,2810,18,18
3,1,1330,5412,2,0,0,5,7,1330,0,47.2053,-121.993,1710,10825,6742,12535,1330,114,114
2,1,820,16030,1,0,0,4,5,820,0,47.2039,-122.003,1880,14046,16850,15926,820,96,96
4,2,1870,6551,1,0,3,3,7,1870,0,47.1934,-121.977,2280,5331,8421,7611,1870,10,10
3,2.25,2160,9612,2,0,0,3,7,2160,0,47.1927,-122.011,1970,9247,11772,11217,2160,25,25
3,1.5,1550,9126,1,0,0,5,7,1550,0,47.2012,-122,1450,9282,10676,10732,1550,62,62
4,2.5,2050,8424,2,0,0,4,8,2050,0,47.196,-122.011,1970,8448,10474,10418,2050,26,26
2,1,740,3434,1,0,0,5,6,740,0,47.2088,-121.992,1160,6000,4174,7160,740,99,99
4,2,1960,30480,1,0,2,4,7,1060,900,47.1924,-121.988,1460,8914,32440,10374,1960,47,47
3,2.5,2000,9669,2,0,0,4,8,2000,0,47.1964,-122.009,1930,9202,11669,11132,2000,27,27
4,3.5,4370,37193,2,0,3,3,8,2780,1590,47.241,-121.979,2860,39356,41563,42216,4370,23,23
3,1.75,2092,250905,1,0,0,3,7,2092,0,47.2664,-122.027,2092,217800,252997,219892,2092,38,38
3,1.75,1300,7735,1,0,0,4,7,1300,0,47.1983,-122,1300,8941,9035,10241,1300,39,39
3,1.75,1670,24650,1,0,0,4,7,1670,0,47.1764,-122.026,1810,19465,26320,21275,1670,45,45
3,1.75,1390,8980,1,0,0,4,8,1390,0,47.2015,-122.005,1770,9085,10370,10855,1390,34,34
3,1.75,1120,98445,1,0,2,4,7,1120,0,47.1853,-122.017,1620,34200,99565,35820,1120,102,102
5,1.5,2520,5753,1,0,0,4,7,1510,1010,47.2058,-121.997,1620,6875,8273,8495,2520,91,91
3,1.75,1580,7875,1,0,0,3,7,1580,0,47.1958,-122.003,1560,8314,9455,9874,1580,40,40
5,3.5,3450,19080,2,0,3,3,9,3450,0,47.2123,-122.005,2570,17007,22530,19577,3450,18,18
3,2.5,1680,8512,2,0,0,3,7,1680,0,47.1952,-121.986,1580,8512,10192,10092,1680,28,28
3,2,2500,10697,1,0,0,3,8,2500,0,47.1927,-122.01,2560,9772,13197,12332,2500,25,25
3,2.5,2260,74297,2,0,0,3,9,2260,0,47.2704,-122.013,3110,98000,76557,101110,2260,27,27
4,2.5,2019,4435,2,0,3,3,8,2019,0,47.1958,-121.974,1950,4800,6454,6750,2019,11,11
3,2.5,1430,9044,2,0,0,3,7,1430,0,47.1956,-121.986,1580,8624,10474,10204,1430,28,28
3,1.75,1910,8329,1,0,0,3,8,1910,0,47.19,-122.016,2510,9259,10239,11769,1910,15,15
3,2.5,2620,4558,2,0,3,3,7,2620,0,47.1944,-121.974,1670,4558,7178,6228,2620,9,9
4,2.5,2170,204296,1,0,0,4,7,2170,0,47.281,-121.933,1760,154202,206466,155962,2170,39,39
3,2.5,3340,70131,2,0,0,3,9,2420,920,47.2666,-122.015,2760,116740,73471,119500,3340,25,25
4,1.5,2700,14760,1,0,0,5,9,2700,0,47.1996,-122.003,1670,7200,17460,8870,2700,79,79
4,2.5,2880,23994,2,0,3,3,9,2880,0,47.2124,-122.005,2470,17009,26874,19479,2880,17,17
3,1.5,1810,100188,1,0,0,5,7,1810,0,47.2175,-121.995,1540,40415,101998,41955,1810,50,50
3,2.5,2060,25046,1,0,0,4,8,1600,460,47.184,-121.959,2050,21255,27106,23305,2060,39,39
2,1,1400,9600,1,0,0,4,6,1400,0,47.2113,-121.993,1230,9600,11000,10830,1400,78,78
3,1.75,1570,8459,1,0,0,3,7,1570,0,47.2016,-122.006,1650,8844,10029,10494,1570,28,28
4,3.25,4400,186846,2,0,0,4,9,4400,0,47.1593,-121.957,2280,186846,191246,189126,4400,26,26
4,2.75,2690,9240,2,0,0,3,8,2690,0,47.1896,-122.014,2640,9240,11930,11880,2690,21,21
4,1.5,1860,5040,1,0,0,5,8,1860,0,47.2077,-121.993,1680,5800,6900,7480,1860,99,99
3,1.5,1570,6450,1,0,0,4,6,1570,0,47.2021,-121.996,1400,6450,8020,7850,1570,88,88
4,2.5,2740,8400,1,0,2,3,8,2740,0,47.1947,-122.008,2030,8638,11140,10668,2740,26,26
3,2.5,2490,18525,2,0,3,3,8,2490,0,47.2119,-122.001,1850,9516,21015,11366,2490,24,24
4,2.5,2100,8501,2,0,0,5,7,2100,0,47.1951,-122.01,2130,8560,10601,10690,2100,26,26
1,1,900,4368,1,0,0,5,6,900,0,47.2107,-121.99,1290,5000,5268,6290,900,104,65
3,1,1660,21514,1,0,0,4,7,1660,0,47.2159,-121.964,1660,21600,23174,23260,1660,46,46
2,1.75,1460,426450,1,0,0,5,7,960,500,47.2079,-121.967,1810,17350,427910,19160,1460,53,53
3,1,1530,389126,1,0,0,4,7,1530,0,47.1776,-122.011,1768,42148,390656,43916,1530,100,100
4,2,2490,339332,1,0,0,3,8,2490,0,47.2725,-121.929,1910,129373,341822,131283,2490,17,17
2,1,2360,105850,1,0,2,2,6,1180,1180,47.2495,-121.97,2640,386812,108210,389452,2360,72,72
4,3,2710,217800,2,0,0,3,9,2710,0,47.2411,-121.932,2710,217800,220510,220510,2710,13,13
2,1,1050,403365,1,0,3,5,6,1050,0,47.2221,-122.059,1760,108900,404415,110660,1050,114,114
3,2,3190,207346,2,0,0,3,9,3190,0,47.2737,-122.015,2930,206474,210536,209404,3190,25,25
3,2,1690,9516,1,0,0,3,7,1690,0,47.2132,-122.001,1850,9516,11206,11366,1690,22,22
3,1,1280,7198,1,0,0,5,6,1280,0,47.2094,-121.996,1260,7198,8478,8458,1280,103,31
2,2,1340,7605,1,0,0,3,7,1340,0,47.1936,-121.981,1670,7136,8945,8806,1340,27,27
3,1.5,1300,7600,1,0,0,4,7,1300,0,47.2083,-122.005,1570,7600,8900,9170,1300,56,56
6,3,2650,12870,1,0,0,4,7,2650,0,47.2069,-121.989,1450,8668,15520,10118,2650,42,42
2,1,1230,5000,1,0,0,5,6,1230,0,47.2064,-121.988,1230,5413,6230,6643,1230,108,108
2,1,890,6430,1,0,0,3,6,890,0,47.2003,-121.996,1460,6430,7320,7890,890,84,17
3,2,1670,4441,1,0,0,3,7,1670,0,47.1948,-121.975,1670,4622,6111,6292,1670,5,5
3,1.75,1660,37642,1,0,0,4,7,1660,0,47.2559,-122.007,2070,54450,39302,56520,1660,28,28
3,2.5,2770,98881,2,0,0,3,9,2770,0,47.2568,-121.952,1830,74923,101651,76753,2770,28,28
2,1,900,5000,1,0,0,5,6,900,0,47.2008,-121.995,1150,5000,5900,6150,900,89,25
4,2.25,2380,122038,2,0,0,4,8,2380,0,47.2624,-122.015,2030,48000,124418,50030,2380,35,35
6,3.25,4750,248600,2,0,0,4,8,4750,0,47.1879,-121.973,2230,311610,253350,313840,4750,72,72
3,2,2080,11375,1,0,0,3,8,2080,0,47.214,-121.993,1080,12899,13455,13979,2080,17,17
4,2,2030,103672,1,0,0,4,7,2030,0,47.1647,-121.973,1560,325393,105702,326953,2030,50,50
3,1,910,5800,1,0,0,4,5,910,0,47.2068,-121.992,1400,6766,6710,8166,910,119,119
3,2,1350,8587,1,0,0,3,7,1350,0,47.2073,-122.012,1350,8587,9937,9937,1350,21,21
4,2.75,3460,13168,2,0,0,4,8,3460,0,47.2046,-121.996,1500,7670,16628,9170,3460,87,29
3,1,1350,165092,1,0,3,5,6,1350,0,47.2217,-122.063,2300,211266,166442,213566,1350,94,94
4,2.75,2420,8438,2,0,0,3,8,2420,0,47.2091,-122.009,2420,8580,10858,11000,2420,23,23
3,2.5,2920,169448,2,0,0,3,9,2920,0,47.2492,-121.975,2360,326097,172368,328457,2920,29,29
3,1.5,1950,7560,1,0,2,4,7,1320,630,47.1976,-121.999,1950,8941,9510,10891,1950,44,44
3,2,1450,9044,2,0,0,3,7,1450,0,47.1955,-121.987,1450,9044,10494,10494,1450,29,29
3,2.75,2270,13590,1,0,0,4,6,1300,970,47.2099,-122.001,1160,13545,15860,14705,2270,71,71
3,2.75,3360,41250,1,0,0,4,7,1820,1540,47.2604,-122.023,2580,98881,44610,101461,3360,31,31
3,1,1320,3954,1,0,0,3,6,1320,0,47.202,-121.994,1270,5184,5274,6454,1320,107,0
3,1.75,1350,9793,1,0,0,4,7,1350,0,47.1981,-122.003,1690,8080,11143,9770,1350,51,51
3,2,1430,8919,1,0,0,3,7,1430,0,47.2118,-121.983,1580,8919,10349,10499,1430,27,27
2,2.5,2200,188200,1,0,3,3,8,2200,0,47.2458,-122.002,2700,84942,190400,87642,2200,12,12
3,1,1200,8514,1,0,0,3,7,1200,0,47.2043,-122.008,1210,8985,9714,10195,1200,60,60
4,2.25,2700,8580,2,0,0,3,8,2700,0,47.2087,-122.009,2420,8580,11280,11000,2700,27,27
3,1,1000,8512,1,0,0,3,6,1000,0,47.2151,-121.993,1490,10395,9512,11885,1000,28,28
1,1,470,63737,1,0,2,5,5,470,0,47.2163,-121.984,1350,46762,64207,48112,470,95,95
3,2.25,1570,9096,1,0,0,4,7,1180,390,47.1937,-121.99,1570,8418,10666,9988,1570,28,28
3,2.25,1670,107157,1,0,0,3,7,1670,0,47.2743,-122.009,3310,108900,108827,112210,1670,12,12
3,1.75,1580,507038,1,0,2,4,7,1580,0,47.2303,-121.936,2040,210394,508618,212434,1580,34,34
3,2,1810,10530,1,0,2,3,8,1810,0,47.1913,-122.012,1910,10450,12340,12360,1810,28,28
4,2,1600,10160,1,0,0,4,7,1600,0,47.2015,-122.003,1540,9352,11760,10892,1600,47,47
3,2,2660,192099,1,0,0,4,9,2660,0,47.2098,-122.016,2570,43561,194759,46131,2660,55,55
2,1,900,423838,1,0,2,5,6,900,0,47.228,-122.088,1810,94960,424738,96770,900,94,94
4,1.75,3730,16980,1,0,0,4,7,2150,1580,47.1775,-122.022,1880,16963,20710,18843,3730,45,45
4,3.5,4370,422967,1,0,2,4,10,2580,1790,47.2332,-122.029,3260,422967,427337,426227,4370,41,41
1,0.75,520,12981,1,0,0,5,3,520,0,47.2082,-121.995,1340,12233,13501,13573,520,99,99
3,2.75,1740,5639,1,0,3,3,7,1740,0,47.1942,-121.977,2380,5331,7379,7711,1740,9,9
4,2,1520,6174,1,0,0,5,6,1520,0,47.2105,-121.989,1390,5407,7694,6797,1520,99,99
5,1.5,2420,43560,1,0,2,3,8,1500,920,47.208,-121.963,1620,17331,45980,18951,2420,57,57
3,1.5,1830,12233,1,0,0,4,5,1830,0,47.2057,-122.003,1520,12233,14063,13753,1830,89,89
3,2.25,1570,8410,1,0,0,3,7,1180,390,47.1942,-121.99,1540,8410,9980,9950,1570,28,28
3,1.75,1540,6687,1,0,0,3,7,1200,340,47.1938,-121.981,1540,7242,8227,8782,1540,28,28
3,2,1510,10215,1,0,0,4,7,1510,0,47.2078,-122.003,1370,8902,11725,10272,1510,24,24
4,2,1260,8400,1,0,0,3,6,1260,0,47.1946,-122,1120,8400,9660,9520,1260,28,28
1,0,670,43377,1,0,0,3,3,670,0,47.2638,-121.906,1160,42882,44047,44042,670,53,53
3,1,1480,15416,1,0,2,4,8,1480,0,47.2142,-121.987,1190,10758,16896,11948,1480,64,64
4,2.5,2470,385506,2,0,3,3,7,2470,0,47.2396,-121.993,1680,158994,387976,160674,2470,28,28
3,3,2450,211266,1,0,3,3,8,2450,0,47.2215,-122.067,2300,263492,213716,265792,2450,15,15
3,2,1820,15068,2,0,2,3,7,1520,300,47.2103,-121.999,1490,9589,16888,11079,1820,99,0
3,1.5,1590,21600,1,0,0,4,7,1590,0,47.2159,-121.966,1780,21600,23190,23380,1590,48,48
4,2.25,1570,499571,1,0,3,4,7,1570,0,47.1808,-122.023,1700,181708,501141,183408,1570,47,47
3,2,2070,9000,1,0,0,4,7,1450,620,47.3085,-122.376,1630,7885,11070,9515,2070,50,50
4,2.25,2150,8250,1,0,0,4,7,1240,910,47.3045,-122.378,2050,7875,10400,9925,2150,41,41
3,2.5,1870,6821,2,0,0,3,7,1870,0,47.3065,-122.358,1970,6821,8691,8791,1870,30,30
4,2.75,2330,7200,1,0,0,4,8,1560,770,47.3203,-122.385,2350,7600,9530,9950,2330,42,42
3,1.75,1840,7300,1,0,0,3,8,1840,0,47.3122,-122.369,1920,8010,9140,9930,1840,53,53
3,1.75,1480,3900,1,0,0,4,7,1480,0,47.2977,-122.367,1830,6956,5380,8786,1480,39,39
3,1.5,1180,7000,1,0,0,4,7,1180,0,47.2966,-122.374,1180,7370,8180,8550,1180,42,42
3,2.5,2790,16173,2,0,0,3,10,2790,0,47.3043,-122.343,2890,11632,18963,14522,2790,31,31
4,2.5,2600,11951,2,0,0,3,10,2600,0,47.3053,-122.34,2820,12093,14551,14913,2600,31,31
3,1.75,1130,7000,1,0,0,3,7,1130,0,47.307,-122.372,1830,8880,8130,10710,1130,41,41
3,1.75,1820,8740,1,0,0,4,8,1820,0,47.3074,-122.385,2210,8320,10560,10530,1820,32,32
3,1.5,1630,6625,1,0,0,5,7,980,650,47.29,-122.368,1440,7145,8255,8585,1630,39,39
3,2.25,1430,5999,2,0,0,3,7,1430,0,47.3116,-122.358,1600,5999,7429,7599,1430,32,32
4,3,2540,8800,1,0,1,3,9,1620,920,47.3204,-122.387,2540,8800,11340,11340,2540,42,42
4,2.75,2530,13474,2,0,0,4,8,2530,0,47.289,-122.344,2490,13140,16004,15630,2530,25,25
4,2.5,1677,7209,2,0,0,3,7,1677,0,47.2957,-122.357,2236,7209,8886,9445,1677,8,8
3,1,840,12091,1,0,0,3,6,840,0,47.3281,-122.343,840,9324,12931,10164,840,60,60
3,1.75,1740,8625,1,0,0,4,7,1240,500,47.3054,-122.38,1980,8625,10365,10605,1740,41,41
4,3.5,1850,6519,2,0,0,3,7,1130,720,47.3087,-122.354,1280,6664,8369,7944,1850,33,33
5,1.75,2460,16000,1,0,0,3,7,1230,1230,47.3305,-122.351,1990,16000,18460,17990,2460,62,62
3,2.5,2370,9102,2,0,0,3,9,2370,0,47.3067,-122.394,2530,9883,11472,12413,2370,29,29
3,1,1460,8400,1,0,0,4,6,1460,0,47.3086,-122.365,1060,8563,9860,9623,1460,57,57
4,2.5,3402,14355,2,0,0,3,10,2846,556,47.3009,-122.385,3402,8487,17757,11889,3402,5,5
3,1,1290,6566,1,0,0,5,7,1290,0,47.3004,-122.377,1690,6860,7856,8550,1290,43,43
3,1.75,1560,10919,1,0,0,3,7,1560,0,47.2917,-122.366,1730,10919,12479,12649,1560,44,44
4,1,1640,10455,1,0,0,3,7,950,690,47.2974,-122.366,1360,9750,12095,11110,1640,56,56
3,1.75,2420,14862,1,0,0,3,8,1380,1040,47.3301,-122.365,2550,14675,17282,17225,2420,42,42
3,1.75,1390,18200,1,0,0,4,7,1390,0,47.3208,-122.337,1810,9675,19590,11485,1390,57,57
3,1,960,9563,1,0,0,5,7,960,0,47.2864,-122.357,1280,9600,10523,10880,960,52,52
4,2.5,2720,7350,2,0,0,3,9,2720,0,47.3028,-122.35,2570,8336,10070,10906,2720,30,30
4,2.75,2530,7350,1,0,0,5,8,1280,1250,47.313,-122.374,2280,7350,9880,9630,2530,42,42
3,1.5,1060,9600,1,0,0,4,7,1060,0,47.3229,-122.348,1440,9600,10660,11040,1060,57,57
3,2,1850,8208,1,0,0,4,7,1180,670,47.3109,-122.362,1790,8174,10058,9964,1850,49,49
3,1.5,2060,15050,1,0,0,4,7,2060,0,47.3321,-122.373,1900,15674,17110,17574,2060,81,81
3,2,1410,44866,1,0,0,4,7,1410,0,47.3273,-122.37,2950,29152,46276,32102,1410,34,34
2,1,1440,6650,1,0,0,3,7,970,470,47.2896,-122.369,1600,6847,8090,8447,1440,39,39
3,2.5,1990,7577,2,0,0,3,7,1990,0,47.2908,-122.351,1900,7152,9567,9052,1990,29,29
3,1,1490,8239,1,0,0,4,6,1490,0,47.306,-122.37,1200,8470,9729,9670,1490,56,56
4,1.75,1980,9000,1,0,0,2,7,1480,500,47.3071,-122.381,1980,9360,10980,11340,1980,41,41
3,2.5,2350,9051,1,0,0,4,8,1570,780,47.3126,-122.364,2270,8748,11401,11018,2350,53,53
4,1.75,1740,9344,1,0,0,3,7,1180,560,47.3196,-122.399,1440,12884,11084,14324,1740,41,41
4,2.5,2020,5100,2,0,0,3,7,2020,0,47.2822,-122.357,2300,5685,7120,7985,2020,9,9
4,2.25,1950,7280,2,0,0,4,8,1950,0,47.2957,-122.37,1910,7280,9230,9190,1950,40,40
3,1,900,4750,1,0,0,4,6,900,0,47.3026,-122.363,900,3404,5650,4304,900,50,50
3,2.5,2530,8669,2,0,0,3,9,2530,0,47.3073,-122.395,2530,9469,11199,11999,2530,29,29
3,1.75,1480,8475,1,0,0,4,7,1480,0,47.3126,-122.361,1800,8800,9955,10600,1480,51,51
4,2.5,1940,6206,2,0,0,3,7,1940,0,47.3063,-122.359,2060,7092,8146,9152,1940,29,29
4,2.75,2690,8874,1,0,0,3,8,1370,1320,47.3078,-122.383,1990,7875,11564,9865,2690,39,39
3,2,1520,7131,1,0,0,3,8,1520,0,47.3061,-122.361,1890,7379,8651,9269,1520,26,26
4,1,1630,8400,1,0,0,3,6,1630,0,47.3052,-122.362,1190,8989,10030,10179,1630,57,57
3,1.75,1050,7854,1,0,0,4,7,1050,0,47.3011,-122.369,1360,7668,8904,9028,1050,44,44
4,2.25,3340,8000,2,0,0,4,8,3340,0,47.317,-122.385,2230,8000,11340,10230,3340,46,46
4,2.25,1995,7102,2,0,0,4,8,1995,0,47.2986,-122.37,1880,7950,9097,9830,1995,38,38
4,2.5,1930,9653,1,0,0,4,9,1930,0,47.3367,-122.335,2100,10454,11583,12554,1930,51,51
4,2.5,1980,7403,2,0,0,3,7,1980,0,47.2897,-122.372,1980,7510,9383,9490,1980,31,31
3,1.75,1520,9600,1,0,0,3,8,1520,0,47.3263,-122.365,2060,9600,11120,11660,1520,53,53
3,1,840,8400,1,0,0,3,6,840,0,47.3281,-122.344,1030,8640,9240,9670,840,60,60
3,2,1920,8075,1,0,0,4,7,1510,410,47.3092,-122.375,1920,7826,9995,9746,1920,50,50
4,2.5,3560,12047,2,0,0,3,10,3560,0,47.3019,-122.341,3420,11250,15607,14670,3560,31,31
4,2.25,1810,7601,1,0,0,3,7,1080,730,47.2857,-122.358,1570,7601,9411,9171,1810,33,33
2,1.75,2860,59612,1,1,4,3,8,1510,1350,47.3276,-122.389,2720,59612,62472,62332,2860,71,11
4,2.5,1900,7000,1,0,0,2,7,1420,480,47.3092,-122.376,1600,7600,8900,9200,1900,51,51
3,2.25,2210,8000,2,0,0,4,8,2210,0,47.3085,-122.381,1990,8000,10210,9990,2210,50,50
3,1.5,1080,9774,1,0,0,3,7,1080,0,47.3155,-122.401,1190,9611,10854,10801,1080,51,51
4,2.5,2300,9690,2,0,0,3,8,2300,0,47.2793,-122.352,1200,9085,11990,10285,2300,13,13
4,2.5,2460,7800,1,0,0,3,8,1500,960,47.3081,-122.384,2210,7800,10260,10010,2460,42,42
3,2.5,3310,21096,2,0,2,3,9,3310,0,47.3049,-122.386,3310,13835,24406,17145,3310,15,15
4,2,2390,23972,2,0,0,3,7,1720,670,47.3197,-122.343,1950,22750,26362,24700,2390,70,70
3,1,1380,10112,1,0,0,4,7,940,440,47.3196,-122.351,1240,10112,11492,11352,1380,56,56
3,2.5,1830,8372,2,0,0,3,8,1830,0,47.3116,-122.4,1770,8372,10202,10142,1830,32,32
3,1.75,1500,7475,1,0,0,4,8,1500,0,47.3155,-122.365,1940,7475,8975,9415,1500,43,43
4,2.25,2270,12000,1,0,0,4,7,1290,980,47.3287,-122.353,2030,23980,14270,26010,2270,43,43
3,2.5,1500,7350,1,0,0,2,7,1060,440,47.3025,-122.382,1390,7770,8850,9160,1500,40,40
3,1,840,9480,1,0,0,3,6,840,0,47.3277,-122.341,840,9420,10320,10260,840,59,59
3,2.25,1560,6013,2,0,0,3,7,1560,0,47.2862,-122.352,1640,6290,7573,7930,1560,29,29
4,1.75,1670,8000,1,0,0,4,8,1670,0,47.3193,-122.383,1720,8000,9670,9720,1670,45,45
3,1.5,1630,10200,1,0,0,4,8,1300,330,47.3155,-122.364,1960,6700,11830,8660,1630,43,43
2,1,1770,16660,1,0,3,3,8,1220,550,47.3346,-122.354,2790,20504,18430,23294,1770,62,62
3,1.75,1570,15570,1,0,0,3,7,1570,0,47.3207,-122.362,2000,28200,17140,30200,1570,38,38
3,1.75,1930,13350,1,0,0,3,8,1930,0,47.3317,-122.365,2270,13350,15280,15620,1930,52,52
3,2.5,2070,9900,1,0,0,3,8,1420,650,47.2988,-122.371,2070,8250,11970,10320,2070,40,40
3,1.75,2160,7140,1,0,0,4,7,1670,490,47.3026,-122.374,1930,7350,9300,9280,2160,41,41
3,2,1900,7980,1,0,0,4,7,1340,560,47.305,-122.373,1690,7840,9880,9530,1900,42,42
3,2,1900,8002,1,0,0,3,7,1900,0,47.2909,-122.352,1900,6086,9902,7986,1900,28,28
2,1,1122,9100,1,0,0,4,6,1122,0,47.328,-122.341,840,9344,10222,10184,1122,59,59
3,1,1430,7000,1,0,0,3,6,1430,0,47.3018,-122.369,1050,7700,8430,8750,1430,51,51
4,2.25,2010,7688,1,0,0,3,8,1170,840,47.3086,-122.396,1990,7688,9698,9678,2010,40,40
4,3.25,3266,5398,2,0,0,3,8,3266,0,47.2975,-122.35,3087,5152,8664,8239,3266,5,5
3,2.75,2090,9620,1,0,0,3,8,1340,750,47.2741,-122.337,2150,9660,11710,11810,2090,32,32
3,2.5,2260,8120,2,0,0,3,8,2260,0,47.2924,-122.357,2250,7784,10380,10034,2260,15,15
4,2.5,1750,6397,2,0,0,3,7,1750,0,47.3082,-122.358,1940,6502,8147,8442,1750,31,31
3,1.75,2380,10450,1,0,0,3,8,2380,0,47.3143,-122.37,2320,8500,12830,10820,2380,53,53
3,1,1320,8450,1,0,0,3,6,880,440,47.3278,-122.337,1320,8450,9770,9770,1320,58,58
3,1,970,9583,1,0,0,4,6,970,0,47.3044,-122.366,970,7875,10553,8845,970,52,52
3,2.5,2100,6021,2,0,0,3,7,2100,0,47.2917,-122.375,2091,7547,8121,9638,2100,27,27
5,4.25,4110,42755,2,0,2,3,10,2970,1140,47.3375,-122.337,2730,12750,46865,15480,4110,19,19
4,2.5,2450,8932,2,0,0,3,8,2450,0,47.3093,-122.345,2410,8775,11382,11185,2450,29,29
3,1.75,1360,10573,1,0,0,4,7,1360,0,47.2983,-122.374,1580,8280,11933,9860,1360,35,35
3,2.75,3230,75889,2,1,4,3,7,3230,0,47.3344,-122.37,2560,72229,79119,74789,3230,94,21
5,3.75,2800,9900,1,0,0,3,7,2800,0,47.319,-122.344,1700,13200,12700,14900,2800,55,55
4,2.75,2330,7642,1,0,0,3,8,1800,530,47.2946,-122.37,2320,7933,9972,10253,2330,29,29
3,2.25,2110,7665,1,0,0,4,7,1360,750,47.3082,-122.372,1660,8436,9775,10096,2110,46,46
3,2.5,1650,6675,1,0,0,3,8,1290,360,47.2899,-122.372,1880,6675,8325,8555,1650,29,29
3,2,1830,10873,1,0,0,3,8,1830,0,47.3066,-122.394,2490,8976,12703,11466,1830,30,30
3,2.25,1960,7414,1,0,0,3,7,1490,470,47.2977,-122.374,1580,8038,9374,9618,1960,35,35
5,3.5,2738,6031,2,0,0,3,8,2738,0,47.2962,-122.35,2738,5201,8769,7939,2738,5,5
3,1.5,1470,18459,2,0,0,4,6,1470,0,47.3302,-122.36,1750,16074,19929,17824,1470,103,103
3,1.75,1290,7210,1,0,0,3,7,1290,0,47.2889,-122.363,1350,7509,8500,8859,1290,35,35
3,1,990,8528,1,0,0,3,6,990,0,47.3066,-122.371,1228,8840,9518,10068,990,53,53
5,3.5,3931,9497,2,0,0,3,10,2650,1281,47.3008,-122.386,3510,9497,13428,13007,3931,5,5
4,2.5,2890,17349,2,0,0,3,8,2890,0,47.2822,-122.34,2330,22356,20239,24686,2890,25,25
3,1.75,3140,8571,1,0,0,4,8,1670,1470,47.3074,-122.337,2590,7949,11711,10539,3140,34,34
3,3.25,3130,9302,2,0,0,3,8,2190,940,47.3078,-122.338,2350,7949,12432,10299,3130,32,32
4,2.25,2820,16770,1,0,0,4,8,1920,900,47.3186,-122.364,2320,13850,19590,16170,2820,53,53
3,1.75,1220,8817,1,0,0,3,7,1220,0,47.3111,-122.396,2000,8028,10037,10028,1220,41,41
3,1,1220,71191,1,0,0,3,6,1220,0,47.3261,-122.353,1960,15378,72411,17338,1220,67,67
4,2.5,3140,8060,2,0,0,3,9,3140,0,47.3091,-122.343,3000,8060,11200,11060,3140,28,28
3,1.75,1710,6400,1,0,0,4,7,1240,470,47.3036,-122.377,1600,6400,8110,8000,1710,43,43
3,2.5,1720,8755,1,0,0,3,8,1000,720,47.3186,-122.391,1720,8690,10475,10410,1720,36,36
4,2.5,1990,6671,2,0,0,3,7,1990,0,47.3078,-122.358,1862,6566,8661,8428,1990,30,30
4,2.5,1940,6887,2,0,0,3,7,1940,0,47.2911,-122.353,1870,6144,8827,8014,1940,29,29
3,3,2031,7702,2,0,0,3,9,2031,0,47.3058,-122.348,2390,7700,9733,10090,2031,31,31
4,2.25,2600,6390,1,0,0,3,8,1390,1210,47.3174,-122.366,2110,6700,8990,8810,2600,41,41
3,2.5,3800,13071,2,0,0,3,10,2730,1070,47.3076,-122.397,2980,11110,16871,14090,3800,25,25
3,2,1540,7210,2,0,0,4,7,1540,0,47.3128,-122.351,1500,7210,8750,8710,1540,35,35
4,2.75,2660,7754,1,0,0,3,8,1590,1070,47.3078,-122.337,2250,7754,10414,10004,2660,33,33
4,2.5,2240,9701,2,0,0,3,9,2240,0,47.3086,-122.392,2240,9410,11941,11650,2240,30,30
3,1,1040,8892,1,0,0,4,6,800,240,47.3273,-122.349,820,9000,9932,9820,1040,61,61
4,2.25,1830,9485,1,0,0,4,7,1200,630,47.2995,-122.387,1730,10109,11315,11839,1830,30,30
4,3.5,5844,10766,2,0,1,3,11,5844,0,47.3293,-122.364,3413,10766,16610,14179,5844,12,12
3,1.5,800,8850,1,0,0,4,6,800,0,47.3266,-122.348,820,8775,9650,9595,800,60,60
3,2.25,1980,8000,1,0,0,4,9,1560,420,47.3149,-122.378,2360,8000,9980,10360,1980,45,45
3,2.25,1610,7084,1,0,0,4,8,1280,330,47.3146,-122.384,2170,8505,8694,10675,1610,51,51
4,2,1610,6650,1,0,0,3,7,1610,0,47.3085,-122.358,1960,6650,8260,8610,1610,30,30
3,1,1070,6440,1,0,0,4,7,1070,0,47.3186,-122.373,1190,6532,7510,7722,1070,48,48
3,2.25,2540,7216,2,0,0,3,8,2540,0,47.2906,-122.349,2140,7531,9756,9671,2540,28,28
4,2.5,2423,7292,2,0,0,3,8,2423,0,47.3227,-122.37,2495,7489,9715,9984,2423,14,14
3,1,1270,7344,1,0,0,3,7,970,300,47.305,-122.371,1290,7300,8614,8590,1270,52,52
3,2.5,3240,33151,2,0,2,3,10,3240,0,47.3256,-122.378,4050,24967,36391,29017,3240,24,24
4,1.75,1250,12705,1,0,0,4,7,1250,0,47.302,-122.382,1390,8550,13955,9940,1250,48,48
2,1,1010,10057,1,0,0,3,6,1010,0,47.3286,-122.336,1040,8591,11067,9631,1010,58,58
3,2,1320,5665,1,0,0,3,7,1320,0,47.3096,-122.357,1336,7080,6985,8416,1320,33,33
4,2.25,2060,11385,1,0,0,4,7,1200,860,47.314,-122.363,2110,11385,13445,13495,2060,57,57
3,1.75,1290,6604,1,0,0,3,7,1290,0,47.323,-122.349,1440,6682,7894,8122,1290,35,35
3,1.75,1190,14777,1,0,0,4,7,1190,0,47.2933,-122.377,2240,8325,15967,10565,1190,54,54
3,1.75,1420,6980,1,0,0,5,7,820,600,47.2873,-122.367,1470,7319,8400,8789,1420,39,39
3,1.5,1420,8580,1,0,0,3,6,1420,0,47.3076,-122.362,1200,8580,10000,9780,1420,57,57
4,2.25,1720,9753,1,0,0,4,7,1120,600,47.2922,-122.371,1510,9753,11473,11263,1720,41,41
4,2,1500,7854,1,0,0,3,7,1500,0,47.3127,-122.354,1500,7334,9354,8834,1500,36,36
3,2.25,1810,6750,1,0,0,3,7,1280,530,47.2976,-122.377,1690,7770,8560,9460,1810,41,41
3,1.75,1170,9085,1,0,0,3,7,1170,0,47.2808,-122.354,1230,9085,10255,10315,1170,52,52
4,2.5,2500,9654,1,0,0,3,8,1830,670,47.3137,-122.343,2500,8839,12154,11339,2500,40,40
3,1,1060,10023,1,0,0,3,6,1060,0,47.2869,-122.36,1060,10023,11083,11083,1060,57,57
4,2.5,1750,11400,2,0,0,4,7,1750,0,47.3149,-122.386,1890,9024,13150,10914,1750,44,44
3,2,1650,6000,1,0,0,3,7,1650,0,47.2904,-122.353,1870,6000,7650,7870,1650,29,29
3,2.5,2690,8577,2,0,0,3,9,2690,0,47.3026,-122.351,2570,8066,11267,10636,2690,32,32
3,2.25,1850,7151,2,0,0,3,7,1850,0,47.2843,-122.352,1710,6827,9001,8537,1850,30,30
4,2.5,3490,9030,1,0,0,4,8,3490,0,47.3198,-122.386,2540,8400,12520,10940,3490,50,50
4,1.5,1360,9323,1,0,0,4,7,1360,0,47.3168,-122.401,1180,9611,10683,10791,1360,51,51
3,2.5,3316,11447,2,0,0,3,9,3316,0,47.3036,-122.34,3000,11447,14763,14447,3316,33,33
2,1,1200,9000,1,0,0,3,6,1200,0,47.3277,-122.349,1040,9600,10200,10640,1200,61,61
3,2.5,2080,9827,2,0,0,3,8,2080,0,47.3058,-122.394,2660,9861,11907,12521,2080,30,30
4,1.75,1940,13370,1,0,0,4,8,1940,0,47.3215,-122.369,2405,11769,15310,14174,1940,45,45
4,1.75,1960,8400,1,0,0,4,8,1960,0,47.3111,-122.379,2080,8400,10360,10480,1960,52,52
3,1.75,1510,10248,1,0,0,3,7,1510,0,47.2929,-122.371,1510,9753,11758,11263,1510,50,50
4,2.5,2550,7349,2,0,0,3,9,2550,0,47.3059,-122.349,2400,8508,9899,10908,2550,30,30
3,1.75,1440,16819,1,0,0,4,6,1440,0,47.3318,-122.373,1560,12376,18259,13936,1440,94,94
3,1.75,1770,29004,1,0,0,3,8,1770,0,47.3204,-122.364,2300,24534,30774,26834,1770,60,60
5,2.5,3840,16905,2,0,0,3,11,3840,0,47.2996,-122.342,3270,12133,20745,15403,3840,28,28
3,2.25,1720,7885,2,0,0,3,8,1720,0,47.3136,-122.344,2340,7885,9605,10225,1720,36,36
3,2.5,2210,7557,2,0,0,3,9,2210,0,47.3079,-122.393,2440,8641,9767,11081,2210,30,30
4,1.5,1240,9600,1,0,0,3,7,1240,0,47.3206,-122.397,1240,9592,10840,10832,1240,48,48
4,1,1620,17500,1,0,0,3,7,1620,0,47.3021,-122.388,2400,17394,19120,19794,1620,57,57
3,2.75,1910,15508,1,0,0,3,8,1210,700,47.3128,-122.345,2450,7989,17418,10439,1910,35,35
2,1,1420,16400,1,0,0,4,6,1420,0,47.3221,-122.344,1900,16400,17820,18300,1420,76,76
4,2.25,2390,13002,2,0,0,3,8,2390,0,47.3111,-122.35,2450,11200,15392,13650,2390,32,32
3,1,1000,12000,1,0,0,3,7,1000,0,47.3321,-122.346,1490,14940,13000,16430,1000,60,60
5,2,1210,12538,2,0,0,3,7,1210,0,47.2848,-122.361,1510,7700,13748,9210,1210,37,37
4,2.75,1760,9222,1,0,0,3,7,1140,620,47.3099,-122.362,1800,9222,10982,11022,1760,48,48
4,3.25,2880,5929,2,0,0,3,8,2880,0,47.2752,-122.349,2880,5846,8809,8726,2880,5,5
4,1,1340,8400,1,0,0,5,7,1340,0,47.3313,-122.343,1120,8400,9740,9520,1340,53,53
3,2.5,1690,5171,2,0,0,3,8,1690,0,47.2779,-122.347,2550,5025,6861,7575,1690,16,16
3,2.25,1580,7941,2,0,0,4,7,1580,0,47.2843,-122.357,1730,8051,9521,9781,1580,33,33
3,2.5,1850,7200,1,0,0,3,7,1500,350,47.3063,-122.384,2140,7500,9050,9640,1850,40,40
4,2.5,2510,8580,2,0,0,4,8,2510,0,47.295,-122.37,2290,7809,11090,10099,2510,28,2
5,2.5,3090,12750,1,0,0,3,8,1750,1340,47.3408,-122.335,1760,25919,15840,27679,3090,51,51
3,1,900,2550,1,0,0,4,6,900,0,47.3036,-122.363,1120,2550,3450,3670,900,41,41
4,2.25,1960,10400,1,0,0,4,8,1220,740,47.3199,-122.392,1650,8660,12360,10310,1960,34,34
3,2.5,2550,8170,2,0,0,3,8,2550,0,47.311,-122.345,1840,8823,10720,10663,2550,34,34
4,2.25,1860,12693,1,0,0,3,8,1140,720,47.3114,-122.395,1950,8740,14553,10690,1860,41,41
3,2.5,2740,11872,2,0,0,3,9,2740,0,47.3076,-122.395,2570,10377,14612,12947,2740,29,29
4,2.25,2390,7350,2,0,0,3,8,2390,0,47.2938,-122.348,2390,7350,9740,9740,2390,29,29
3,1,1100,8560,1,0,0,3,6,1100,0,47.329,-122.338,1120,8470,9660,9590,1100,58,58
3,2.5,2238,7209,2,0,0,3,8,2238,0,47.2966,-122.353,2456,7212,9447,9668,2238,8,8
3,1.75,1480,3900,1,0,0,4,7,1480,0,47.2977,-122.367,1830,6956,5380,8786,1480,39,39
3,1.75,1790,7650,1,0,3,3,9,1790,0,47.3213,-122.385,2540,7600,9440,10140,1790,41,41
3,1,1400,9690,1,0,0,3,7,1400,0,47.3201,-122.398,1280,9600,11090,10880,1400,50,50
3,2.5,2410,11900,1,0,2,4,9,1600,810,47.3384,-122.34,3090,11902,14310,14992,2410,30,30
5,1.75,2490,24969,1,0,2,4,8,1540,950,47.336,-122.35,2790,15600,27459,18390,2490,60,60
5,1,1410,9000,1,0,0,5,7,1410,0,47.3054,-122.369,1200,8346,10410,9546,1410,52,52
3,2.25,2030,8690,1,0,0,4,8,1360,670,47.3185,-122.391,1720,8800,10720,10520,2030,33,33
3,1.5,1430,7347,1,0,0,3,7,820,610,47.2927,-122.369,1430,8723,8777,10153,1430,39,39
3,1.75,1610,6205,1,0,0,4,7,1210,400,47.3004,-122.383,1780,8056,7815,9836,1610,40,40
4,2.25,2390,11250,2,0,0,3,9,2390,0,47.3305,-122.371,2480,11250,13640,13730,2390,31,31
4,3.5,3990,23544,1,0,2,3,10,2300,1690,47.3245,-122.38,3410,15932,27534,19342,3990,20,20
4,2.5,2506,7206,2,0,0,3,8,2506,0,47.3236,-122.337,2441,7220,9712,9661,2506,12,12
3,2.25,1950,8661,1,0,0,4,8,1950,0,47.3127,-122.362,1950,8800,10611,10750,1950,53,53
3,1.5,1700,9579,1,0,0,4,7,1100,600,47.3209,-122.338,1700,9628,11279,11328,1700,57,57
3,1.75,1670,6900,1,0,0,3,7,1170,500,47.2975,-122.38,1740,7000,8570,8740,1670,41,41
4,2.25,2180,8000,1,0,0,4,9,1630,550,47.317,-122.378,2310,8000,10180,10310,2180,44,44
3,2.5,2060,7658,2,0,0,3,8,2060,0,47.2923,-122.36,2250,7299,9718,9549,2060,16,16
3,1,1350,9680,1,0,0,4,7,820,530,47.3274,-122.346,1320,9225,11030,10545,1350,60,60
3,2.5,1800,8697,2,0,0,3,8,1800,0,47.3115,-122.4,1770,8390,10497,10160,1800,32,32
3,1.5,1860,8505,1,0,0,4,7,1860,0,47.3106,-122.365,1810,8262,10365,10072,1860,52,52
3,1.75,1460,12367,2,1,4,4,8,1120,340,47.3311,-122.375,1970,18893,13827,20863,1460,49,49
4,3.25,3266,5969,2,0,0,3,8,3266,0,47.2975,-122.35,3087,5169,9235,8256,3266,5,5
3,2,1690,6750,1,0,0,3,7,1210,480,47.3021,-122.375,1930,7350,8440,9280,1690,42,42
3,1,1260,8378,1,0,0,4,6,840,420,47.3274,-122.348,1140,8496,9638,9636,1260,60,38
3,2.5,2400,9701,1,0,0,3,9,2400,0,47.3081,-122.392,2400,8258,12101,10658,2400,29,29
3,1.75,1070,6315,1,0,0,3,7,1070,0,47.2803,-122.356,1520,5707,7385,7227,1070,27,27
3,1.75,1660,7350,1,0,0,2,8,1660,0,47.3118,-122.337,1840,7673,9010,9513,1660,40,40
3,1.5,1420,8580,1,0,0,3,6,1420,0,47.3076,-122.362,1200,8580,10000,9780,1420,57,57
3,2.25,1940,9100,1,0,0,4,8,1630,310,47.3133,-122.364,2080,9100,11040,11180,1940,53,53
4,2.75,2250,7345,1,0,0,4,8,1320,930,47.2895,-122.37,1800,6950,9595,8750,2250,35,35
4,2.5,3090,18645,2,0,0,3,9,3090,0,47.2902,-122.342,3610,20114,21735,23724,3090,24,24
4,2.25,2300,7524,2,0,0,4,8,2300,0,47.313,-122.388,2270,8025,9824,10295,2300,41,41
3,1.75,1480,6592,1,0,0,4,7,1080,400,47.2982,-122.378,1660,7150,8072,8810,1480,41,41
2,1.75,1950,8200,1,0,0,3,8,1950,0,47.3161,-122.382,2370,8000,10150,10370,1950,44,44
3,1.75,1460,7967,1,0,0,3,7,1040,420,47.3199,-122.374,1460,6835,9427,8295,1460,42,42
4,1,1540,7350,1,0,0,4,6,770,770,47.3318,-122.34,910,8000,8890,8910,1540,50,50
4,1.75,2520,10890,1,0,0,3,7,1260,1260,47.3224,-122.343,2090,12375,13410,14465,2520,40,40
4,2.5,2400,7215,2,0,0,3,8,2400,0,47.2944,-122.371,2220,7760,9615,9980,2400,27,27
4,2.25,1880,6160,2,0,0,3,7,1880,0,47.3214,-122.347,1580,6405,8040,7985,1880,26,26
2,2.25,2690,15000,1,0,2,3,8,1870,820,47.3361,-122.353,2690,15000,17690,17690,2690,32,32
4,2.5,2300,8100,1,0,0,4,8,1360,940,47.2979,-122.371,1910,7630,10400,9540,2300,40,40
3,2.5,3440,18167,2,0,0,3,11,3440,0,47.2909,-122.342,3990,20239,21607,24229,3440,28,28
3,1.75,1860,15681,1,0,0,4,7,1860,0,47.3191,-122.339,1860,22979,17541,24839,1860,48,48
4,2.25,2160,8811,1,0,0,3,8,1360,800,47.3129,-122.39,2090,8400,10971,10490,2160,41,41
3,1.75,1100,9750,1,0,0,4,6,1100,0,47.2955,-122.362,1100,9900,10850,11000,1100,52,52
3,1,1520,8450,1,0,0,2,6,1120,400,47.328,-122.337,1320,8450,9970,9770,1520,58,58
3,1.5,1180,7000,1,0,0,4,7,1180,0,47.2959,-122.373,1630,7500,8180,9130,1180,42,42
4,2.75,2640,7500,1,0,0,3,8,1620,1020,47.3135,-122.369,1980,7875,10140,9855,2640,52,52
4,2.5,2190,7294,2,0,0,3,8,2190,0,47.2923,-122.357,2240,7379,9484,9619,2190,16,16
4,2.5,2180,11132,1,0,0,4,8,1620,560,47.3187,-122.367,1950,13801,13312,15751,2180,41,41
4,2.5,2980,5674,2,0,0,3,8,2980,0,47.277,-122.347,2610,5495,8654,8105,2980,16,16
3,2.25,1630,7900,1,0,0,4,7,1130,500,47.3076,-122.377,1630,8200,9530,9830,1630,46,46
3,1.75,2270,9000,1,0,0,4,8,1330,940,47.3077,-122.381,2090,8400,11270,10490,2270,41,41
6,2.75,2940,7350,1,0,0,3,8,1780,1160,47.3103,-122.339,2120,8236,10290,10356,2940,41,41
3,1,1030,8395,1,0,0,4,7,1030,0,47.3322,-122.337,1370,9380,9425,10750,1030,59,59
3,2.75,3610,107386,1,1,3,3,8,3130,480,47.3351,-122.362,2630,42126,110996,44756,3610,101,53
5,2.25,3260,7969,2,0,0,4,8,3260,0,47.314,-122.344,2070,7962,11229,10032,3260,37,37
3,1,1040,10080,1,0,0,3,6,1040,0,47.329,-122.343,1000,8736,11120,9736,1040,60,60
4,2.5,2380,5737,2,0,0,3,7,2380,0,47.2815,-122.356,2380,5396,8117,7776,2380,9,9
4,1.75,1960,6177,1,0,0,4,8,1960,0,47.3131,-122.383,2010,8162,8137,10172,1960,52,52
3,1.75,1600,14250,1,0,0,3,7,1070,530,47.3272,-122.355,2140,14960,15850,17100,1600,40,40
4,2,1200,8470,1,0,0,4,7,1200,0,47.3262,-122.338,1110,8400,9670,9510,1200,58,58
3,1.75,1460,7800,1,0,0,2,7,1040,420,47.3035,-122.382,1310,7865,9260,9175,1460,40,40
5,3,2970,7000,1,0,0,3,8,1810,1160,47.3079,-122.341,2630,8062,9970,10692,2970,40,40
3,2.25,2420,7548,1,0,0,4,8,1370,1050,47.3112,-122.376,2150,8000,9968,10150,2420,52,52
4,2.25,2270,9600,1,0,0,3,7,1290,980,47.3261,-122.355,1930,15000,11870,16930,2270,43,43
3,1.5,1800,12196,1,0,0,4,7,1800,0,47.333,-122.345,1490,11730,13996,13220,1800,53,53
3,1,880,8976,1,0,0,4,6,880,0,47.3056,-122.368,990,8760,9856,9750,880,53,53
3,2.25,1840,9040,1,0,0,3,8,1370,470,47.3144,-122.339,1870,8992,10880,10862,1840,40,40
3,2.25,1740,6650,1,0,0,3,7,1240,500,47.2979,-122.379,1740,7000,8390,8740,1740,41,41
3,2,1530,8749,1,0,0,3,7,1530,0,47.2974,-122.372,1750,8749,10279,10499,1530,24,24
3,1,1100,9750,1,0,0,4,7,1100,0,47.3248,-122.345,1190,9750,10850,10940,1100,53,53
4,2.75,2200,13498,2,0,0,3,8,2200,0,47.3148,-122.35,2190,11850,15698,14040,2200,32,32
3,1.5,1330,7600,1,0,0,4,7,1330,0,47.3103,-122.366,1500,7776,8930,9276,1330,51,51
4,2.25,2440,8098,2,0,0,3,8,2440,0,47.3126,-122.346,2110,7911,10538,10021,2440,36,36
4,2.5,2460,7350,2,0,0,3,9,2460,0,47.3061,-122.349,2390,8568,9810,10958,2460,30,30
4,2.5,4620,20793,2,0,0,4,11,4620,0,47.2929,-122.342,3640,20793,25413,24433,4620,28,28
3,2.5,1850,6676,2,0,0,3,7,1850,0,47.3103,-122.36,1700,6663,8526,8363,1850,33,33
3,2.5,1860,6607,2,0,0,3,7,1860,0,47.2891,-122.351,1760,6766,8467,8526,1860,30,30
3,1.75,1830,9620,1,0,0,4,8,1830,0,47.3123,-122.389,1990,8280,11450,10270,1830,41,41
3,2.25,1960,7708,1,0,0,4,7,1490,470,47.2981,-122.374,1580,8063,9668,9643,1960,35,35
3,2.75,2090,9620,1,0,0,3,8,1340,750,47.2741,-122.337,2150,9660,11710,11810,2090,32,32
3,1.75,1790,7485,1,0,0,4,8,1330,460,47.3118,-122.34,1970,8097,9275,10067,1790,40,40
4,4,3530,10935,2,0,0,3,10,3530,0,47.3016,-122.342,3360,11250,14465,14610,3530,27,27
3,2.5,2070,5013,2,0,0,3,8,2070,0,47.3202,-122.395,1670,5013,7083,6683,2070,32,32
4,1.75,1490,10000,1,0,0,4,8,1100,390,47.3099,-122.379,2190,8910,11490,11100,1490,50,50
3,1.75,1520,15344,1,0,0,3,8,1520,0,47.3308,-122.365,2270,14981,16864,17251,1520,51,51
4,2.75,2370,7320,2,0,0,3,7,2370,0,47.3071,-122.36,1960,7320,9690,9280,2370,30,30
3,1.75,1680,7455,1,0,0,4,8,1680,0,47.3112,-122.378,2040,8214,9135,10254,1680,51,51
4,2.25,2930,9840,1,0,0,4,8,1560,1370,47.3103,-122.382,2800,8374,12770,11174,2930,42,42
4,2.75,3430,8000,1,0,0,4,8,3430,0,47.3183,-122.382,2090,8000,11430,10090,3430,47,47
3,1.75,1080,7942,1,0,0,3,7,1080,0,47.3141,-122.355,1380,8244,9022,9624,1080,38,38
4,3.5,3660,14401,2,0,0,3,10,2660,1000,47.3076,-122.396,2780,10653,18061,13433,3660,25,25
4,2.5,2441,7316,2,0,0,3,8,2441,0,47.3237,-122.337,2724,7357,9757,10081,2441,12,12
4,1.75,1880,12150,1,0,0,3,7,1280,600,47.3272,-122.363,1980,9680,14030,11660,1880,43,43
3,1,1290,8470,1,0,0,4,7,970,320,47.3054,-122.371,1300,7350,9760,8650,1290,53,53
3,2.5,3192,5653,2,0,0,3,8,3192,0,47.2956,-122.35,3000,5134,8845,8134,3192,5,5
3,1.75,1920,11340,1,0,0,4,7,1230,690,47.3272,-122.362,1980,9638,13260,11618,1920,42,42
3,2.75,3210,15939,2,0,1,3,10,3210,0,47.3357,-122.351,2870,15939,19149,18809,3210,21,21
4,2.25,3220,7889,2,0,0,3,8,3220,0,47.3112,-122.339,2120,7651,11109,9771,3220,41,41
4,3.5,2584,5005,2,0,0,3,8,2584,0,47.296,-122.35,2767,5201,7589,7968,2584,5,5
3,2,1240,12285,1,0,0,3,7,620,620,47.3219,-122.341,1560,11564,13525,13124,1240,80,24
4,2.25,2580,8820,1,0,0,4,9,1620,960,47.3122,-122.376,2140,8400,11400,10540,2580,52,52
5,2.75,3130,9450,1,0,0,4,8,1580,1550,47.3099,-122.384,1900,9000,12580,10900,3130,46,46
3,1,1384,8960,1,0,0,4,6,1384,0,47.3062,-122.371,1000,8470,10344,9470,1384,54,54
3,1,1040,8970,1,0,0,4,6,1040,0,47.3283,-122.337,1040,8450,10010,9490,1040,58,58
4,2.75,2990,11210,1,0,1,4,8,1880,1110,47.3357,-122.336,2790,9858,14200,12648,2990,42,42
4,2,1220,9100,1,0,0,4,7,1220,0,47.2964,-122.376,1160,7700,10320,8860,1220,49,49
2,1,1050,9600,1,0,0,4,6,1050,0,47.3274,-122.346,990,8880,10650,9870,1050,60,60
3,2,1420,6788,2,0,0,3,7,1420,0,47.2887,-122.351,1790,6607,8208,8397,1420,29,29
3,2.5,1830,7062,2,0,0,3,7,1830,0,47.2895,-122.352,1820,6434,8892,8254,1830,29,29
5,1.75,1990,27810,1,0,0,3,7,1990,0,47.3325,-122.35,2240,20000,29800,22240,1990,64,64
3,2.25,1730,10030,1,0,0,4,8,1730,0,47.3108,-122.345,2090,8823,11760,10913,1730,34,34
3,2.5,1680,5000,2,0,0,3,8,1680,0,47.3196,-122.395,1720,5000,6680,6720,1680,32,32
4,3.25,3920,881654,3,0,3,3,11,3920,0,47.5385,-121.896,2970,112384,885574,115354,3920,17,17
4,3.25,3580,43093,1,0,0,4,8,3580,0,47.5595,-121.901,2070,43093,46673,45163,3580,29,29
3,1.75,1300,20700,1,0,0,3,7,1300,0,47.5587,-121.904,1930,37638,22000,39568,1300,57,57
3,1,670,23522,1,0,0,4,6,670,0,47.5329,-121.89,1880,20270,24192,22150,670,51,51
3,0.75,770,7000,1,0,0,3,4,770,0,47.5661,-121.887,950,10500,7770,11450,770,77,77
2,3.25,3570,392475,1,0,0,3,9,2370,1200,47.5448,-121.93,3190,217800,396045,220990,3570,21,21
4,3.5,3980,209523,2,0,2,3,9,3980,0,47.5574,-121.89,2220,65775,213503,67995,3980,13,13
2,2.5,2410,102366,1,0,0,4,7,1940,470,47.5629,-121.918,2460,310582,104776,313042,2410,107,25
0,0,290,20875,1,0,0,1,1,290,0,47.5308,-121.888,1620,22850,21165,24470,290,56,56
3,1.75,1690,6375,1,0,0,3,8,1690,0,47.5247,-121.926,1270,7774,8065,9044,1690,116,12
3,2.25,1880,100623,1,0,0,3,8,1880,0,47.5342,-121.883,2520,21689,102503,24209,1880,32,7
3,2,2360,118483,1,0,0,3,8,2360,0,47.5595,-121.867,2660,91476,120843,94136,2360,38,38
2,1,920,43560,1,0,0,4,5,920,0,47.5245,-121.931,1530,11875,44480,13405,920,96,96
3,1,1280,10500,1,0,0,4,5,1280,0,47.566,-121.894,1410,10500,11780,11910,1280,78,78
3,2.75,3150,219978,2,0,0,4,9,3000,150,47.553,-121.946,3180,218235,223128,221415,3150,29,29
3,1,1370,17859,1,0,0,4,7,1150,220,47.5617,-121.859,1460,47044,19229,48504,1370,89,89
3,1,1100,145490,1,0,0,4,6,1100,0,47.5697,-121.898,1100,11610,146590,12710,1100,104,104
3,2.5,3970,263538,1,0,0,3,9,3970,0,47.6067,-121.952,3970,194676,267508,198646,3970,28,28
4,2.5,2890,15067,2,0,0,3,9,2890,0,47.5666,-121.907,3090,15398,17957,18488,2890,16,16
5,3.5,4000,9234,2,0,0,3,9,4000,0,47.5265,-121.887,3690,6600,13234,10290,4000,4,4
2,2,1410,12282,1,0,0,5,8,1410,0,47.5242,-121.926,1410,8931,13692,10341,1410,110,26
3,1.5,1240,9975,1,0,0,3,6,1240,0,47.5667,-121.905,1390,10735,11215,12125,1240,42,42
5,2.25,1970,15247,1,0,0,3,7,1450,520,47.5669,-121.905,1300,10800,17217,12100,1970,33,33
3,1,1390,10500,1,0,0,3,6,1390,0,47.567,-121.893,1350,9800,11890,11150,1390,79,79
3,2.5,2660,206480,1,0,0,3,8,2660,0,47.6042,-121.956,2660,206736,209140,209396,2660,30,30
3,2.5,3150,151588,2,0,0,3,9,3150,0,47.572,-121.926,2410,208652,154738,211062,3150,12,12
2,1,750,7000,1,0,0,3,6,750,0,47.5655,-121.89,1100,8777,7750,9877,750,87,87
4,2,1810,42981,1,0,0,4,7,1810,0,47.5597,-121.85,1980,113691,44791,115671,1810,46,46
3,1,1330,40259,1,0,0,4,7,1330,0,47.552,-121.89,1710,34787,41589,36497,1330,42,42
3,1,960,213008,1,0,0,2,6,960,0,47.5621,-121.862,1520,57499,213968,59019,960,86,86
4,4,4620,130208,2,0,0,3,10,4620,0,47.5885,-121.939,4620,131007,134828,135627,4620,5,5
3,2.25,1580,47916,1,0,0,3,7,1580,0,47.5583,-121.852,1980,75358,49496,77338,1580,40,40
4,1,1620,37075,1,0,0,3,7,1620,0,47.5654,-121.929,2190,87117,38695,89307,1620,76,76
5,1.75,1610,15246,1,0,0,3,6,1610,0,47.5654,-121.894,1410,10500,16856,11910,1610,83,83
3,2.25,1580,16215,1,0,0,4,7,1580,0,47.5643,-121.897,1450,16215,17795,17665,1580,41,41
4,1.5,1980,113691,1,0,0,3,7,1980,0,47.5606,-121.853,1980,89298,115671,91278,1980,57,57
3,1.75,1610,144619,1,0,0,3,7,1610,0,47.5659,-121.863,2220,144619,146229,146839,1610,42,42
4,5.25,5240,320917,2,0,2,3,10,5240,0,47.5605,-121.905,1930,68824,326157,70754,5240,13,13
5,4.25,4650,108464,2,0,0,3,10,3260,1390,47.5669,-121.956,2810,155509,113114,158319,4650,20,20
4,2.5,2370,15336,2,0,0,3,8,2370,0,47.5633,-121.901,2110,15925,17706,18035,2370,24,24
4,3.5,4270,117176,2,0,0,3,9,4270,0,47.5352,-121.883,2610,5251,121446,7861,4270,11,11
3,2.75,3900,111514,2,0,0,3,6,3460,440,47.5621,-121.924,2460,217800,115414,220260,3900,52,6
3,2,2570,159865,1,0,0,5,7,2570,0,47.5547,-121.892,2010,38322,162435,40332,2570,51,51
6,5,6050,230652,2,0,3,3,11,6050,0,47.6033,-121.943,4210,233971,236702,238181,6050,18,18
3,2,1340,9750,1,0,0,4,7,890,450,47.5644,-121.898,1460,12900,11090,14360,1340,45,45
3,2.5,1950,18533,2,0,0,3,8,1950,0,47.5647,-121.903,1810,18401,20483,20211,1950,31,31
3,2.5,2030,7770,2,0,0,3,8,2030,0,47.5253,-121.93,1360,10782,9800,12142,2030,16,16
3,1.5,2580,47480,1,0,0,3,7,1360,1220,47.5333,-121.933,1760,48181,50060,49941,2580,66,66
4,1,2300,9583,1,0,0,3,6,1220,1080,47.5671,-121.89,1200,11325,11883,12525,2300,91,91
5,3.5,2990,212137,2,0,0,3,8,2450,540,47.5298,-121.887,1060,69260,215127,70320,2990,25,25
3,2.75,2930,218235,2,0,2,3,8,2930,0,47.5481,-121.886,2450,218235,221165,220685,2930,29,29
5,3.25,4300,50405,2,0,0,3,8,3220,1080,47.4615,-122,2680,41684,54705,44364,4300,47,47
5,2.75,2910,85377,1,0,0,4,8,1510,1400,47.48,-122.03,2160,66120,88287,68280,2910,53,53
3,2.25,1620,1075,3,0,0,3,8,1540,80,47.5405,-122.026,1620,1237,2695,2857,1620,10,10
4,4,4420,5940,2,0,0,3,10,3410,1010,47.5397,-122.072,4510,5797,10360,10307,4420,13,13
3,2.5,2340,2155,2,0,0,3,10,2120,220,47.53,-122.073,2640,2680,4495,5320,2340,7,7
4,3.25,3720,7150,2,0,2,3,11,3720,0,47.5359,-122.069,4040,7442,10870,11482,3720,12,12
4,2.5,2630,15000,2,0,0,5,8,2630,0,47.5262,-122.028,1770,8700,17630,10470,2630,57,57
4,2.5,3480,13421,2,0,0,3,11,3480,0,47.5504,-122.097,3290,9642,16901,12932,3480,24,24
3,2.5,1790,2700,2,0,0,3,8,1790,0,47.564,-122.093,1890,3078,4490,4968,1790,9,9
4,1.75,2350,7574,1,0,0,3,8,1720,630,47.5634,-122.087,2220,8496,9924,10716,2350,40,40
3,2.25,1960,12350,1,0,0,4,7,1960,0,47.5247,-122.052,1920,13608,14310,15528,1960,58,58
3,2.5,1670,2575,2,0,0,3,8,1670,0,47.531,-122.047,1670,2897,4245,4567,1670,19,19
4,2.5,1910,7683,2,0,0,3,8,1910,0,47.5644,-122.092,1980,8485,9593,10465,1910,32,32
3,1,1020,18050,1,0,0,3,7,1020,0,47.5254,-122.043,1750,11640,19070,13390,1020,50,50
4,3.25,4160,35654,2,0,0,3,8,2760,1400,47.4683,-122.008,2500,35675,39814,38175,4160,46,46
3,2.5,1790,3078,2,0,0,3,8,1790,0,47.5638,-122.094,1890,3078,4868,4968,1790,9,9
4,2.5,3000,10392,2,0,0,3,9,3000,0,47.535,-122.049,3140,9213,13392,12353,3000,24,24
3,2.5,2320,5663,2,0,0,3,8,2320,0,47.539,-122.07,2500,4500,7983,7000,2320,16,16
4,3.5,4190,15724,2,0,2,3,11,4190,0,47.5518,-122.096,3300,10113,19914,13413,4190,25,25
3,2.25,2300,9914,2,0,0,4,8,2300,0,47.5677,-122.086,2240,9032,12214,11272,2300,39,39
3,3,2230,1407,2,0,0,3,8,1850,380,47.5446,-122.017,2230,1407,3637,3637,2230,5,5
3,1.75,3150,9258,1,0,1,3,8,2370,780,47.5571,-122.08,2740,10274,12408,13014,3150,49,49
3,2.5,1650,14054,1,0,0,4,7,1130,520,47.4821,-122.017,1940,87555,15704,89495,1650,33,33
2,1.75,2200,89298,1,0,0,3,7,1100,1100,47.4633,-121.976,2590,89298,91498,91888,2200,46,46
4,1.75,1800,10890,1,0,0,4,6,1800,0,47.5312,-122.04,1530,9818,12690,11348,1800,107,107
2,2.25,1240,720,2,0,0,3,7,1150,90,47.5322,-122.072,1260,810,1960,2070,1240,11,11
3,2.25,1445,1028,2,0,0,3,7,1300,145,47.5339,-122.067,1445,1377,2473,2822,1445,14,14
3,2.25,1620,997,2,0,0,3,8,1540,80,47.54,-122.026,1620,1068,2617,2688,1620,9,9
7,4.5,4290,37607,1,0,0,5,10,4290,0,47.4812,-122.033,2810,40510,41897,43320,4290,37,37
3,2.75,2440,45738,2,0,0,3,8,1840,600,47.5453,-121.957,2440,189100,48178,191540,2440,32,32
4,3.25,4350,112750,1,0,0,3,9,2200,2150,47.5435,-121.966,2180,223027,117100,225207,4350,13,13
3,2,2420,38781,1,0,0,5,7,1210,1210,47.4511,-121.976,2650,88426,41201,91076,2420,70,70
4,2.5,2520,3980,2,0,0,3,8,2520,0,47.5399,-122.07,2580,3980,6500,6560,2520,15,15
4,2.5,3120,14300,2,0,0,3,9,3120,0,47.5318,-122.055,2580,10005,17420,12585,3120,16,16
5,2.75,2630,10165,1,0,0,4,8,1690,940,47.5196,-122.049,2440,10165,12795,12605,2630,43,43
3,2.5,3545,9816,1,0,0,3,10,2610,935,47.5534,-122.078,3630,7704,13361,11334,3545,14,14
4,3.5,2340,2810,2,0,2,3,8,1730,610,47.5403,-122.028,2600,2843,5150,5443,2340,8,8
4,3.5,2950,3737,2,0,0,3,10,2270,680,47.5313,-122.074,2580,3581,6687,6161,2950,7,7
4,2.5,2310,9624,2,0,0,3,8,2310,0,47.5386,-122.053,1940,9636,11934,11576,2310,35,35
5,4.75,5990,10450,2,1,4,3,11,4050,1940,47.5554,-122.077,3330,14810,16440,18140,5990,17,17
6,3.5,3830,68825,2,0,0,3,9,3830,0,47.4574,-122.003,2410,68825,72655,71235,3830,24,24
4,3.5,3930,5680,2,0,1,3,9,2820,1110,47.5528,-122.076,3700,5816,9610,9516,3930,6,6
5,3.25,4610,10576,2,0,3,3,11,3310,1300,47.5373,-122.07,4042,8321,15186,12363,4610,13,13
3,3.5,2490,3517,2,0,0,3,8,1720,770,47.5341,-122.067,1600,2378,6007,3978,2490,14,14
3,2.75,2310,1850,2,0,0,3,10,2020,290,47.5304,-122.073,2340,2155,4160,4495,2310,8,8
5,4.25,3970,4500,2,0,0,3,9,2860,1110,47.5402,-122.069,3480,4500,8470,7980,3970,15,15
5,3.25,2710,2356,2,0,0,3,8,2230,480,47.5394,-122.028,2160,2108,5066,4268,2710,6,6
3,2,2870,95396,1,0,0,4,9,1350,1520,47.4834,-122.001,2870,102366,98266,105236,2870,39,39
2,1,1320,24319,1,0,0,3,7,1320,0,47.4741,-122.015,1430,98445,25639,99875,1320,53,53
3,1.75,1540,12446,1,0,0,5,8,1540,0,47.5172,-122.027,1330,11508,13986,12838,1540,52,52
4,2.25,3320,53392,2,0,0,4,8,2000,1320,47.4724,-122.014,3230,43129,56712,46359,3320,33,33
3,2.5,2360,9938,1,0,0,3,8,1690,670,47.5374,-122.053,2280,9626,12298,11906,2360,32,32
3,2,1730,9000,1,0,0,3,8,1370,360,47.5202,-122.047,2390,10000,10730,12390,1730,41,41
3,1,3060,30166,1,0,0,5,8,3060,0,47.5656,-122.093,1880,19602,33226,21482,3060,60,60
4,2.25,2020,85813,2,0,0,3,7,2020,0,47.483,-122.026,2120,85813,87833,87933,2020,24,24
4,2.5,3040,35201,2,0,0,4,10,3040,0,47.4872,-122.066,2990,35416,38241,38406,3040,32,32
4,2,1350,942,3,0,0,3,7,1350,0,47.5401,-122.026,1390,942,2292,2332,1350,11,11
4,2.5,2370,9679,2,0,0,3,8,2370,0,47.5631,-122.085,2290,7944,12049,10234,2370,35,35
3,2.5,1980,3128,2,0,0,3,8,1890,90,47.5456,-122.016,2160,2240,5108,4400,1980,10,10
4,2.75,2400,104108,2,0,0,3,8,2400,0,47.4686,-121.989,2270,54450,106508,56720,2400,31,31
3,3.25,2440,2812,2,0,0,3,8,1710,730,47.5362,-122.072,2440,2836,5252,5276,2440,14,14
4,2.25,2610,7700,1,0,0,3,8,1700,910,47.5659,-122.089,2260,8266,10310,10526,2610,42,42
3,2.25,1620,1057,3,0,0,3,8,1540,80,47.5396,-122.026,1390,942,2677,2332,1620,10,10
4,2,1960,190357,1,0,3,2,8,1960,0,47.5538,-121.958,2560,189100,192317,191660,1960,48,48
5,2.25,3020,10010,1,0,0,3,7,1510,1510,47.5249,-122.044,1760,10878,13030,12638,3020,60,60
4,3.25,2600,2074,2,0,0,3,8,2150,450,47.5402,-122.028,2510,2074,4674,4584,2600,8,8
4,2.5,2110,13850,2,0,0,3,9,2110,0,47.5497,-122.077,2520,10194,15960,12714,2110,32,32
4,3.5,2650,3127,2,0,0,3,8,2230,420,47.5381,-122.046,2330,3137,5777,5467,2650,8,8
4,3.25,3060,3898,2,0,0,3,10,2300,760,47.5311,-122.073,2920,3448,6958,6368,3060,5,5
2,2.5,1320,48787,1,0,0,3,8,1320,0,47.5157,-121.924,1830,155073,50107,156903,1320,15,15
3,2.25,1940,5980,1,0,0,3,7,1520,420,47.5476,-122.075,1910,6309,7920,8219,1940,32,32
4,2.25,2220,130244,2,0,0,3,8,2220,0,47.4989,-121.9,2680,130680,132464,133360,2220,30,30
5,3.5,4490,6000,2,0,0,3,10,3200,1290,47.5396,-122.073,4530,6000,10490,10530,4490,13,13
3,2.5,2030,6500,2,0,0,3,8,2030,0,47.5654,-122.092,2030,8485,8530,10515,2030,31,31
3,1,1140,27760,1,0,0,4,6,1140,0,47.5372,-121.972,1690,87300,28900,88990,1140,38,38
3,2.5,2280,2289,2,0,0,3,8,1880,400,47.5375,-122.073,2280,2425,4569,4705,2280,13,13
5,2.5,3400,9500,2,0,1,4,8,3400,0,47.5645,-122.082,3080,11081,12900,14161,3400,42,42
4,3.75,4740,126759,2,0,0,4,10,4740,0,47.4449,-121.979,3060,118047,131499,121107,4740,28,28
3,2,2020,38332,1,0,0,4,7,1010,1010,47.4582,-122.023,2110,36590,40352,38700,2020,44,44
4,2.75,3260,5000,2,0,0,3,9,3260,0,47.5395,-121.997,3450,6218,8260,9668,3260,12,12
3,2.5,2460,108900,1,0,0,4,9,1860,600,47.4824,-122,2870,102366,111360,105236,2460,42,42
5,3.25,3130,12087,2,0,0,3,8,2180,950,47.5336,-122.052,2410,10350,15217,12760,3130,44,44
3,2.5,2430,54059,2,0,0,3,10,2430,0,47.4664,-121.992,2910,49658,56489,52568,2430,32,32
3,2.25,2600,220300,1,0,0,5,8,2120,480,47.4562,-122.016,2760,215600,222900,218360,2600,42,42
2,1.75,1680,8187,1,0,0,4,8,1680,0,47.5603,-122.081,2390,7801,9867,10191,1680,36,36
3,1.75,2620,38350,1,0,0,4,8,1320,1300,47.4619,-121.991,2170,36962,40970,39132,2620,42,42
4,2.75,3640,231739,1,0,0,3,10,3640,0,47.5078,-122.018,2670,91040,235379,93710,3640,20,20
5,2.5,3160,5635,2,0,0,3,9,3160,0,47.5362,-122.067,3670,6087,8795,9757,3160,16,16
3,2.5,2390,1984,2,0,0,3,8,2220,170,47.5405,-122.027,2150,1984,4374,4134,2390,11,11
4,3.25,2610,2552,2,0,0,3,10,2160,450,47.5322,-122.076,2610,2664,5162,5274,2610,11,11
5,1.5,1720,12551,1,0,0,3,7,1720,0,47.5241,-122.053,1560,12960,14271,14520,1720,52,52
3,2.25,2420,23507,1,0,0,4,8,2420,0,47.5107,-122.027,2540,22257,25927,24797,2420,50,50
2,1,600,1500,1,0,0,4,4,600,0,47.5289,-122.033,1130,6000,2100,7130,600,119,119
5,2.25,3160,8065,2,0,0,3,8,3160,0,47.5678,-122.089,2540,7917,11225,10457,3160,42,42
2,1,960,8276,1,0,0,3,5,960,0,47.5322,-122.033,1620,6000,9236,7620,960,80,80
2,2.5,1090,923,2,0,0,3,7,1090,0,47.5347,-122.071,1410,1326,2013,2736,1090,15,15
3,2.25,1445,1087,2,0,0,3,7,1300,145,47.5339,-122.067,1410,1336,2532,2746,1445,14,14
4,3.5,4070,336283,2,0,0,3,11,4070,0,47.478,-122.038,3020,44613,340353,47633,4070,13,13
4,2.75,2230,9460,1,0,0,5,7,1480,750,47.5246,-122.044,1760,10878,11690,12638,2230,59,59
4,2,1350,942,3,0,0,3,7,1350,0,47.5394,-122.026,1390,942,2292,2332,1350,11,11
4,2.75,2450,4187,2,0,2,3,8,2450,0,47.5471,-122.016,2320,4187,6637,6507,2450,9,9
3,3.25,3610,59677,2,0,0,3,10,2440,1170,47.5464,-122.088,3130,65775,63287,68905,3610,16,16
2,2,1140,12000,1,0,0,3,6,1140,0,47.5277,-122.031,1880,6125,13140,8005,1140,76,76
2,1,1470,81021,1,0,0,4,6,1470,0,47.4771,-122.03,2600,69696,82491,72296,1470,70,70
2,1,930,6098,1,0,0,4,6,930,0,47.5289,-122.03,1730,9000,7028,10730,930,100,100
4,3.25,5010,49222,2,0,0,5,9,3710,1300,47.5489,-122.092,3140,54014,54232,57154,5010,41,41
3,1,1120,8321,1,0,0,4,6,1120,0,47.5631,-122.091,1980,8671,9441,10651,1120,78,27
4,2,1390,745,3,0,0,3,7,1390,0,47.5401,-122.026,1390,942,2135,2332,1390,11,11
4,2.5,3550,10233,2,0,0,3,9,3550,0,47.5499,-122.1,3310,9157,13783,12467,3550,23,23
3,2.5,3200,18750,1,0,0,2,9,2660,540,47.5717,-122.12,3200,22475,21950,25675,3200,52,18
5,3,2240,18265,2,0,0,4,8,2240,0,47.5171,-122.029,1990,18265,20505,20255,2240,56,56
3,2.5,1690,9626,2,0,0,3,8,1690,0,47.5647,-122.092,1860,8958,11316,10818,1690,35,35
2,1,1440,43560,1,0,0,4,7,1150,290,47.4916,-122.082,1870,56628,45000,58498,1440,54,54
3,1,1150,4825,1,0,0,4,6,1150,0,47.5321,-122.029,1760,7121,5975,8881,1150,62,62
3,2.5,2140,4126,2,0,0,3,8,1960,180,47.5368,-122.073,2280,2615,6266,4895,2140,14,14
3,1,1180,43124,1,0,0,4,6,1180,0,47.5278,-122.063,1410,43560,44304,44970,1180,60,60
3,2.25,1410,1290,2,0,0,3,7,1290,120,47.5345,-122.069,1490,1380,2700,2870,1410,15,15
3,2,1720,128066,1,0,0,3,7,1720,0,47.4487,-121.981,2360,111078,129786,113438,1720,25,25
3,3,1960,1168,2,0,0,3,9,1600,360,47.5445,-122.014,2080,1423,3128,3503,1960,12,12
3,2.5,1600,2042,2,0,0,3,8,1600,0,47.5341,-122.067,1445,1370,3642,2815,1600,14,14
5,6.5,7270,130017,2,0,0,3,12,6420,850,47.5371,-121.982,1800,44890,137287,46690,7270,9,9
3,2,1900,9975,1,0,0,3,8,1500,400,47.5307,-122.054,2140,9825,11875,11965,1900,46,46
3,2.5,2630,10047,2,0,0,3,9,2630,0,47.5515,-122.083,2640,10620,12677,13260,2630,23,23
3,2.5,2220,60984,2,0,0,4,8,2220,0,47.4802,-122.052,1930,55333,63204,57263,2220,32,32
3,2.5,2660,20369,2,0,0,3,8,2660,0,47.5234,-122.055,2720,12927,23029,15647,2660,27,27
4,2.75,2790,10819,2,0,0,3,10,2790,0,47.5515,-122.08,3080,12603,13609,15683,2790,23,23
3,2.25,2030,16200,2,0,0,3,8,2030,0,47.5162,-122.057,2660,17958,18230,20618,2030,35,35
4,3.25,2950,4161,2,0,0,3,10,2210,740,47.5297,-122.073,2790,3693,7111,6483,2950,5,5
3,1.75,1680,14630,1,0,0,3,8,1680,0,47.5272,-122.044,1920,14630,16310,16550,1680,34,34
3,2.25,2720,54450,2,0,0,3,11,2720,0,47.5473,-122.092,3170,60548,57170,63718,2720,22,22
4,3,2180,12196,2,0,0,4,7,2180,0,47.5338,-122.033,1500,6534,14376,8034,2180,51,51
5,2.25,2520,49222,2,0,0,4,8,2520,0,47.4918,-122.064,2780,55321,51742,58101,2520,41,41
4,2.5,3690,11468,2,0,0,3,11,3690,0,47.5699,-122.092,3370,10751,15158,14121,3690,32,32
3,3.5,2490,3582,2,0,0,3,8,1720,770,47.5338,-122.067,1445,1590,6072,3035,2490,14,14
3,1.75,2130,9775,1,0,0,4,8,1430,700,47.5326,-122.049,2130,11250,11905,13380,2130,46,46
4,3.5,4670,6000,2,0,3,3,11,3820,850,47.5414,-121.994,4310,6000,10670,10310,4670,12,12
3,2.25,1620,998,2,0,0,3,8,1540,80,47.5401,-122.027,1620,1299,2618,2919,1620,9,9
5,1.75,2980,53578,1,0,0,4,9,2230,750,47.4908,-122.059,2860,75546,56558,78406,2980,43,43
4,3.5,3390,3960,2,0,0,3,10,3390,0,47.5406,-121.995,2990,3400,7350,6390,3390,11,11
4,2.5,3420,6233,2,0,0,3,9,3420,0,47.5416,-121.998,3350,5000,9653,8350,3420,13,13
4,1.75,1650,7088,1,0,0,3,8,1650,0,47.5688,-122.087,1850,7523,8738,9373,1650,46,46
4,2.5,2920,252648,2,0,0,3,10,2920,0,47.4784,-122.048,2180,71874,255568,74054,2920,17,17
3,1.75,1460,22651,1,0,0,4,7,1460,0,47.4861,-122.03,2030,49222,24111,51252,1460,58,58
4,2.5,2370,9601,1,0,0,3,8,1570,800,47.5327,-122.054,2550,10500,11971,13050,2370,43,43
3,1.75,1430,16200,1,0,0,4,7,1430,0,47.5223,-122.043,1690,13125,17630,14815,1430,52,52
3,2.25,1910,35015,1,0,0,4,8,1430,480,47.4672,-122.006,2340,36680,36925,39020,1910,42,42
3,2.5,2030,2805,2,0,0,3,8,1720,310,47.5305,-122.047,1670,2898,4835,4568,2030,18,18
4,2,1540,17859,1,0,0,3,6,1540,0,47.5326,-122.032,1390,9688,19399,11078,1540,55,55
4,2.25,2120,9921,2,0,0,3,8,2120,0,47.5593,-122.082,1890,7845,12041,9735,2120,38,38
2,1,1200,12856,1,0,0,4,6,1200,0,47.5321,-122.034,1740,6098,14056,7838,1200,71,71
4,2.5,3470,10045,2,0,0,3,10,3470,0,47.554,-122.095,4370,12359,13515,16729,3470,26,26
2,1,1180,4900,1,0,0,5,6,1180,0,47.5321,-122.029,1650,7121,6080,8771,1180,65,65
4,3.25,3160,6327,2,0,0,3,9,2280,880,47.536,-122.066,3160,5946,9487,9106,3160,15,15
4,2.75,2710,37277,2,0,0,3,9,2710,0,47.4634,-121.987,2390,39299,39987,41689,2710,19,19
3,2.25,1445,1606,2,0,0,3,7,1300,145,47.5348,-122.072,1410,1286,3051,2696,1445,16,16
3,2.25,1970,35100,2,0,0,4,9,1970,0,47.4635,-121.991,2340,35100,37070,37440,1970,42,42
3,3.75,3830,219106,2,0,0,3,9,3830,0,47.5432,-121.952,2440,219106,222936,221546,3830,42,15
3,2.25,1620,1425,3,0,0,3,8,1540,80,47.5405,-122.026,1620,1237,3045,2857,1620,10,10
3,1.5,1480,21320,1,0,0,4,7,1480,0,47.5234,-122.043,1850,17825,22800,19675,1480,52,52
4,3.5,3310,21050,2,0,0,5,9,2400,910,47.5197,-122.041,2260,23400,24360,25660,3310,27,27
3,2.5,2500,51836,1,0,0,3,9,1510,990,47.4694,-121.989,2270,54450,54336,56720,2500,6,6
3,1,1480,13280,2,0,0,3,6,1480,0,47.5378,-122.043,1510,8723,14760,10233,1480,79,79
3,3,1720,70567,1,0,2,5,7,1720,0,47.4936,-122.069,2740,70567,72287,73307,1720,53,53
4,3.5,4740,8611,2,0,3,3,11,3640,1100,47.5375,-122.07,4042,8321,13351,12363,4740,13,13
5,2.25,3340,52476,2,0,0,4,8,3340,0,47.4553,-121.987,2460,48351,55816,50811,3340,44,44
4,1.75,2350,54450,1,0,0,4,7,1250,1100,47.4816,-122.005,2180,50529,56800,52709,2350,48,48
4,3.5,3910,59863,2,0,0,4,10,2490,1420,47.4846,-122.067,2830,37674,63773,40504,3910,32,32
4,1.75,2420,7672,1,0,0,3,8,1480,940,47.5637,-122.085,2370,7699,10092,10069,2420,40,40
5,3,3480,57499,1,0,0,4,8,2340,1140,47.4574,-122.024,2020,40946,60979,42966,3480,43,43
5,3.75,3580,14275,2,0,0,3,10,3190,390,47.5322,-122.056,2740,14300,17855,17040,3580,20,20
3,1.75,2680,8625,1,0,0,5,8,1590,1090,47.5316,-122.056,2620,14275,11305,16895,2680,45,45
3,2.5,3570,35271,2,0,0,3,9,3570,0,47.4782,-122.035,3510,37194,38841,40704,3570,22,22
3,1,1580,6000,1,0,0,5,7,1580,0,47.5286,-122.032,1580,6000,7580,7580,1580,72,72
5,3.5,3990,42436,2,0,0,3,9,2710,1280,47.461,-122,3030,41684,46426,44714,3990,17,17
4,2.5,3500,10891,2,0,2,3,10,3500,0,47.5533,-122.093,3820,13521,14391,17341,3500,24,24
3,2,2220,10275,2,0,0,3,9,1640,580,47.5304,-122.055,2300,9975,12495,12275,2220,39,39
4,2.5,3230,40319,2,0,0,4,10,3230,0,47.4856,-122.069,2990,40234,43549,43224,3230,32,32
4,2.5,3260,26772,2,0,0,3,9,3260,0,47.5115,-122.031,3260,14491,30032,17751,3260,12,12
3,1.75,1820,34800,1,0,0,4,6,1820,0,47.4616,-121.98,2570,52707,36620,55277,1820,52,52
3,2.5,2140,2867,2,0,0,3,8,1960,180,47.5357,-122.073,2280,2836,5007,5116,2140,14,14
5,3.75,5330,6000,2,0,2,3,10,3570,1760,47.5401,-122.073,4420,5797,11330,10217,5330,13,13
3,2.5,2560,9182,2,0,0,3,9,2560,0,47.5361,-122.051,2800,8784,11742,11584,2560,26,26
5,3.5,4350,6218,2,0,2,3,10,3520,830,47.5396,-121.997,3260,5989,10568,9249,4350,12,12
3,3.25,2580,9825,1,0,1,4,9,1760,820,47.5314,-122.054,2140,10270,12405,12410,2580,41,41
4,3.5,2650,3474,2,0,0,3,8,2230,420,47.5377,-122.046,2330,3474,6124,5804,2650,8,8
3,2.5,1940,3211,2,0,0,3,8,1940,0,47.5644,-122.093,1880,3078,5151,4958,1940,10,10
3,2.5,2420,49928,2,0,0,3,8,1860,560,47.463,-122.008,2620,37301,52348,39921,2420,34,34
4,1.75,1450,8450,1,0,0,3,7,1450,0,47.5289,-122.028,1540,8450,9900,9990,1450,59,59
3,2.5,2000,35438,2,0,0,3,7,2000,0,47.4733,-121.994,2000,51836,37438,53836,2000,51,10
5,2.5,3480,74052,1,0,0,4,8,1980,1500,47.4961,-122.063,2610,65775,77532,68385,3480,47,47
5,3.5,5930,13288,2,0,2,3,11,3920,2010,47.5542,-122.097,3860,12062,19218,15922,5930,23,23
3,3.5,2630,4713,2,0,2,3,9,2030,600,47.5473,-122.016,2450,4187,7343,6637,2630,11,11
3,2.25,2560,117176,1,0,0,4,9,1280,1280,47.4655,-122.033,2760,57063,119736,59823,2560,42,42
3,3.5,2710,3290,2,0,0,3,8,1650,1060,47.5367,-122.072,2440,3290,6000,5730,2710,13,13
4,2.5,2500,36254,1,0,0,4,8,1590,910,47.4685,-122.004,2360,36254,38754,38614,2500,41,41
3,2.5,1600,2610,2,0,0,3,8,1600,0,47.5344,-122.068,1445,1288,4210,2733,1600,14,14
3,1,1400,5662,1,0,0,5,5,1400,0,47.5271,-122.036,1250,14375,7062,15625,1400,99,99
3,2.25,1410,1377,2,0,0,3,7,1290,120,47.5342,-122.067,1445,1370,2787,2815,1410,14,14
4,4,5050,202554,2,0,0,3,10,3260,1790,47.5269,-121.922,3370,213444,207604,216814,5050,19,19
3,2,1420,11325,1,0,0,3,7,1420,0,47.5356,-122.046,2330,3474,12745,5804,1420,39,39
2,2.25,1230,1078,2,0,0,3,7,1160,70,47.5324,-122.073,1240,817,2308,2057,1230,11,11
3,2.5,2140,3628,2,0,0,3,8,1960,180,47.537,-122.074,2280,2812,5768,5092,2140,13,13
4,2,1390,745,3,0,0,3,7,1390,0,47.5393,-122.026,1390,942,2135,2332,1390,11,11
3,2.25,2010,7495,1,0,0,4,8,1570,440,47.5613,-122.083,2050,8402,9505,10452,2010,40,40
5,4,4720,493534,2,0,0,5,9,3960,760,47.4536,-122.009,2160,219542,498254,221702,4720,44,44
3,2.25,1410,1332,2,0,0,3,7,1290,120,47.5345,-122.069,1445,1290,2742,2735,1410,15,15
3,3,2230,1407,2,0,0,3,8,1850,380,47.5446,-122.017,2290,1407,3637,3697,2230,5,5
3,2.25,1760,10835,1,0,0,4,8,1290,470,47.522,-122.048,2050,10488,12595,12538,1760,43,43
4,2.5,2560,10400,1,0,0,4,7,1280,1280,47.5225,-122.04,1740,11050,12960,12790,2560,54,54
4,2.25,2010,9603,1,0,0,3,8,1440,570,47.5343,-122.054,2060,9793,11613,11853,2010,33,33
3,2.25,2680,9162,1,0,0,3,8,1570,1110,47.5683,-122.091,2480,8261,11842,10741,2680,41,41
3,1.75,1400,10018,1,0,0,4,7,1400,0,47.5327,-122.032,1350,9300,11418,10650,1400,57,57
4,2.25,1990,7712,1,0,0,3,8,1210,780,47.5688,-122.087,1720,7393,9702,9113,1990,46,46
7,2.25,3170,36384,2,0,0,3,8,3170,0,47.4654,-122.003,2460,38370,39554,40830,3170,50,50
4,3.25,2740,7266,2,0,0,3,9,2060,680,47.5346,-122.066,3030,6546,10006,9576,2740,16,16
3,2.5,1940,3211,2,0,0,3,8,1940,0,47.5644,-122.093,1880,3078,5151,4958,1940,10,10
4,1.75,2480,60548,1,0,0,4,7,1600,880,47.4722,-122.001,2390,90169,63028,92559,2480,51,51
4,4,7850,89651,2,0,0,3,12,7850,0,47.5406,-121.982,6210,95832,97501,102042,7850,13,13
3,2.75,1840,2060,2,0,0,3,10,1700,140,47.53,-122.073,2590,2680,3900,5270,1840,6,6
3,2.25,1620,998,2,0,0,3,8,1540,80,47.5394,-122.027,1620,1068,2618,2688,1620,7,7
3,2,1500,8086,1,0,0,3,7,1060,440,47.5584,-122.081,1550,8086,9586,9636,1500,38,38
4,3.5,4010,15365,2,0,1,3,11,4010,0,47.5528,-122.093,3550,13429,19375,16979,4010,13,13
2,2.25,1240,705,2,0,0,3,7,1150,90,47.5321,-122.073,1240,750,1945,1990,1240,10,10
2,2.25,1240,750,2,0,0,3,7,1150,90,47.5322,-122.073,1240,750,1990,1990,1240,11,11
4,2.5,2600,118666,1,0,0,3,7,1400,1200,47.54,-121.97,2440,131116,121266,133556,2600,38,38
4,2.25,2770,9340,2,0,0,4,9,2770,0,47.5628,-122.081,3010,9340,12110,12350,2770,40,40
3,2.5,1940,37565,1,0,0,4,8,1940,0,47.4801,-122.063,2560,37565,39505,40125,1940,32,32
3,1.75,1810,10625,1,0,0,3,8,1370,440,47.5322,-122.049,2140,10922,12435,13062,1810,46,46
4,3.5,3280,6603,2,0,0,3,10,3280,0,47.5642,-122.126,3280,7333,9883,10613,3280,12,12
2,1.75,1410,1005,1,0,0,3,9,900,510,47.5446,-122.018,1440,1188,2415,2628,1410,8,8
3,1.75,1290,1237,2,0,0,3,7,1060,230,47.54,-122.026,1370,942,2527,2312,1290,11,11
4,2.5,3060,7140,2,0,0,3,9,3060,0,47.5393,-121.998,3240,6218,10200,9458,3060,13,13
4,2.5,2230,64438,1,0,0,4,7,1230,1000,47.4754,-122.007,2230,71002,66668,73232,2230,41,41
4,2.25,2110,10698,2,0,0,4,8,2110,0,47.5614,-122.082,2220,8252,12808,10472,2110,40,40
3,2.5,1670,2589,2,0,0,3,8,1670,0,47.5314,-122.047,1670,2897,4259,4567,1670,19,19
2,2.25,1150,711,2,0,0,3,7,1150,0,47.5323,-122.071,1150,748,1861,1898,1150,6,6
4,1.75,2800,49149,1,0,0,4,7,1400,1400,47.4649,-122.034,2560,61419,51949,63979,2800,41,41
4,3.25,3680,5759,2,0,0,3,9,2840,840,47.5367,-122.067,3620,6006,9439,9626,3680,16,16
3,1.75,1850,7735,1,0,0,4,8,1850,0,47.5608,-122.082,2220,7639,9585,9859,1850,36,36
4,4,4320,8709,2,0,0,3,11,3190,1130,47.5369,-122.07,4010,8321,13029,12331,4320,13,13
2,2.25,1240,705,2,0,0,3,7,1150,90,47.5321,-122.073,1240,750,1945,1990,1240,10,10
3,2.5,2460,138085,2,0,0,4,9,2460,0,47.4572,-122.007,2090,219542,140545,221632,2460,42,42
2,2.5,2420,60984,2,0,0,3,7,2420,0,47.5262,-121.943,1940,193842,63404,195782,2420,12,12
3,3.25,1540,1487,2,0,0,3,8,1540,0,47.5397,-122.027,1620,1104,3027,2724,1540,8,8
4,3.25,3080,4287,2,0,0,3,10,2230,850,47.5313,-122.076,2250,2520,7367,4770,3080,7,7
3,2.25,1445,1471,2,0,0,3,7,1300,145,47.5342,-122.072,1410,1399,2916,2809,1445,16,16
3,1.75,2030,10089,1,0,0,4,8,1330,700,47.5217,-122.05,2030,9827,12119,11857,2030,43,43
2,2.25,1150,711,2,0,0,3,7,1150,0,47.5323,-122.07,1150,748,1861,1898,1150,6,6
3,2.25,1800,36704,1,0,0,4,8,1360,440,47.4688,-122.013,2730,36404,38504,39134,1800,41,41
2,1.75,2040,114562,1,0,0,4,7,2040,0,47.4985,-122.092,1850,94960,116602,96810,2040,51,51
3,1.75,2250,11520,1,0,1,3,8,2250,0,47.7619,-122.268,2730,12445,13770,15175,2250,63,63
3,2.5,2100,6092,2,0,0,3,8,2100,0,47.7508,-122.239,2250,8592,8192,10842,2100,6,6
5,3.5,4060,8309,2,0,0,3,9,2960,1100,47.757,-122.228,1730,11711,12369,13441,4060,18,18
4,2.75,2140,13000,1,0,0,3,7,1320,820,47.7683,-122.252,2360,11000,15140,13360,2140,51,51
3,2.25,1710,11500,1,0,0,3,7,1210,500,47.7675,-122.267,1800,11500,13210,13300,1710,41,41
3,2.25,1180,9630,2,0,0,3,7,1180,0,47.7352,-122.232,2660,5979,10810,8639,1180,33,33
4,3,2290,5105,2,0,0,3,8,2290,0,47.7727,-122.237,2450,5105,7395,7555,2290,7,7
3,2.25,1510,9600,1,0,0,1,7,1090,420,47.7758,-122.238,1870,10681,11110,12551,1510,53,53
4,2.5,2800,17279,1,0,2,3,7,1560,1240,47.7596,-122.269,3060,13423,20079,16483,2800,62,62
3,1.75,2110,10454,1,0,0,4,8,1440,670,47.7344,-122.246,1990,10890,12564,12880,2110,41,41
4,2.5,2820,5612,2,0,0,3,9,2820,0,47.7477,-122.236,1620,14881,8432,16501,2820,12,12
4,2.5,2160,9750,2,0,0,3,8,2160,0,47.7438,-122.246,2840,10535,11910,13375,2160,36,36
3,1,980,9903,1,0,0,4,7,980,0,47.7746,-122.239,1830,9903,10883,11733,980,53,53
3,1.75,1830,27468,1,0,0,3,7,1830,0,47.7754,-122.233,1860,10180,29298,12040,1830,65,65
4,2.5,2480,9869,1,0,0,4,8,1240,1240,47.7612,-122.229,2230,10310,12349,12540,2480,56,56
6,3,3470,117612,1,0,0,3,7,3470,0,47.7663,-122.234,2120,17100,121082,19220,3470,95,95
4,2.5,2440,28405,2,0,0,3,8,2440,0,47.7386,-122.238,2480,11429,30845,13909,2440,17,17
4,1,2020,18150,1,0,0,4,7,2020,0,47.739,-122.249,1530,11970,20170,13500,2020,64,64
3,2.5,2550,6677,2,0,0,3,8,2550,0,47.7336,-122.232,1930,7217,9227,9147,2550,17,17
3,2.5,2820,10208,1,0,1,4,8,1410,1410,47.7609,-122.26,1540,10684,13028,12224,2820,65,65
3,1.75,1530,10731,1,0,0,3,7,1530,0,47.7655,-122.244,2100,12593,12261,14693,1530,33,33
3,2.75,2460,6413,2,0,0,3,9,2460,0,47.7497,-122.245,2440,6092,8873,8532,2460,15,15
2,1.5,1068,1158,2,0,0,3,7,1068,0,47.753,-122.244,1078,1278,2226,2356,1068,29,29
5,2.75,3740,6750,1,0,0,4,8,1980,1760,47.7679,-122.261,2620,7920,10490,10540,3740,41,41
3,1,1520,10798,1,0,0,3,7,1520,0,47.7635,-122.262,1670,9876,12318,11546,1520,66,66
3,2.5,1300,10484,2,0,0,3,8,1300,0,47.7768,-122.268,1380,7868,11784,9248,1300,36,36
4,2.5,2300,10880,1,0,0,4,7,1190,1110,47.7341,-122.242,1960,10400,13180,12360,2300,58,58
4,2.5,2040,5616,2,0,0,3,8,2040,0,47.7737,-122.238,2380,4737,7656,7117,2040,7,7
3,2.25,2010,7447,2,0,0,3,8,2010,0,47.747,-122.248,2230,7846,9457,10076,2010,34,34
4,2.75,2720,4613,2,0,0,3,9,2720,0,47.7352,-122.223,2830,4836,7333,7666,2720,14,14
3,2.5,1990,12793,2,0,0,3,8,1990,0,47.7347,-122.226,2290,9035,14783,11325,1990,26,26
2,1,1220,10000,1,0,0,5,7,1220,0,47.7405,-122.241,2000,9600,11220,11600,1220,69,69
5,2,1760,21562,1,0,1,3,8,1560,200,47.7597,-122.263,2150,12676,23322,14826,1760,60,60
3,1.75,2160,8565,1,0,0,3,8,1730,430,47.7664,-122.262,2910,9570,10725,12480,2160,48,48
5,2.5,2270,10700,1,0,0,4,8,1570,700,47.741,-122.256,2020,10230,12970,12250,2270,56,56
4,2.5,2650,9627,1,0,3,4,8,1610,1040,47.7684,-122.254,2650,9221,12277,11871,2650,43,43
3,1,1160,10518,1,0,0,3,7,1160,0,47.7343,-122.22,1670,9380,11678,11050,1160,59,59
3,2.5,2990,9413,2,0,0,3,10,2990,0,47.7341,-122.234,1940,9600,12403,11540,2990,13,13
4,2.75,2630,4501,2,0,0,3,8,2630,0,47.7748,-122.244,2380,4599,7131,6979,2630,4,4
4,2.5,1850,9248,2,0,0,3,8,1850,0,47.735,-122.244,2080,8711,11098,10791,1850,22,22
3,1,2400,17239,1,0,0,4,7,1890,510,47.75,-122.245,2390,7350,19639,9740,2400,79,79
3,1.75,1160,22470,1,0,0,4,7,1160,0,47.7595,-122.23,1940,15999,23630,17939,1160,43,43
3,2.75,3200,12682,2,0,1,3,9,3200,0,47.7443,-122.26,2880,10432,15882,13312,3200,42,42
4,2.25,2590,10002,1,0,0,4,8,1340,1250,47.7689,-122.266,1550,10436,12592,11986,2590,51,51
3,1.75,1320,7200,1,0,0,4,7,1320,0,47.7341,-122.237,1750,7260,8520,9010,1320,42,42
4,3.25,4110,14219,2,0,2,4,10,2570,1540,47.7382,-122.264,2760,12283,18329,15043,4110,40,40
4,1.5,2150,11026,1,0,0,4,7,2150,0,47.7635,-122.263,1760,10283,13176,12043,2150,67,67
3,1.75,1660,8301,1,0,0,5,7,1660,0,47.7647,-122.263,1660,9489,9961,11149,1660,64,64
5,2.75,2190,12687,1,0,0,5,7,1370,820,47.7762,-122.257,2280,10784,14877,13064,2190,41,41
3,1.75,1270,6017,1,0,0,4,7,1030,240,47.737,-122.225,1630,7381,7287,9011,1270,29,29
6,2,2400,7684,1,0,0,3,6,1200,1200,47.7705,-122.269,1290,9800,10084,11090,2400,87,10
4,3,2650,4924,2,0,0,3,8,2650,0,47.7734,-122.238,2380,4733,7574,7113,2650,8,8
4,2.25,2150,20181,1,0,0,3,7,1090,1060,47.7627,-122.245,2150,10480,22331,12630,2150,56,56
4,2.5,2280,8798,2,0,0,4,8,2280,0,47.7471,-122.247,2180,8632,11078,10812,2280,32,32
3,1.5,1300,12240,1,0,0,3,7,1300,0,47.737,-122.243,2040,9326,13540,11366,1300,56,56
4,2.5,2060,10125,2,0,0,4,7,1560,500,47.764,-122.262,1760,9876,12185,11636,2060,40,40
4,2.25,3230,9935,2,0,0,3,8,3230,0,47.7685,-122.257,2820,9722,13165,12542,3230,33,33
6,3.25,3870,24700,2,0,0,3,10,2520,1350,47.7517,-122.233,2360,30030,28570,32390,3870,30,30
4,2.5,2890,5801,2,0,0,3,9,2890,0,47.7349,-122.238,2890,6286,8691,9176,2890,14,14
4,2.75,2950,5803,2,0,0,3,9,2950,0,47.7368,-122.231,2940,5803,8753,8743,2950,12,12
4,2.5,2807,9430,2,0,0,3,8,2807,0,47.7449,-122.223,2028,11056,12237,13084,2807,23,23
4,1.75,1970,12409,1,0,0,4,7,1220,750,47.7489,-122.236,1690,10720,14379,12410,1970,51,51
3,2.25,2160,9540,2,0,0,3,8,2160,0,47.7668,-122.243,1720,12593,11700,14313,2160,40,40
3,2.5,2310,4729,2,0,0,3,8,2310,0,47.7734,-122.237,2440,4711,7039,7151,2310,8,8
4,3,2450,4668,2,0,0,3,8,2450,0,47.7721,-122.235,2460,4895,7118,7355,2450,15,15
4,3,3100,15480,2,0,0,3,8,2400,700,47.7466,-122.241,2000,42500,18580,44500,3100,23,23
4,1.75,2190,9225,1,0,0,4,7,1250,940,47.7396,-122.256,2190,9225,11415,11415,2190,60,60
2,1.5,1068,1452,2,0,0,3,7,1068,0,47.753,-122.244,1078,1357,2520,2435,1068,29,29
4,2.5,2600,9355,1,0,0,3,9,1840,760,47.7446,-122.249,2250,7691,11955,9941,2600,36,36
4,2.25,1880,9727,1,0,0,3,7,1100,780,47.7731,-122.257,1790,10274,11607,12064,1880,40,40
4,2.5,2420,10603,1,0,0,5,7,1210,1210,47.7397,-122.259,1750,10800,13023,12550,2420,61,61
5,2.75,2620,6389,2,0,0,3,9,2620,0,47.77,-122.236,2620,4504,9009,7124,2620,12,12
3,1.75,1770,10513,1,0,0,4,7,1400,370,47.7726,-122.266,2070,9968,12283,12038,1770,37,37
3,1.75,1460,7980,1,0,0,3,7,1460,0,47.7713,-122.265,1920,7980,9440,9900,1460,47,47
3,1,1830,8209,1,0,0,3,7,1830,0,47.7439,-122.228,2150,12000,10039,14150,1830,77,77
4,2.75,3820,26300,2,0,0,3,9,2850,970,47.7618,-122.261,1860,12136,30120,13996,3820,5,5
3,2.25,1960,44634,1,0,0,3,7,1130,830,47.7769,-122.253,1970,44634,46594,46604,1960,35,35
3,3,1850,9600,1,0,0,3,7,1230,620,47.7717,-122.25,1970,10000,11450,11970,1850,38,38
3,2.25,1490,4539,2,0,0,3,7,1490,0,47.7607,-122.233,1750,4667,6029,6417,1490,10,10
3,2.25,3420,9900,1,0,0,3,9,1710,1710,47.7412,-122.256,2290,10700,13320,12990,3420,56,10
3,3,2420,13959,1,0,0,4,8,1740,680,47.7486,-122.23,2570,13300,16379,15870,2420,31,31
4,3.5,3100,15842,2,0,0,3,8,2400,700,47.7466,-122.242,2200,19400,18942,21600,3100,23,23
3,2.5,1860,3690,2,0,0,3,7,1860,0,47.776,-122.239,1870,4394,5550,6264,1860,19,19
3,2.5,2170,4912,2,0,0,3,7,2170,0,47.7767,-122.239,2010,4395,7082,6405,2170,16,16
3,1.75,1400,13775,1,0,0,3,8,1400,0,47.7413,-122.259,2200,10450,15175,12650,1400,56,56
4,2.25,2550,10000,1,0,0,4,7,1560,990,47.77,-122.259,2440,10000,12550,12440,2550,40,40
4,1.75,2340,17541,1,0,0,4,7,1360,980,47.745,-122.229,2250,9212,19881,11462,2340,63,63
4,2,1670,12056,1,0,0,3,7,1670,0,47.7418,-122.244,1860,12056,13726,13916,1670,64,64
3,1.5,1860,9003,1,0,0,3,7,1490,370,47.7624,-122.26,2090,11574,10863,13664,1860,64,64
4,2.5,2470,7539,2,0,0,3,9,2470,0,47.7407,-122.226,2580,7539,10009,10119,2470,13,13
3,2.25,1450,4706,2,0,0,3,7,1450,0,47.761,-122.232,1490,4667,6156,6157,1450,10,10
3,1,1190,9000,1,0,0,3,7,1190,0,47.77,-122.264,1960,7200,10190,9160,1190,51,51
2,2,1384,1822,2,0,0,3,7,1384,0,47.7525,-122.244,1078,1315,3206,2393,1384,29,29
2,1,950,11835,1,0,0,3,5,950,0,47.7494,-122.237,1690,12586,12785,14276,950,87,87
4,2.5,3290,11446,2,0,0,3,8,3290,0,47.7399,-122.234,2050,11933,14736,13983,3290,27,27
4,2.5,2800,21370,2,0,0,3,8,2800,0,47.776,-122.246,1880,9336,24170,11216,2800,16,16
4,2.5,3700,4500,2,0,0,3,9,3700,0,47.7473,-122.23,3050,5047,8200,8097,3700,12,12
4,2.25,2040,12000,1,0,0,4,7,1300,740,47.7362,-122.241,1930,12000,14040,13930,2040,56,56
3,2.5,1720,10031,2,0,0,3,8,1720,0,47.7688,-122.238,2280,5845,11751,8125,1720,26,26
4,2.5,2840,4500,2,0,0,3,8,2840,0,47.7678,-122.237,2840,4939,7340,7779,2840,7,7
3,2.75,2010,11200,1,0,0,3,8,1360,650,47.7728,-122.253,2200,10640,13210,12840,2010,40,40
3,2.25,1800,9800,1,0,0,4,7,1300,500,47.7393,-122.244,1680,9545,11600,11225,1800,60,60
3,2.25,1420,6600,1,0,0,3,7,1160,260,47.77,-122.265,1920,7902,8020,9822,1420,32,32
2,1,720,5820,1,0,1,5,6,720,0,47.7598,-122.255,952,5820,6540,6772,720,69,69
4,1.75,1830,11090,1,0,0,3,7,1060,770,47.7333,-122.246,1990,10917,12920,12907,1830,57,57
3,2.5,1530,1116,2,0,0,3,7,1530,0,47.7385,-122.25,1530,7780,2646,9310,1530,14,14
4,2.5,2470,5954,2,0,0,3,8,2470,0,47.7685,-122.236,2470,4800,8424,7270,2470,6,6
3,2.75,2650,9752,1,0,0,3,9,2650,0,47.768,-122.259,3030,9910,12402,12940,2650,30,30
4,2.25,2100,9984,1,0,0,4,7,1290,810,47.7365,-122.242,1930,10511,12084,12441,2100,46,46
4,1.75,1770,12875,1,0,0,3,8,1770,0,47.7438,-122.247,2150,12875,14645,15025,1770,31,31
4,4.25,3770,13058,2,0,0,4,8,3770,0,47.7517,-122.225,2200,12255,16828,14455,3770,36,36
3,2.5,2690,11575,1,0,3,3,8,2130,560,47.7605,-122.267,2390,11782,14265,14172,2690,62,62
3,2.25,1740,11040,2,0,0,3,8,1740,0,47.7376,-122.242,1720,11778,12780,13498,1740,39,39
3,2.5,2678,6607,2,0,0,3,9,2678,0,47.738,-122.235,2780,6607,9285,9387,2678,21,21
3,1,1720,9605,1,0,0,3,7,860,860,47.7439,-122.242,1720,9998,11325,11718,1720,50,50
3,1,1160,36831,1,0,0,3,7,1160,0,47.7507,-122.237,1800,15640,37991,17440,1160,81,81
3,0.75,1040,15000,1,0,0,3,6,1040,0,47.7639,-122.234,1410,19000,16040,20410,1040,78,78
3,2.5,2830,5788,2,0,0,3,9,2830,0,47.7604,-122.235,2500,5802,8618,8302,2830,18,18
3,1.75,1650,12940,1,0,0,4,7,1650,0,47.7629,-122.268,2830,12600,14590,15430,1650,58,58
3,2.25,2520,26943,1,0,0,3,7,1760,760,47.7728,-122.25,2300,10004,29463,12304,2520,42,42
3,2.25,1400,11400,2,0,0,3,8,1400,0,47.7428,-122.231,2180,9248,12800,11428,1400,35,35
4,2.25,2940,48788,1,0,0,5,7,1520,1420,47.7422,-122.245,2470,14900,51728,17370,2940,58,58
4,2.5,2610,4595,2,0,0,3,8,2610,0,47.7728,-122.235,2440,4588,7205,7028,2610,11,11
3,1,1060,10050,1,0,0,4,7,1060,0,47.7355,-122.231,1570,9938,11110,11508,1060,52,52
3,2.5,2390,6263,2,0,0,3,9,2390,0,47.7379,-122.248,2390,11761,8653,14151,2390,16,16
3,2.25,3010,9600,2,0,0,3,8,2410,600,47.7671,-122.263,2620,9660,12610,12280,3010,41,41
3,1.75,1510,9720,1,0,0,3,7,1510,0,47.7728,-122.258,1520,10037,11230,11557,1510,71,39
4,2.5,2480,16360,1,0,0,5,7,1510,970,47.7638,-122.265,1770,15205,18840,16975,2480,60,60
3,1.75,2220,11646,1,0,0,3,7,1270,950,47.7762,-122.27,1490,10003,13866,11493,2220,69,69
4,2.5,2590,6394,2,0,0,3,8,2590,0,47.7599,-122.233,2500,5328,8984,7828,2590,16,16
4,1.75,1570,9670,1,0,0,3,7,1170,400,47.7432,-122.248,2080,9100,11240,11180,1570,60,60
4,2.75,3650,4534,2,0,0,3,7,2940,710,47.7397,-122.224,2400,7682,8184,10082,3650,5,5
2,1.5,1068,1758,2,0,0,3,7,1068,0,47.7527,-122.244,1078,1315,2826,2393,1068,29,29
2,1,770,10000,1,0,0,3,6,770,0,47.7379,-122.233,2720,8062,10770,10782,770,86,86
3,2.25,2590,9263,1,0,0,5,8,1440,1150,47.7691,-122.262,2580,9450,11853,12030,2590,42,42
3,2.5,1920,9812,2,0,0,3,8,1920,0,47.7633,-122.243,1830,10534,11732,12364,1920,19,19
3,2.5,1710,12677,2,0,0,3,8,1710,0,47.75,-122.234,1610,12160,14387,13770,1710,23,23
3,1.75,1460,9998,1,0,0,3,7,960,500,47.7434,-122.242,1460,9998,11458,11458,1460,61,61
3,1.75,2300,12682,1,0,2,3,8,2300,0,47.7588,-122.27,2720,14643,14982,17363,2300,64,64
3,1.5,1340,13560,1,0,0,3,7,1340,0,47.741,-122.234,1540,15000,14900,16540,1340,51,51
5,2,2330,10750,1,0,0,4,7,1190,1140,47.7325,-122.245,1830,10180,13080,12010,2330,57,57
4,2.25,2200,6900,2,0,0,4,8,2200,0,47.7682,-122.261,2400,6900,9100,9300,2200,44,44
3,2.5,1820,4883,2,0,0,3,9,1820,0,47.7355,-122.224,2720,5002,6703,7722,1820,14,14
3,2.25,1830,7943,2,0,0,3,8,1830,0,47.7466,-122.249,2100,8070,9773,10170,1830,34,34
3,2.25,1490,4522,2,0,0,3,7,1490,0,47.7611,-122.233,1580,4667,6012,6247,1490,10,10
2,2.25,1660,2128,2,0,0,4,8,1660,0,47.7528,-122.252,1640,2128,3788,3768,1660,45,45
4,2.5,1750,4779,2,0,0,3,7,1750,0,47.7608,-122.232,1580,4687,6529,6267,1750,10,10
3,2.25,1840,9929,1,0,0,3,7,1200,640,47.7408,-122.236,1710,9929,11769,11639,1840,32,32
4,2.25,2070,14000,1,0,0,3,7,1720,350,47.7484,-122.237,1690,14444,16070,16134,2070,61,61
4,2.5,4060,9734,1,0,4,3,9,2150,1910,47.7678,-122.254,2750,10370,13794,13120,4060,42,42
3,1.5,1490,9630,1,0,0,4,8,1490,0,47.7623,-122.256,1960,10469,11120,12429,1490,60,60
4,1.75,1400,11934,1,0,0,3,7,1050,350,47.7346,-122.244,2080,10400,13334,12480,1400,58,58
4,2.5,2070,4270,2,0,0,3,8,2070,0,47.773,-122.265,2070,4610,6340,6680,2070,9,9
3,1.5,1300,8280,1,0,0,5,7,1300,0,47.7403,-122.256,1570,8692,9580,10262,1300,63,63
4,2.5,2010,6294,2,0,0,3,7,2010,0,47.776,-122.24,1870,4394,8304,6264,2010,19,19
4,2.5,2590,7910,2,0,0,3,9,2590,0,47.7378,-122.248,2110,11761,10500,13871,2590,16,16
4,2.5,2360,15008,1,0,0,3,9,1920,440,47.7363,-122.254,2680,15344,17368,18024,2360,33,33
4,2.5,2320,7800,2,0,0,3,8,2320,0,47.7738,-122.266,2090,5721,10120,7811,2320,33,33
3,2.5,2040,7503,2,0,0,3,8,2040,0,47.5718,-122.021,2170,7503,9543,9673,2040,32,32
3,2.5,1720,4006,2,0,0,3,8,1720,0,47.569,-122.007,1780,3974,5726,5754,1720,25,25
3,2.25,1440,4667,2,0,0,3,7,1440,0,47.5662,-122.017,1610,4756,6107,6366,1440,34,34
4,2.25,1890,3615,2,0,0,3,7,1890,0,47.5493,-121.999,1630,3280,5505,4910,1890,14,14
4,4.25,4500,215186,2,0,3,3,11,2630,1870,47.559,-122.045,3030,25447,219686,28477,4500,10,10
3,2.75,2950,6667,2,0,0,3,9,2950,0,47.5577,-122.026,3340,6667,9617,10007,2950,16,16
4,2.5,2780,7985,2,0,0,4,10,2780,0,47.5608,-122.016,2650,8094,10765,10744,2780,27,27
4,3.25,3440,7661,2,0,0,3,11,3440,0,47.5429,-121.995,3580,6478,11101,10058,3440,13,13
3,2.25,1260,3000,2,0,0,3,7,1260,0,47.5454,-121.997,1630,3042,4260,4672,1260,16,16
2,2.25,1620,1841,2,0,0,3,8,1540,80,47.5483,-122.004,1530,1831,3461,3361,1620,15,15
3,2.5,1690,1689,2,0,0,3,8,1150,540,47.5528,-121.999,1540,1689,3379,3229,1690,5,5
3,2.25,1690,4964,2,0,0,3,8,1690,0,47.5756,-122.01,1800,5036,6654,6836,1690,30,30
4,2.5,3020,3600,2,0,0,3,9,3020,0,47.5407,-121.993,2570,3600,6620,6170,3020,10,10
4,2.5,1950,3720,2,0,0,3,8,1950,0,47.5503,-121.997,1720,3720,5670,5440,1950,15,15
3,2.5,2180,7169,2,0,0,3,8,2180,0,47.5714,-122.002,2150,5914,9349,8064,2180,29,29
4,3.5,3780,20023,2,0,2,3,10,3780,0,47.5491,-122.006,2150,3675,23803,5825,3780,18,18
3,2.5,1910,5562,2,0,0,3,8,1910,0,47.5738,-122.017,1940,4647,7472,6587,1910,31,31
3,2.5,1890,5929,2,0,0,3,8,1890,0,47.5697,-121.994,2060,5775,7819,7835,1890,26,26
4,4.5,3890,5906,2,0,3,3,11,3060,830,47.5426,-121.995,4170,6052,9796,10222,3890,15,15
4,3.5,2980,2147,2,0,0,3,10,2490,490,47.5463,-121.995,2880,2428,5127,5308,2980,13,13
4,2.5,2940,14071,2,0,0,3,9,2940,0,47.5627,-122.018,2670,10982,17011,13652,2940,33,33
3,2.5,2210,8622,2,0,0,3,8,2210,0,47.5715,-122.02,2340,7192,10832,9532,2210,31,31
3,2.5,2160,7584,2,0,0,3,8,2160,0,47.5751,-122.014,2160,7372,9744,9532,2160,31,31
4,4,4270,6002,2,0,3,3,10,3180,1090,47.5443,-121.994,4280,5942,10272,10222,4270,15,15
4,2.5,2680,9185,2,0,0,3,9,2680,0,47.5738,-121.992,2810,8505,11865,11315,2680,30,30
4,2.5,2260,7753,2,0,0,3,9,2260,0,47.5752,-121.995,2690,8924,10013,11614,2260,30,30
4,2.5,2400,7351,2,0,0,3,9,2400,0,47.5707,-122.022,2330,7756,9751,10086,2400,29,29
4,3,2320,4468,2,0,0,3,8,2160,160,47.546,-122.009,2330,3541,6788,5871,2320,20,20
3,2.5,1670,5146,2,0,0,3,8,1670,0,47.5707,-121.999,1940,5146,6816,7086,1670,28,28
4,2.5,2120,3640,2,0,0,3,8,2120,0,47.5521,-121.996,2190,3640,5760,5830,2120,14,14
3,2.5,2190,3600,2,0,0,3,9,2190,0,47.5506,-121.993,2300,3600,5790,5900,2190,16,16
3,2.5,1470,1779,2,0,0,3,8,1160,310,47.5472,-121.998,1470,1576,3249,3046,1470,14,14
3,2.5,1700,3150,2,0,0,3,8,1700,0,47.5505,-121.998,1700,3600,4850,5300,1700,14,14
3,2.5,1500,2314,2,0,0,3,7,1500,0,47.5537,-121.998,1440,2170,3814,3610,1500,14,14
3,2.25,1710,4140,2,0,0,3,8,1710,0,47.5498,-121.997,1730,3680,5850,5410,1710,15,15
4,3,2170,5764,2,0,0,3,8,2170,0,47.5673,-121.999,2010,5681,7934,7691,2170,27,27
3,2.5,1470,1445,2,0,0,3,8,1160,310,47.5468,-121.998,1470,1525,2915,2995,1470,14,14
4,2.5,2280,7219,2,0,0,4,8,2280,0,47.5719,-122.021,2240,7471,9499,9711,2280,32,32
3,3.25,3190,5283,2,0,0,3,9,3190,0,47.5534,-122.002,2950,5198,8473,8148,3190,12,12
4,2.75,1950,6192,2,0,0,3,8,1950,0,47.5698,-121.999,2040,5441,8142,7481,1950,27,27
3,2,1440,5469,1,0,0,3,8,1440,0,47.5753,-122.017,1980,6198,6909,8178,1440,31,31
4,2.5,1980,4500,2,0,0,3,8,1980,0,47.579,-122.001,1770,4595,6480,6365,1980,30,30
4,2.5,2700,10160,2,0,0,3,9,2700,0,47.5685,-122.012,2760,9219,12860,11979,2700,31,31
4,2.5,2040,5508,2,0,0,4,8,2040,0,47.5719,-122.007,2130,5496,7548,7626,2040,23,23
3,2,1540,1827,2,0,0,3,8,1540,0,47.5479,-121.998,1540,1827,3367,3367,1540,14,14
4,2.5,2340,8971,2,0,0,3,9,2340,0,47.5679,-122.011,2510,9219,11311,11729,2340,32,32
4,3.5,3010,6202,2,0,0,3,9,3010,0,47.5533,-121.993,2520,5001,9212,7521,3010,14,14
3,2.25,1630,2520,2,0,0,3,7,1630,0,47.5493,-121.998,1630,3131,4150,4761,1630,14,14
3,2.5,2370,4950,2,0,0,3,8,2370,0,47.5465,-122.013,2230,4950,7320,7180,2370,16,16
3,2.5,1910,4363,2,0,0,3,9,1910,0,47.5482,-121.996,1890,3732,6273,5622,1910,13,13
3,2.5,2010,2386,2,0,0,3,8,1390,620,47.5525,-121.998,1690,1870,4396,3560,2010,5,5
4,2.5,2130,9139,2,0,0,3,9,2130,0,47.5648,-122.01,2150,8178,11269,10328,2130,31,31
4,2.75,2940,4232,2,0,0,3,9,2940,0,47.5529,-121.99,2410,4000,7172,6410,2940,15,15
4,2.5,2620,6114,2,0,0,3,9,2620,0,47.5603,-122.013,2620,5808,8734,8428,2620,8,8
2,2.5,1830,2856,2,0,0,3,7,1830,0,47.5524,-121.996,1850,2667,4686,4517,1830,14,14
3,2.75,2470,3600,2,0,0,3,9,2470,0,47.5406,-121.994,2570,3600,6070,6170,2470,12,12
2,1.75,1230,1107,2,0,0,3,8,1230,0,47.5475,-121.999,1380,1107,2337,2487,1230,13,13
4,2.75,2180,5799,2,0,0,4,8,2180,0,47.5702,-121.995,2060,6061,7979,8121,2180,26,26
3,2.5,1770,5146,2,0,0,3,8,1770,0,47.5704,-121.999,1870,5146,6916,7016,1770,27,27
3,3.25,1710,2381,2,0,0,3,8,1360,350,47.5477,-122.004,1420,1163,4091,2583,1710,16,16
4,3.25,3740,11467,2,0,0,3,10,3740,0,47.581,-122.022,2510,27520,15207,30030,3740,5,5
3,2.5,2440,10363,2,0,0,3,9,2440,0,47.5634,-122.016,2500,10728,12803,13228,2440,31,31
4,2.5,1670,3315,2,0,0,3,7,1670,0,47.5532,-121.998,1650,2051,4985,3701,1670,14,14
3,2.5,2140,3821,2,0,0,3,8,2140,0,47.5541,-121.995,2860,3841,5961,6701,2140,14,14
3,2.5,2050,4976,2,0,0,3,8,2050,0,47.5689,-121.995,2050,5153,7026,7203,2050,25,25
3,2.5,1800,3933,2,0,0,3,8,1800,0,47.5746,-122.009,1800,4659,5733,6459,1800,30,30
4,2.5,3700,7051,2,0,0,3,11,3700,0,47.5427,-121.995,3580,6175,10751,9755,3700,13,13
4,2.5,2700,9122,2,0,0,3,9,2700,0,47.5771,-121.994,2500,9122,11822,11622,2700,29,29
3,2.5,2120,6602,2,0,0,4,8,2120,0,47.5669,-122.012,2330,7795,8722,10125,2120,30,30
4,2.5,2310,3866,2,0,0,3,8,2310,0,47.5498,-121.996,1950,4023,6176,5973,2310,14,14
3,2.25,1610,5159,2,0,0,3,7,1610,0,47.5675,-122.019,1610,5210,6769,6820,1610,34,34
4,2.5,3670,7680,2,0,0,3,10,3670,0,47.5401,-121.993,3130,6112,11350,9242,3670,12,12
3,2.5,2010,2261,2,0,0,3,8,1390,620,47.5514,-121.998,1690,1899,4271,3589,2010,5,5
4,2.75,2330,3917,2,0,0,3,9,2330,0,47.5527,-121.99,2620,4400,6247,7020,2330,15,15
4,3.5,2710,2147,2,0,0,3,10,2220,490,47.5468,-121.994,2650,2252,4857,4902,2710,12,12
3,2.5,1480,1961,2,0,0,3,8,1480,0,47.5478,-122,1400,1138,3441,2538,1480,14,14
3,2.5,1530,3840,2,0,0,3,8,1530,0,47.5691,-122.007,1720,3985,5370,5705,1530,25,25
4,3.25,3730,11820,2,0,0,3,10,2460,1270,47.5775,-122.019,3680,10667,15550,14347,3730,29,29
3,2.5,2350,7035,2,0,0,3,8,2350,0,47.5713,-122.02,2270,7192,9385,9462,2350,30,30
3,2,1330,5632,1,0,0,3,8,1330,0,47.5745,-122.017,1900,4842,6962,6742,1330,31,31
3,2.5,2080,2625,2,0,0,3,8,2080,0,47.5469,-121.997,1760,2772,4705,4532,2080,13,13
3,2.25,1760,4539,2,0,0,3,8,1760,0,47.5754,-122.013,1960,4808,6299,6768,1760,31,31
3,1,1290,47044,1,0,0,3,7,1150,140,47.5655,-121.998,1960,49658,48334,51618,1290,51,51
3,2.25,1470,4322,2,0,0,3,7,1470,0,47.5672,-122.018,1610,4322,5792,5932,1470,34,34
4,2.5,2660,5608,2,0,0,3,9,2660,0,47.5449,-121.995,3010,5608,8268,8618,2660,16,16
4,2.5,2540,5760,2,0,0,3,9,2540,0,47.5405,-121.993,2580,3600,8300,6180,2540,10,10
4,3.5,3060,4777,2,0,0,3,9,3060,0,47.555,-122,3060,4935,7837,7995,3060,12,12
3,2.5,2010,2287,2,0,0,3,8,1390,620,47.5517,-121.998,1690,1662,4297,3352,2010,5,5
3,2.5,1730,4924,2,0,0,3,8,1730,0,47.5672,-122.005,1610,4313,6654,5923,1730,23,23
3,3.25,3190,5283,2,0,0,3,9,3190,0,47.5534,-122.002,2950,5198,8473,8148,3190,12,12
4,2.5,3060,8167,2,0,0,3,9,3060,0,47.5521,-121.989,2930,4800,11227,7730,3060,14,14
4,2.5,2500,8540,2,0,0,3,9,2500,0,47.5759,-121.994,2560,8475,11040,11035,2500,29,29
4,2.5,2440,7491,2,0,0,4,10,2440,0,47.561,-122.019,2490,8580,9931,11070,2440,31,31
3,2.25,1850,10855,1,0,0,3,8,1370,480,47.5696,-122.02,1850,8209,12705,10059,1850,34,34
4,3.25,2930,25020,2,0,0,3,9,2930,0,47.5514,-122.023,2400,32374,27950,34774,2930,6,6
3,2,1540,1827,2,0,0,3,8,1540,0,47.5479,-121.999,1560,2058,3367,3618,1540,14,14
4,2.5,1780,4169,2,0,0,3,8,1780,0,47.5695,-122.006,1830,4164,5949,5994,1780,25,25
4,2.75,2390,6979,2,0,0,3,8,2390,0,47.5703,-121.996,2090,6321,9369,8411,2390,26,26
3,2.5,2270,7866,1,0,0,4,10,2270,0,47.5622,-122.022,2580,8132,10136,10712,2270,31,31
5,4.5,4130,10404,2,0,0,3,10,4130,0,47.5556,-122.03,3890,11531,14534,15421,4130,15,15
4,3.5,3060,4573,2,0,0,3,9,2410,650,47.5522,-122.001,3170,3634,7633,6804,3060,7,7
4,2.5,2050,2772,2,0,0,3,8,2050,0,47.5431,-122.011,1800,2886,4822,4686,2050,6,6
4,2.5,2290,6738,2,0,0,3,8,2290,0,47.5714,-122.005,2100,6261,9028,8361,2290,23,23
4,3.5,3910,8095,2,0,0,3,9,3130,780,47.5588,-122.036,3770,7021,12005,10791,3910,12,12
4,3.5,3200,3250,2,0,0,3,9,2670,530,47.5515,-122,3400,3663,6450,7063,3200,12,12
3,2.5,1690,1618,2,0,0,3,8,1150,540,47.5518,-121.998,1690,1618,3308,3308,1690,5,5
4,2.5,2050,6360,2,0,0,3,8,2050,0,47.5641,-122.011,2070,7541,8410,9611,2050,31,31
3,3,2980,3730,2,0,0,3,9,2980,0,47.5533,-121.995,2710,3640,6710,6350,2980,14,14
3,2.5,1600,2375,2,0,0,3,7,1600,0,47.5531,-121.996,1830,2375,3975,4205,1600,14,14
4,2.5,2770,10274,2,0,0,3,9,2770,0,47.5748,-122.018,2270,7210,13044,9480,2770,30,30
3,2.5,1640,7847,2,0,0,3,8,1640,0,47.5684,-122.018,1870,6079,9487,7949,1640,32,32
4,2.5,1540,1860,2,0,0,3,8,1540,0,47.5521,-121.999,1210,1090,3400,2300,1540,5,5
4,3,2190,5085,2,0,0,4,8,2190,0,47.5693,-122.002,2130,5142,7275,7272,2190,27,27
3,2.5,1780,4000,2,0,0,4,8,1780,0,47.5677,-122.003,1730,4000,5780,5730,1780,24,24
2,1.75,1210,1032,2,0,0,3,8,1210,0,47.5522,-121.999,1210,1090,2242,2300,1210,5,5
5,2.5,2200,4942,2,0,0,3,8,2200,0,47.5772,-122.001,2200,5924,7142,8124,2200,30,30
3,2.5,2010,2212,2,0,0,3,8,1390,620,47.5523,-121.998,1690,1619,4222,3309,2010,5,5
3,2.25,1440,6232,2,0,0,3,7,1440,0,47.5658,-122.018,1740,5999,7672,7739,1440,34,34
4,2.5,2120,8448,2,0,0,4,9,2120,0,47.5654,-122.01,2140,8122,10568,10262,2120,30,30
4,2.5,2650,30500,1,0,0,4,8,1680,970,47.5535,-122.028,2650,30500,33150,33150,2650,59,59
4,2.5,2240,7350,2,0,0,3,9,2240,0,47.5652,-122.013,2200,8017,9590,10217,2240,30,30
4,2.5,2290,6318,2,0,0,4,8,2290,0,47.57,-122.02,2150,7350,8608,9500,2290,31,31
4,2.5,3710,7491,2,0,0,3,9,3710,0,47.5596,-122.016,3040,7491,11201,10531,3710,16,16
3,2.5,2030,6970,2,0,0,4,8,2030,0,47.5718,-121.999,2000,6140,9000,8140,2030,28,28
3,2.5,2350,4975,2,0,0,3,8,2350,0,47.5418,-122.01,2350,3951,7325,6301,2350,7,7
4,2.5,2080,8504,2,0,0,3,8,2080,0,47.5703,-121.998,2000,6773,10584,8773,2080,28,28
3,2.5,2170,5000,2,0,0,3,9,2170,0,47.5458,-121.996,2170,5000,7170,7170,2170,16,16
3,2.5,2180,5496,2,0,0,3,8,2180,0,47.5723,-122.007,2120,5496,7676,7616,2180,25,25
4,2.5,2440,10049,2,0,0,4,9,2440,0,47.5744,-121.993,2820,8484,12489,11304,2440,30,30
4,2.5,2010,7972,2,0,0,4,8,2010,0,47.5782,-122.018,2100,8511,9982,10611,2010,30,30
3,1.5,1140,3104,2,0,0,3,7,1140,0,47.5707,-122.018,1150,2981,4244,4131,1140,31,31
5,4.5,5840,17168,2,0,0,3,12,4570,1270,47.5457,-121.991,4850,15017,23008,19867,5840,13,13
4,2.5,1850,1836,2,0,0,3,7,1600,250,47.5529,-121.996,1770,2236,3686,4006,1850,14,14
3,2.5,2110,3870,2,0,0,3,9,2110,0,47.5513,-121.994,2300,3870,5980,6170,2110,15,15
4,2.5,2770,9532,2,0,0,4,9,2770,0,47.5688,-122.012,2770,9219,12302,11989,2770,31,31
3,2.5,1740,5782,2,0,0,4,8,1740,0,47.5783,-122.001,2080,5782,7522,7862,1740,30,30
2,2.5,1590,1426,2,0,0,3,8,1590,0,47.5441,-122.013,1590,1426,3016,3016,1590,5,5
3,2.5,3760,5260,2,0,0,3,9,3230,530,47.5489,-122.007,3080,5312,9020,8392,3760,17,17
3,2.25,1260,3000,2,0,0,3,7,1260,0,47.5459,-121.997,1630,3023,4260,4653,1260,16,16
3,2.5,1820,4910,2,0,0,3,8,1820,0,47.5703,-121.996,2090,6668,6730,8758,1820,26,26
3,2.75,2830,3496,2,0,0,3,8,2830,0,47.5606,-122.011,2160,3501,6326,5661,2830,7,7
3,2,1860,5146,2,0,0,3,8,1860,0,47.5706,-121.999,1950,5146,7006,7096,1860,28,28
3,2.25,1710,4561,2,0,0,4,8,1710,0,47.5691,-122.004,1810,4770,6271,6580,1710,25,25
5,4.5,4300,12250,2,0,0,3,10,4300,0,47.5557,-122.027,3950,12250,16550,16200,4300,15,15
3,2.5,2070,10908,2,0,0,3,8,2070,0,47.5665,-122.023,2220,10975,12978,13195,2070,33,33
3,2.5,2420,8244,2,0,0,3,10,2420,0,47.5595,-122.019,2500,9320,10664,11820,2420,31,31
3,2.25,1260,2556,2,0,0,3,7,1260,0,47.5482,-121.998,1630,2844,3816,4474,1260,14,14
3,2.5,2060,4812,2,0,0,3,8,2060,0,47.5793,-122.002,1930,5264,6872,7194,2060,29,29
4,2.5,2580,5787,2,0,0,3,9,2580,0,47.5416,-121.994,2580,4410,8367,6990,2580,12,12
3,2.5,1610,4611,2,0,0,3,8,1610,0,47.5678,-122.004,1730,4461,6221,6191,1610,23,23
3,2.5,1930,4500,2,0,0,3,8,1930,0,47.5791,-122.001,1770,4500,6430,6270,1930,29,29
4,3.25,3030,9273,2,0,0,5,8,3030,0,47.5747,-122.014,2360,7632,12303,9992,3030,31,31
4,2.5,2390,9638,2,0,0,3,10,2390,0,47.5598,-122.018,2630,9258,12028,11888,2390,31,31
3,2.5,1530,3984,2,0,0,3,8,1530,0,47.569,-122.007,1720,4005,5514,5725,1530,24,24
4,2.5,2630,6247,2,0,0,3,8,2630,0,47.5662,-122,2130,4668,8877,6798,2630,27,27
4,4.5,6380,88714,2,0,0,3,12,6380,0,47.5592,-122.015,3040,7113,95094,10153,6380,13,13
3,2.25,1670,5004,2,0,0,3,8,1670,0,47.5688,-122.017,1850,5276,6674,7126,1670,32,32
4,2.5,2160,7000,2,0,0,4,9,2160,0,47.5659,-122.013,2300,7440,9160,9740,2160,30,30
3,2.5,1480,1386,3,0,0,3,8,1480,0,47.5468,-121.998,1470,1593,2866,3063,1480,14,14
3,2.5,2060,7184,2,0,0,3,8,2060,0,47.567,-122.012,2230,7788,9244,10018,2060,32,32
4,2.5,3050,7238,2,0,0,3,8,3050,0,47.5772,-122.013,2580,7228,10288,9808,3050,30,30
4,2.25,1990,5948,2,0,0,3,8,1990,0,47.5712,-121.995,2150,6459,7938,8609,1990,28,28
4,2.5,2740,9959,2,0,0,3,9,2740,0,47.5672,-122.011,2630,9905,12699,12535,2740,30,30
3,2.25,2010,11817,2,0,0,4,8,2010,0,47.5665,-122.023,2190,10168,13827,12358,2010,33,33
2,2.5,2290,3507,2,0,0,3,9,2290,0,47.5545,-122.002,2290,3640,5797,5930,2290,14,14
4,3.25,3040,4155,2,0,0,3,8,2350,690,47.5429,-122.012,2680,4000,7195,6680,3040,6,6
3,2.5,2060,10839,2,0,0,3,8,2060,0,47.5675,-122.016,2180,8126,12899,10306,2060,32,32
3,2.5,2280,12498,2,0,0,4,9,2280,0,47.5688,-122.014,2330,8844,14778,11174,2280,32,32
3,2.5,1500,2255,2,0,0,3,7,1500,0,47.5538,-121.997,1440,2040,3755,3480,1500,14,14
3,2.5,1740,3082,2,0,0,3,8,1740,0,47.5489,-122.006,1910,3075,4822,4985,1740,19,19
4,2.75,2690,25000,1,0,0,3,8,1750,940,47.5537,-122.026,2640,28250,27690,30890,2690,41,41
4,2.5,2220,7064,2,0,0,3,8,2220,0,47.5716,-122.022,2220,7451,9284,9671,2220,31,31
3,2.5,1730,4065,2,0,0,3,8,1730,0,47.5668,-122.005,1730,4094,5795,5824,1730,23,23
4,3.75,3860,5474,2,0,0,3,10,3860,0,47.5396,-121.995,3040,5474,9334,8514,3860,12,12
4,2.5,2650,9990,2,0,0,3,10,2650,0,47.5605,-122.016,2710,8012,12640,10722,2650,29,29
3,1.75,2590,25992,1,0,0,3,8,1970,620,47.5521,-122.03,2590,29250,28582,31840,2590,51,51
4,3.75,3880,9979,2,0,0,3,10,3880,0,47.5408,-121.992,3130,6112,13859,9242,3880,12,12
3,2.25,1470,1703,2,0,0,3,8,1470,0,47.5478,-121.999,1380,1107,3173,2487,1470,14,14
4,2.25,1890,3006,2,0,0,3,7,1890,0,47.5461,-121.998,1580,3000,4896,4580,1890,16,16
3,1.5,1150,3323,2,0,0,3,7,1150,0,47.5707,-122.017,1150,2980,4473,4130,1150,31,31
4,3.5,3370,3634,2,0,0,3,9,2750,620,47.5519,-122.001,3200,3650,7004,6850,3370,12,12
3,2.5,1870,3485,2,0,0,3,8,1870,0,47.5493,-122.004,1940,3485,5355,5425,1870,18,18
3,2.25,1630,3817,2,0,0,3,7,1630,0,47.5485,-121.999,1630,3348,5447,4978,1630,14,14
3,1,1150,8924,1,0,0,3,6,1150,0,47.3865,-122.217,1492,8924,10074,10416,1150,76,76
3,2.5,1520,7200,2,0,0,4,7,1520,0,47.3679,-122.182,1780,7210,8720,8990,1520,34,34
3,1.5,1660,8000,1,0,0,4,7,1120,540,47.353,-122.172,1900,7500,9660,9400,1660,43,43
3,2.5,1400,7629,1,0,0,3,7,1120,280,47.3788,-122.179,1530,7688,9029,9218,1400,31,31
3,2.5,1520,6298,2,0,0,3,7,1520,0,47.3687,-122.182,1670,7207,7818,8877,1520,33,33
4,2.5,3202,4964,2,0,0,3,9,3202,0,47.3412,-122.179,2425,4886,8166,7311,3202,5,5
4,1.75,1910,8171,1,0,0,3,7,1910,0,47.35,-122.168,1910,7542,10081,9452,1910,33,33
3,1,1010,11880,1,0,0,3,7,1010,0,47.3762,-122.219,1150,9435,12890,10585,1010,59,59
3,2.25,1860,13939,1,0,0,4,7,1860,0,47.3746,-122.217,1530,10018,15799,11548,1860,58,58
3,2,1910,8050,1,0,0,4,7,1000,910,47.37,-122.17,1780,7344,9960,9124,1910,39,39
3,2.5,1580,7000,2,0,0,3,8,1580,0,47.3659,-122.17,2110,7062,8580,9172,1580,27,27
4,2.5,2390,6111,2,0,0,3,8,2390,0,47.3677,-122.173,2520,6500,8501,9020,2390,22,22
5,1,1790,30456,1,0,0,4,7,1350,440,47.3469,-122.195,2420,35647,32246,38067,1790,55,55
5,2.5,2450,6994,2,0,0,3,8,2450,0,47.3572,-122.192,1940,6035,9444,7975,2450,17,17
4,3,2793,5703,2,0,0,3,9,2793,0,47.3682,-122.178,2793,5704,8496,8497,2793,10,10
4,2,1890,6302,2,0,0,3,7,1890,0,47.3846,-122.205,1690,5369,8192,7059,1890,22,22
5,2.25,2300,11505,1,0,0,3,8,1300,1000,47.3812,-122.223,2350,11505,13805,13855,2300,56,56
4,3,2483,6870,2,0,0,3,8,2483,0,47.3627,-122.199,1943,6434,9353,8377,2483,14,14
3,1,1460,11880,1,0,0,2,7,1460,0,47.3762,-122.219,1310,9315,13340,10625,1460,58,58
3,2.75,1320,15236,1,0,0,3,7,880,440,47.365,-122.184,1490,8351,16556,9841,1320,24,24
3,2,1410,5760,1,0,0,3,7,1410,0,47.3702,-122.185,1670,6222,7170,7892,1410,34,34
6,2.5,3080,8163,1,0,0,3,7,1580,1500,47.3859,-122.221,1850,8658,11243,10508,3080,34,34
4,2.5,2692,8392,2,0,0,3,9,2692,0,47.3519,-122.197,2574,14446,11084,17020,2692,5,5
3,2.25,1730,9516,1,0,0,3,8,1180,550,47.3823,-122.166,1870,8165,11246,10035,1730,41,41
3,1,1010,11880,1,0,0,3,7,1010,0,47.3762,-122.219,1150,9435,12890,10585,1010,59,59
3,2,1239,6036,1,0,0,3,7,1239,0,47.3689,-122.175,2060,5746,7275,7806,1239,10,10
3,1,1150,8924,1,0,0,3,6,1150,0,47.3865,-122.217,1492,8924,10074,10416,1150,76,76
4,2,1700,12048,2,0,0,3,7,1700,0,47.3748,-122.186,1960,7650,13748,9610,1700,29,29
6,5,3028,18055,2,0,0,3,7,3028,0,47.3651,-122.197,1400,34575,21083,35975,3028,14,14
3,1.75,1440,10920,1,0,0,4,8,1440,0,47.3812,-122.168,1720,8260,12360,9980,1440,42,42
3,2.5,2550,6021,2,0,0,3,7,2550,0,47.3828,-122.211,2080,6021,8571,8101,2550,17,17
3,1.5,1470,11599,1,0,0,3,7,1070,400,47.3632,-122.188,1580,9760,13069,11340,1470,52,52
4,2.5,1970,6600,2,0,0,3,7,1970,0,47.3491,-122.168,1970,7682,8570,9652,1970,32,32
3,2.5,2196,7475,2,0,0,3,8,2196,0,47.3803,-122.204,1860,6755,9671,8615,2196,13,13
3,2,1290,13282,1,0,0,3,7,1290,0,47.3787,-122.169,1290,12357,14572,13647,1290,41,41
4,2.5,2130,9100,1,0,0,3,8,1290,840,47.3815,-122.169,1770,7700,11230,9470,2130,41,41
4,2.5,1700,6031,2,0,0,3,8,1700,0,47.3582,-122.191,1930,6035,7731,7965,1700,25,25
5,2.75,2530,9375,1,0,0,5,7,1530,1000,47.3738,-122.214,2250,8200,11905,10450,2530,53,53
3,1.75,1260,9346,1,0,0,4,7,1260,0,47.3713,-122.186,1800,9705,10606,11505,1260,56,56
4,2.5,1790,19177,1,0,0,4,7,1790,0,47.3617,-122.172,1760,11726,20967,13486,1790,53,53
3,2,1760,6600,1,0,0,3,7,1760,0,47.3836,-122.184,2590,6600,8360,9190,1760,21,21
2,1,1800,9236,1,0,0,3,7,1800,0,47.3792,-122.198,1730,5701,11036,7431,1800,65,65
3,1.75,1490,6930,1,0,0,4,7,1490,0,47.3682,-122.179,1880,6861,8420,8741,1490,29,29
3,1.75,1800,7763,1,0,0,3,6,1470,330,47.3766,-122.184,1440,7483,9563,8923,1800,35,35
3,2.25,1490,8722,2,0,0,3,7,1490,0,47.3648,-122.185,1510,8061,10212,9571,1490,22,22
3,2.75,1300,14197,1,0,0,3,7,860,440,47.3652,-122.183,1550,7596,15497,9146,1300,23,23
4,2.25,2192,12128,2,0,0,3,8,2192,0,47.3644,-122.2,1914,4649,14320,6563,2192,13,13
3,1.75,1980,9800,1,0,0,3,7,1980,0,47.3745,-122.224,1630,7650,11780,9280,1980,28,28
3,2.5,2828,4050,2,0,0,3,8,2828,0,47.382,-122.197,2513,4507,6878,7020,2828,6,6
4,2.5,2156,3562,2,0,0,3,9,2156,0,47.3591,-122.201,1708,3539,5718,5247,2156,7,7
3,1,1980,39150,1,0,0,3,6,1580,400,47.3818,-122.225,1860,11811,41130,13671,1980,87,87
3,2.5,1650,5994,2,0,0,4,7,1650,0,47.3603,-122.19,1930,6666,7644,8596,1650,30,30
3,2,1730,6007,1,0,0,3,8,1730,0,47.3573,-122.2,2000,6245,7737,8245,1730,15,15
3,2.5,1578,7340,2,0,0,3,7,1578,0,47.3771,-122.186,1850,7200,8918,9050,1578,9,9
4,2.5,2930,5973,2,0,0,3,10,2930,0,47.3846,-122.186,3038,7095,8903,10133,2930,11,11
4,2.25,2080,7526,1,0,0,4,7,1280,800,47.3762,-122.183,1200,7500,9606,8700,2080,34,34
3,2.5,1540,7739,2,0,0,4,7,1540,0,47.3511,-122.169,1720,7200,9279,8920,1540,33,33
4,2.5,1867,15314,2,0,0,3,9,1867,0,47.3524,-122.198,2616,8048,17181,10664,1867,6,6
5,3,2110,10766,2,0,0,3,7,2110,0,47.3599,-122.176,1460,10400,12876,11860,2110,14,14
3,2.5,1528,7616,2,0,0,3,7,1528,0,47.3774,-122.186,1850,7340,9144,9190,1528,8,8
3,1.75,2060,7251,1,0,0,3,7,1350,710,47.3569,-122.175,1520,7582,9311,9102,2060,32,32
4,1,1450,32234,1,0,0,4,6,1450,0,47.3818,-122.21,1530,10125,33684,11655,1450,87,87
4,2.5,2060,5950,2,0,0,3,8,2060,0,47.3631,-122.192,2242,6406,8010,8648,2060,19,19
4,2.25,1964,3541,2,0,0,3,9,1964,0,47.3594,-122.201,1757,3547,5505,5304,1964,6,6
3,2.5,1780,7214,1,0,0,4,7,1400,380,47.3667,-122.182,1520,7228,8994,8748,1780,33,33
3,2.5,1610,6732,2,0,0,3,7,1610,0,47.3658,-122.172,1680,7414,8342,9094,1610,25,25
4,2.5,2260,6086,2,0,0,3,8,2260,0,47.3642,-122.174,2260,6218,8346,8478,2260,20,20
3,2.5,1650,6000,2,0,0,3,7,1650,0,47.36,-122.194,1750,6000,7650,7750,1650,29,29
4,3.25,2864,8035,3,0,0,3,8,2864,0,47.3746,-122.189,2419,8984,10899,11403,2864,5,5
4,2.5,2570,10155,2,0,0,3,9,2570,0,47.3842,-122.17,2770,10155,12725,12925,2570,25,25
3,2.5,2329,5720,2,0,0,3,8,2329,0,47.362,-122.2,2197,5720,8049,7917,2329,9,9
3,2.25,2450,6500,2,0,0,4,8,2450,0,47.3739,-122.172,2200,6865,8950,9065,2450,34,34
3,1.75,1840,9697,1,0,0,4,7,1500,340,47.3764,-122.179,1430,8079,11537,9509,1840,34,34
4,2.5,2240,7589,2,0,0,3,8,2240,0,47.3824,-122.207,2250,7300,9829,9550,2240,25,25
4,1.75,1940,7500,1,0,0,4,7,1720,220,47.3736,-122.215,2000,9000,9440,11000,1940,53,53
4,1.75,2250,13515,1,0,0,4,8,2150,100,47.3789,-122.229,2150,12508,15765,14658,2250,79,79
4,2,2340,10507,1,0,0,4,6,2340,0,47.3578,-122.178,990,10507,12847,11497,2340,60,60
4,2.5,2120,6754,2,0,0,3,7,2120,0,47.3629,-122.184,2120,6937,8874,9057,2120,21,21
3,2.5,1741,5701,2,0,0,3,8,1741,0,47.379,-122.184,2002,5700,7442,7702,1741,7,7
4,2.5,2930,4875,2,0,0,3,9,2930,0,47.3421,-122.179,2815,4900,7805,7715,2930,5,5
4,2.5,3050,32450,1,0,0,4,8,1550,1500,47.3626,-122.209,2350,15390,35500,17740,3050,36,36
4,2.5,2440,7093,2,0,0,3,7,2440,0,47.3817,-122.204,1860,6072,9533,7932,2440,20,20
3,2.5,1800,8518,2,0,0,3,7,1800,0,47.3643,-122.185,1770,7570,10318,9340,1800,23,23
3,2.25,1660,7003,2,0,0,3,7,1660,0,47.3599,-122.188,1840,6680,8663,8520,1660,23,23
4,2.5,2200,7719,2,0,0,3,8,2200,0,47.3649,-122.194,2460,7348,9919,9808,2200,19,19
3,2.5,2340,6837,2,0,0,3,7,2340,0,47.3608,-122.194,1850,6209,9177,8059,2340,27,27
3,2.5,1981,5700,2,0,0,3,8,1981,0,47.3668,-122.178,1981,5894,7681,7875,1981,9,9
4,2.5,2540,12843,2,0,0,3,9,2540,0,47.3866,-122.169,2410,9383,15383,11793,2540,27,27
3,2,2360,6145,1,0,0,3,8,2360,0,47.3564,-122.198,2304,5880,8505,8184,2360,8,8
3,2,1470,12096,1,0,0,4,6,1470,0,47.3734,-122.193,1470,10966,13566,12436,1470,77,77
3,2,1390,13464,1,0,0,4,7,1390,0,47.3581,-122.173,1720,12080,14854,13800,1390,32,32
3,1,1580,8240,1,0,0,4,7,1040,540,47.3542,-122.181,1480,9200,9820,10680,1580,41,41
6,2,2780,13950,2,0,0,4,7,2780,0,47.3738,-122.226,2120,13950,16730,16070,2780,64,51
3,1.75,2090,7461,1,0,0,3,6,1200,890,47.3764,-122.184,1420,7462,9551,8882,2090,33,33
3,1.5,1600,9072,1,0,0,4,7,1600,0,47.3737,-122.216,1710,8000,10672,9710,1600,56,56
4,2.25,1830,6136,2,0,0,3,7,1830,0,47.367,-122.181,1830,7664,7966,9494,1830,29,29
4,2.5,1660,9760,2,0,0,3,7,1660,0,47.3635,-122.188,1580,9614,11420,11194,1660,25,25
3,2.5,1710,10341,2,0,2,3,7,1710,0,47.3494,-122.171,1830,9358,12051,11188,1710,33,33
3,2.5,2410,17424,1,0,0,3,7,1630,780,47.3741,-122.218,1530,11761,19834,13291,2410,41,41
3,2.5,2200,7201,2,0,0,3,8,2200,0,47.3821,-122.207,2250,7240,9401,9490,2200,25,25
5,1.75,2190,16788,1,0,2,3,8,1380,810,47.3764,-122.176,1920,8366,18978,10286,2190,41,41
3,2.5,1610,7223,2,0,0,3,7,1610,0,47.3661,-122.173,1610,7162,8833,8772,1610,25,25
3,1.5,1360,9625,1,0,0,3,7,1360,0,47.3799,-122.211,1890,9625,10985,11515,1360,56,56
4,2.25,1830,7614,2,0,0,3,7,1830,0,47.3682,-122.179,1860,6930,9444,8790,1830,28,28
4,2.5,1785,2552,2,0,0,3,8,1785,0,47.3582,-122.2,1691,2700,4337,4391,1785,10,10
3,2,1678,13862,1,0,0,3,7,1678,0,47.3744,-122.19,1550,11753,15540,13303,1678,25,25
4,2.5,2544,4071,2,0,0,3,9,2544,0,47.341,-122.179,2358,4179,6615,6537,2544,6,6
4,1,1100,7110,1,0,0,4,7,880,220,47.3858,-122.227,1150,7110,8210,8260,1100,112,112
4,2.5,3236,9608,2,0,0,3,10,3236,0,47.3838,-122.195,3236,9660,12844,12896,3236,14,14
5,2.5,3004,5700,2,0,0,3,9,3004,0,47.3801,-122.185,2665,5700,8704,8365,3004,13,13
4,1.5,2120,7110,1,0,0,3,6,2120,0,47.3846,-122.227,1540,7110,9230,8650,2120,100,100
3,2.5,1940,8547,1,0,0,3,7,1460,480,47.3491,-122.177,1750,7803,10487,9553,1940,30,30
4,2.75,1910,7700,1,0,0,4,7,1000,910,47.369,-122.17,1880,7875,9610,9755,1910,39,39
3,2.5,1610,6176,2,0,0,3,7,1610,0,47.3657,-122.173,1680,7414,7786,9094,1610,25,25
3,1.75,2310,11200,1,0,0,4,8,1630,680,47.3637,-122.21,2350,13300,13510,15650,2310,41,41
3,2.25,2730,9388,1,0,0,3,7,1390,1340,47.3785,-122.185,2255,5701,12118,7956,2730,44,44
3,1.75,1420,6984,1,0,0,4,7,980,440,47.3748,-122.18,1430,7875,8404,9305,1420,39,39
4,1.5,1790,10200,1,0,0,4,8,1210,580,47.3774,-122.225,1540,6600,11990,8140,1790,56,56
3,1,1420,8800,1,0,0,4,6,1090,330,47.3746,-122.181,1480,8000,10220,9480,1420,38,38
3,1.5,1350,7827,1,0,0,4,7,1350,0,47.3786,-122.219,1900,7827,9177,9727,1350,51,51
4,2.5,1680,6655,2,0,0,3,7,1680,0,47.3867,-122.191,1680,6982,8335,8662,1680,18,18
4,2.5,2280,7200,2,0,0,3,8,2280,0,47.3829,-122.207,2250,7200,9480,9450,2280,25,25
4,2.5,1982,6406,2,0,0,3,8,1982,0,47.3636,-122.192,2340,6501,8388,8841,1982,15,15
2,1.5,1070,9643,1,0,0,3,7,1070,0,47.3533,-122.166,1220,8386,10713,9606,1070,34,34
3,2.5,1800,8518,2,0,0,3,7,1800,0,47.3643,-122.185,1770,7570,10318,9340,1800,23,23
3,1.75,1420,7205,1,0,0,3,7,1420,0,47.3555,-122.175,1690,7405,8625,9095,1420,33,33
4,3,2710,7199,1,0,0,4,7,1710,1000,47.3789,-122.213,2070,9271,9909,11341,2710,52,52
3,1.5,1690,161913,1,0,0,2,7,1430,260,47.356,-122.189,1930,12548,163603,14478,1690,67,67
3,2,1430,7280,1,0,0,3,7,990,440,47.3742,-122.18,1430,7280,8710,8710,1430,39,39
4,2.75,2170,9658,1,0,0,3,7,2170,0,47.3741,-122.189,1490,9731,11828,11221,2170,53,53
3,1,1200,7200,1,0,0,3,6,1200,0,47.3746,-122.183,1200,7420,8400,8620,1200,42,42
3,1.75,1150,8079,1,0,0,4,7,1150,0,47.3766,-122.18,1540,7399,9229,8939,1150,36,36
4,2.5,2689,6688,2,0,0,3,9,2689,0,47.3803,-122.184,2665,5700,9377,8365,2689,13,13
3,1.5,1070,8886,1,0,0,4,7,1070,0,47.3516,-122.166,1730,9461,9956,11191,1070,35,35
4,2.5,2448,4949,2,0,0,3,9,2448,0,47.3428,-122.179,2815,5446,7397,8261,2448,5,5
5,2.75,2440,6858,2,0,0,3,8,2440,0,47.3655,-122.174,2300,6858,9298,9158,2440,16,16
4,2.5,1930,6228,2,0,0,3,8,1930,0,47.3572,-122.191,1930,6168,8158,8098,1930,19,19
4,2,2220,8229,1,0,0,4,7,2220,0,47.3722,-122.22,1660,8396,10449,10056,2220,61,61
3,2.5,1730,5799,2,0,0,4,7,1730,0,47.3499,-122.177,1710,6490,7529,8200,1730,32,32
3,2,1390,7120,1,0,0,3,7,1390,0,47.3786,-122.179,1530,7688,8510,9218,1390,31,31
4,2.5,2110,6295,2,0,0,3,8,2110,0,47.3641,-122.193,2720,6311,8405,9031,2110,19,19
4,3,2230,52983,2,0,0,3,8,2230,0,47.3577,-122.195,2060,8755,55213,10815,2230,28,28
3,2.5,1590,8449,2,0,0,3,7,1590,0,47.3493,-122.177,1750,7172,10039,8922,1590,30,30
4,2.5,2716,7850,2,0,0,3,9,2716,0,47.352,-122.197,2580,14448,10566,17028,2716,5,5
4,2.5,3250,13360,2,0,0,3,9,3250,0,47.3524,-122.198,2612,14448,16610,17060,3250,5,5
4,2.5,1790,5257,2,0,0,3,7,1790,0,47.3849,-122.204,1680,5320,7047,7000,1790,23,23
3,1.5,1900,9737,1,0,0,4,7,1200,700,47.4125,-122.207,1670,9737,11637,11407,1900,51,51
4,2.5,1980,12062,2,0,0,3,8,1980,0,47.4038,-122.167,2300,7902,14042,10202,1980,27,27
3,1,1610,7140,1,0,0,3,7,1080,530,47.3943,-122.189,1800,7600,8750,9400,1610,43,43
5,1.75,1750,8325,1,0,0,5,7,1750,0,47.4007,-122.198,1430,8325,10075,9755,1750,53,53
4,2.5,2370,7274,2,0,0,3,7,2370,0,47.3982,-122.171,2090,7656,9644,9746,2370,22,22
4,2.5,2210,7079,2,0,0,3,8,2210,0,47.4206,-122.183,1970,7000,9289,8970,2210,26,26
3,2,1140,7078,1,0,0,4,7,1140,0,47.4057,-122.185,1460,7078,8218,8538,1140,28,28
4,2.75,2110,6838,2,0,0,4,8,2110,0,47.3877,-122.171,2100,7280,8948,9380,2110,28,28
5,1,1600,7350,1,0,0,5,7,1600,0,47.3943,-122.196,1600,7725,8950,9325,1600,57,57
4,2.5,3250,4650,2,0,0,3,8,3250,0,47.4004,-122.203,2960,4650,7900,7610,3250,12,12
3,1,1180,9000,1,0,0,4,7,1180,0,47.39,-122.166,1290,8316,10180,9606,1180,49,49
4,1.75,1420,7500,1,0,0,4,7,1080,340,47.4025,-122.176,1500,7260,8920,8760,1420,38,38
4,2.5,1980,5909,2,0,0,3,8,1980,0,47.3913,-122.185,2550,5487,7889,8037,1980,16,16
4,2,2440,9600,1,0,0,5,7,1220,1220,47.4142,-122.179,1370,9600,12040,10970,2440,56,56
4,1.75,1650,7200,1,0,0,3,7,1100,550,47.3944,-122.187,1620,7374,8850,8994,1650,42,42
3,2.5,1680,15711,1,0,0,3,7,1240,440,47.423,-122.171,1420,8588,17391,10008,1680,25,25
3,1.75,2200,7700,1,0,0,3,7,1240,960,47.4119,-122.181,1770,7360,9900,9130,2200,44,44
3,2.5,1640,5707,2,0,0,3,7,1640,0,47.4016,-122.209,1850,5827,7347,7677,1640,24,24
3,1.75,1560,9514,1,0,0,4,7,1560,0,47.4088,-122.21,1550,9600,11074,11150,1560,52,52
3,2.25,1840,6214,1,0,0,4,7,1270,570,47.4043,-122.185,1840,6214,8054,8054,1840,36,36
4,2.5,1790,10584,1,0,0,4,7,1290,500,47.4061,-122.188,1730,9120,12374,10850,1790,38,38
3,2.5,1950,9618,2,0,0,3,7,1950,0,47.4068,-122.18,1890,7133,11568,9023,1950,27,27
3,2.25,2070,7995,1,0,0,3,7,1350,720,47.403,-122.175,1620,6799,10065,8419,2070,32,32
4,2.5,1940,10133,2,0,0,3,8,1940,0,47.3877,-122.171,1940,7265,12073,9205,1940,27,27
4,1.75,1800,28650,1,0,0,4,7,1800,0,47.3926,-122.166,1800,5234,30450,7034,1800,44,44
3,1,1530,8498,1,0,0,3,7,1530,0,47.404,-122.203,1380,8498,10028,9878,1530,60,60
3,1.5,1550,40752,1,0,0,5,7,1550,0,47.394,-122.202,1550,8000,42302,9550,1550,65,65
3,2.25,2140,7200,2,0,0,4,7,2140,0,47.3913,-122.191,1890,7455,9340,9345,2140,40,40
3,1.75,1730,11325,1,0,0,5,7,1730,0,47.3921,-122.182,2030,17859,13055,19889,1730,47,47
4,2.25,2260,7200,2,0,0,4,7,2260,0,47.4121,-122.183,1720,7200,9460,8920,2260,35,35
4,1.75,2600,11325,1,0,0,4,7,1610,990,47.3954,-122.206,1720,11088,13925,12808,2600,50,50
4,2.5,1790,4358,2,0,0,3,7,1790,0,47.3994,-122.204,1790,4305,6148,6095,1790,26,26
4,2.25,1930,7452,1,0,0,3,7,1430,500,47.4098,-122.189,1714,7200,9382,8914,1930,35,35
3,2.25,1350,3582,2,0,0,3,8,1350,0,47.4214,-122.191,1940,3860,4932,5800,1350,9,9
4,1.5,1050,9516,1,0,0,4,7,1050,0,47.4151,-122.181,1390,9600,10566,10990,1050,50,50
4,1.75,1710,7200,1,0,0,5,7,910,800,47.3967,-122.174,1730,7200,8910,8930,1710,44,44
3,2.5,1650,6684,2,0,0,3,7,1650,0,47.4051,-122.184,1850,7048,8334,8898,1650,28,28
3,3.25,2760,6420,2,0,2,3,9,2110,650,47.3895,-122.221,2030,7725,9180,9755,2760,28,28
5,2.5,2750,12350,2,0,0,3,8,2750,0,47.419,-122.206,1650,9810,15100,11460,2750,32,32
3,2,1260,7346,1,0,0,3,7,1260,0,47.4034,-122.176,1460,7363,8606,8823,1260,32,32
3,1.75,1570,7416,1,0,0,4,7,1570,0,47.4117,-122.174,1900,7416,8986,9316,1570,48,48
3,1.75,1280,12776,1,0,0,4,7,1280,0,47.4212,-122.199,1680,11704,14056,13384,1280,42,42
3,1.5,1510,16200,1,0,0,3,7,1510,0,47.3926,-122.167,1650,13950,17710,15600,1510,49,49
4,2.5,3000,9460,2,0,0,3,9,3000,0,47.3959,-122.211,3000,8450,12460,11450,3000,18,18
2,1,700,13500,1,0,0,3,4,700,0,47.3882,-122.208,1600,10124,14200,11724,700,99,99
3,1.75,1370,8280,1,0,0,4,7,1370,0,47.4096,-122.172,1850,7820,9650,9670,1370,39,39
3,2.25,1710,7134,1,0,0,4,7,1130,580,47.3911,-122.191,1790,7455,8844,9245,1710,40,40
3,1.75,1400,6956,1,0,0,4,7,1400,0,47.4233,-122.198,1400,9375,8356,10775,1400,62,62
4,2.5,1700,7280,2,0,0,4,7,1700,0,47.4045,-122.171,1950,7475,8980,9425,1700,31,31
3,2.75,2850,8039,1,0,0,4,8,1540,1310,47.4141,-122.204,2240,7727,10889,9967,2850,30,30
4,2.25,1770,7778,2,0,0,3,7,1770,0,47.4192,-122.201,1770,7591,9548,9361,1770,21,21
3,2,1510,3413,2,0,0,3,7,1510,0,47.3912,-122.167,1570,3777,4923,5347,1510,34,34
3,1.75,1570,7775,2,0,0,3,7,1570,0,47.3876,-122.216,1580,8622,9345,10202,1570,37,37
3,2,1010,7896,1,0,0,3,7,1010,0,47.4046,-122.181,1540,7896,8906,9436,1010,35,35
3,2,1490,8371,1,0,0,3,7,1490,0,47.3962,-122.189,1350,7846,9861,9196,1490,35,35
4,2.5,2170,11511,2,0,0,3,8,2170,0,47.3886,-122.188,1900,8961,13681,10861,2170,27,27
4,2,1710,8288,1,0,0,3,7,1710,0,47.3947,-122.174,1710,7200,9998,8910,1710,49,49
3,2.25,1840,6750,1,0,0,4,7,1270,570,47.4075,-122.172,1750,7004,8590,8754,1840,39,39
4,2.5,1850,7199,2,0,0,4,7,1850,0,47.4031,-122.172,1940,7432,9049,9372,1850,30,30
3,2.5,1920,7779,2,0,0,3,7,1920,0,47.4024,-122.171,1960,7536,9699,9496,1920,30,30
4,2.5,1910,8058,2,0,0,3,8,1910,0,47.3891,-122.172,1910,6500,9968,8410,1910,27,27
4,1.75,1700,40973,1,0,0,3,8,1700,0,47.3439,-122.198,2760,40973,42673,43733,1700,58,58
3,2.25,1840,7326,1,0,0,5,7,1370,470,47.3958,-122.168,2050,7475,9166,9525,1840,40,40
4,2.5,2030,4997,2,0,0,3,8,2030,0,47.393,-122.184,2095,5500,7027,7595,2030,15,15
3,2,1320,7200,1,0,0,5,7,1320,0,47.3947,-122.174,1540,7200,8520,8740,1320,44,44
3,2.75,1900,8200,2,0,0,4,7,1900,0,47.402,-122.183,1620,8200,10100,9820,1900,35,35
3,2,1830,12891,1,0,0,3,7,1830,0,47.3924,-122.192,2320,8709,14721,11029,1830,25,25
3,2.25,1650,2958,2,0,0,3,7,1650,0,47.3916,-122.167,1510,3788,4608,5298,1650,34,34
4,3,2350,9952,1,0,0,3,9,1650,700,47.4194,-122.211,2440,9100,12302,11540,2350,30,30
3,1.5,1390,11340,1,0,0,4,7,1390,0,47.3984,-122.186,1740,11340,12730,13080,1390,56,56
4,2.5,2020,7289,2,0,0,3,7,2020,0,47.401,-122.171,2090,7259,9309,9349,2020,25,25
3,3,2500,8304,2,0,0,3,8,2500,0,47.4022,-122.166,2290,7855,10804,10145,2500,22,22
3,1.5,1700,8247,1,0,0,3,7,1010,690,47.4216,-122.174,1440,8400,9947,9840,1700,49,49
5,2,2260,11970,1,0,0,4,7,1250,1010,47.3896,-122.218,1950,11970,14230,13920,2260,57,57
4,2.5,1810,4871,2,0,0,3,8,1810,0,47.4088,-122.192,1850,5003,6681,6853,1810,20,20
3,2.5,2550,4240,2,0,0,3,7,2550,0,47.3986,-122.169,2550,4240,6790,6790,2550,13,13
3,2.25,1920,9680,1,0,0,4,7,1300,620,47.412,-122.195,1500,9516,11600,11016,1920,58,58
3,1.75,1320,10416,1,0,0,3,7,1320,0,47.3902,-122.208,1670,7991,11736,9661,1320,23,23
5,2.5,2740,12413,2,0,0,3,7,2740,0,47.4199,-122.183,1900,7416,15153,9316,2740,29,29
3,1.75,1470,10390,1,0,0,3,7,1470,0,47.4192,-122.201,1770,7507,11860,9277,1470,30,30
4,2.75,3390,16153,1,0,0,4,7,1970,1420,47.3954,-122.184,2530,8495,19543,11025,3390,58,58
3,2.5,2470,7700,2,0,0,4,8,2470,0,47.4096,-122.17,2400,7700,10170,10100,2470,29,29
4,2.5,2070,7007,2,0,0,3,7,2070,0,47.3968,-122.171,2130,8100,9077,10230,2070,23,23
2,1.75,1460,10506,1,0,0,3,7,1460,0,47.4048,-122.178,1460,8153,11966,9613,1460,36,36
4,2.5,2200,8065,2,0,0,3,7,2200,0,47.4042,-122.213,2641,8535,10265,11176,2200,21,21
3,1.5,1270,11600,1,0,0,4,7,1270,0,47.4075,-122.196,1380,9945,12870,11325,1270,55,55
3,2.5,2110,7434,2,0,0,4,7,2110,0,47.3935,-122.169,2100,7749,9544,9849,2110,41,41
3,2.25,2090,7500,1,0,0,4,7,1280,810,47.3951,-122.172,1800,7350,9590,9150,2090,42,42
3,1,1570,8316,1,0,0,3,7,1070,500,47.3943,-122.198,2030,8295,9886,10325,1570,57,57
3,1.75,1540,8885,1,0,0,4,7,1440,100,47.4031,-122.201,1540,12734,10425,14274,1540,39,39
3,2,1180,7793,1,0,0,4,7,1180,0,47.4053,-122.181,1720,7793,8973,9513,1180,27,27
4,2.5,2090,5195,2,0,0,3,7,2090,0,47.3986,-122.166,2090,5236,7285,7326,2090,12,12
3,2.25,1440,7673,1,0,0,3,7,940,500,47.4034,-122.178,1440,8418,9113,9858,1440,37,37
4,2.5,2440,7797,1,0,0,3,8,1560,880,47.3895,-122.222,2090,8100,10237,10190,2440,54,54
6,4.5,4520,40164,2,0,0,3,9,3580,940,47.407,-122.216,2870,13068,44684,15938,4520,66,7
3,1.5,1280,7742,1,0,0,4,7,1280,0,47.3947,-122.197,1450,8316,9022,9766,1280,57,57
0,0,2460,8049,2,0,0,3,8,2460,0,47.4095,-122.168,2520,8050,10509,10570,2460,29,29
3,1.5,1460,7140,1,0,0,4,7,980,480,47.3954,-122.191,1400,8572,8600,9972,1460,39,39
3,1,980,9682,1,0,0,3,7,980,0,47.4136,-122.207,1580,9682,10662,11262,980,50,50
4,2.5,2740,8336,2,0,0,4,9,2740,0,47.3904,-122.176,2460,9189,11076,11649,2740,29,29
3,2.25,1820,9766,1,0,0,4,7,1450,370,47.397,-122.203,1860,8236,11586,10096,1820,32,32
3,1,1180,6947,1,0,0,4,7,1180,0,47.4233,-122.177,1760,8657,8127,10417,1180,51,51
2,1,740,9003,1,0,0,3,5,740,0,47.4217,-122.197,1230,8050,9743,9280,740,70,70
3,2.5,1730,7200,2,0,0,4,7,1730,0,47.4029,-122.196,1770,7396,8930,9166,1730,34,34
3,2.5,1413,3600,2,0,0,3,8,1413,0,47.4222,-122.193,2150,3869,5013,6019,1413,8,8
4,2.5,2030,5202,2,0,0,3,8,2030,0,47.388,-122.176,2260,5232,7232,7492,2030,18,18
3,1.75,1910,10230,1,0,0,4,7,1290,620,47.4185,-122.207,1590,10800,12140,12390,1910,55,55
3,1.5,1500,15000,1,0,0,3,7,1500,0,47.3926,-122.208,1790,13905,16500,15695,1500,67,67
3,2.25,1650,3788,2,0,0,3,7,1650,0,47.3908,-122.167,1510,3994,5438,5504,1650,34,34
3,2.5,1920,7415,2,0,0,3,7,1920,0,47.4022,-122.171,1930,7536,9335,9466,1920,30,30
4,2.5,1920,7277,2,0,0,4,8,1920,0,47.4058,-122.192,2300,7645,9197,9945,1920,29,29
4,2.5,2340,8548,2,0,0,3,8,2340,0,47.4206,-122.183,1970,6818,10888,8788,2340,26,26
4,2.75,2180,8475,1,0,0,4,7,1330,850,47.4045,-122.174,1500,7140,10655,8640,2180,32,32
4,1.75,2140,159865,1,0,0,4,7,1140,1000,47.4235,-122.218,1830,15569,162005,17399,2140,59,59
4,2,1960,7560,1,0,0,5,7,1160,800,47.4081,-122.178,1950,7560,9520,9510,1960,41,41
5,1.5,1830,94960,1,0,0,3,7,1830,0,47.4218,-122.218,1440,16365,96790,17805,1830,90,90
4,2.5,2360,7475,2,0,0,3,8,2360,0,47.4052,-122.17,2280,7570,9835,9850,2360,27,27
3,2.5,2300,8938,2,0,0,3,9,2300,0,47.4181,-122.211,2570,9694,11238,12264,2300,30,30
4,2.5,1930,9643,2,0,0,4,7,1930,0,47.4065,-122.18,1930,7525,11573,9455,1930,27,27
3,2.25,2310,7200,2,0,0,3,8,2310,0,47.4051,-122.193,1960,7201,9510,9161,2310,29,29
4,1.75,2130,8151,1,0,0,4,7,1330,800,47.3932,-122.201,1600,8587,10281,10187,2130,52,52
3,2,1210,6634,1,0,0,4,7,1210,0,47.4097,-122.193,1560,7200,7844,8760,1210,34,34
3,1.75,1650,16200,1,0,0,3,7,1650,0,47.3926,-122.168,1650,8680,17850,10330,1650,43,43
2,2.5,2110,114127,1,0,0,4,8,1590,520,47.4137,-122.212,1960,11250,116237,13210,2110,44,44
3,2.5,2090,12027,2,0,0,3,8,2090,0,47.4084,-122.213,2090,12666,14117,14756,2090,28,28
6,4.25,5480,189050,2,0,0,4,10,5140,340,47.412,-122.168,2470,10429,194530,12899,5480,28,28
4,2,1620,7992,2,0,0,4,7,1620,0,47.395,-122.176,1710,7500,9612,9210,1620,44,44
4,1.75,1840,7275,1,0,0,3,7,1090,750,47.4002,-122.189,1840,7275,9115,9115,1840,43,43
3,2.5,2030,8000,2,0,0,3,7,2030,0,47.4024,-122.216,2290,7945,10030,10235,2030,22,22
3,2,1210,7136,1,0,0,3,7,1210,0,47.3996,-122.203,1210,5765,8346,6975,1210,16,16
3,2,1110,7231,1,0,0,4,7,1110,0,47.4036,-122.191,1550,7245,8341,8795,1110,28,28
4,1,1540,115434,1,0,0,4,7,1540,0,47.4163,-122.22,2027,23522,116974,25549,1540,96,96
4,2.5,3200,22651,1,0,0,5,8,1610,1590,47.3931,-122.183,2030,5500,25851,7530,3200,49,49
3,1.75,1420,8126,1,0,0,3,8,1420,0,47.3871,-122.189,1730,7954,9546,9684,1420,28,28
5,2.5,2740,5400,2,0,0,3,8,2740,0,47.4036,-122.205,2900,5476,8140,8376,2740,14,14
3,1.5,1360,9980,1,0,0,4,7,1360,0,47.4143,-122.206,1360,9750,11340,11110,1360,53,53
4,2.75,2520,6964,1,0,0,4,7,1260,1260,47.4038,-122.175,1930,6949,9484,8879,2520,32,32
4,1,1940,9533,1,0,0,3,7,1080,860,47.4139,-122.208,1940,8839,11473,10779,1940,57,57
3,2,1610,8416,1,0,0,3,7,1610,0,47.397,-122.187,1600,8308,10026,9908,1610,25,25
3,2.5,2160,15817,2,0,0,3,8,2160,0,47.4166,-122.183,1990,15817,17977,17807,2160,20,20
4,2.5,2130,9653,1,0,0,3,7,1500,630,47.4068,-122.175,2000,7988,11783,9988,2130,41,41
4,2.5,1930,8336,2,0,0,3,8,1930,0,47.4016,-122.166,2280,7959,10266,10239,1930,24,24
4,2,1710,7455,1,0,0,3,7,1030,680,47.3965,-122.173,1710,7350,9165,9060,1710,44,44
3,1.75,1410,9315,1,0,0,5,7,1410,0,47.3969,-122.198,1630,8250,10725,9880,1410,59,59
4,1.75,1400,54014,1,0,0,4,7,1400,0,47.4153,-122.184,1910,8523,55414,10433,1400,84,84
4,2.25,1800,4500,2,0,0,4,8,1800,0,47.394,-122.183,2010,5050,6300,7060,1800,15,15
4,1.5,1760,6150,1,0,0,3,7,1760,0,47.3871,-122.224,1760,8276,7910,10036,1760,68,68
3,2.25,1740,10836,1,0,0,3,7,910,830,47.3976,-122.166,2090,7500,12576,9590,1740,38,38
3,1,1790,11884,1,0,0,3,7,1790,0,47.3887,-122.22,1660,11513,13674,13173,1790,68,68
3,1.5,1500,11616,1,0,0,3,7,1100,400,47.4062,-122.174,1830,8288,13116,10118,1500,39,39
4,2.5,2040,7000,1,0,0,3,7,1250,790,47.4056,-122.176,1900,7378,9040,9278,2040,40,40
4,2.5,1860,6687,1,0,0,4,7,1220,640,47.4046,-122.186,1860,6117,8547,7977,1860,36,36
4,1,1730,36356,1,0,0,4,6,1730,0,47.4135,-122.199,1380,14060,38086,15440,1730,65,65
4,1.75,1630,8000,1,0,0,3,7,1630,0,47.3948,-122.201,1630,7700,9630,9330,1630,60,60
4,1.75,2090,7416,1,0,0,4,7,1050,1040,47.4107,-122.179,1710,7527,9506,9237,2090,49,49
2,1,970,8185,1,0,0,5,6,970,0,47.4025,-122.201,1500,12541,9155,14041,970,115,115
4,2.25,2130,9600,1,0,0,4,7,2130,0,47.4119,-122.211,1710,9600,11730,11310,2130,53,53
5,2.25,1820,10500,1,0,0,4,7,1080,740,47.4058,-122.177,1820,7500,12320,9320,1820,40,40
4,2.5,2520,9604,2,0,0,3,9,2520,0,47.3893,-122.216,2540,9793,12124,12333,2520,29,29
4,2.75,1950,9720,1,0,0,3,7,1400,550,47.3969,-122.205,2300,10530,11670,12830,1950,33,33
3,2.5,1440,7741,1,0,0,4,7,1000,440,47.4042,-122.194,1680,7316,9181,8996,1440,36,36
3,1,1050,8498,1,0,0,4,7,1050,0,47.4043,-122.202,1050,8498,9548,9548,1050,60,60
4,2.75,2500,26400,1,0,0,3,8,1780,720,47.3444,-122.084,2180,31900,28900,34080,2500,42,42
4,2.5,2040,6300,2,0,0,3,8,2040,0,47.3918,-122.185,2260,5877,8340,8137,2040,16,16
4,2,2130,8400,1,0,0,3,7,1350,780,47.4133,-122.209,1550,8596,10530,10146,2130,57,57
4,2.5,2810,6146,2,0,0,3,9,2810,0,47.4045,-122.208,2810,6180,8956,8990,2810,21,21
3,1.5,1010,10350,1,0,0,3,7,1010,0,47.379,-122.29,1640,7700,11360,9340,1010,50,50
3,1,1160,8320,1,0,0,4,7,1160,0,47.3831,-122.288,1480,7800,9480,9280,1160,60,60
4,1.75,1710,7140,1,0,0,5,7,1010,700,47.3745,-122.275,1770,8960,8850,10730,1710,51,51
4,2,2600,9000,1,0,0,3,8,1410,1190,47.381,-122.299,2600,7200,11600,9800,2600,60,60
3,1,1030,9120,1,0,0,3,7,1030,0,47.3607,-122.291,1470,10220,10150,11690,1030,58,58
3,1,940,11055,1,0,0,4,7,940,0,47.3732,-122.295,1420,9100,11995,10520,940,60,60
4,2,1540,7575,1,0,0,4,7,1040,500,47.3664,-122.279,1720,7575,9115,9295,1540,41,41
5,1.5,1820,8712,1,0,0,5,7,1090,730,47.3712,-122.289,1820,8712,10532,10532,1820,59,59
3,1.5,1952,8613,1,0,0,4,7,1652,300,47.3715,-122.29,1400,8712,10565,10112,1952,59,59
5,2.75,2980,8500,1,0,0,3,8,1540,1440,47.3641,-122.278,2310,8500,11480,10810,2980,37,37
4,2,1850,7560,1,0,0,4,7,1540,310,47.3666,-122.277,1620,7658,9410,9278,1850,41,41
3,2.5,2740,83199,2,0,4,3,9,2740,0,47.3581,-122.266,2500,29269,85939,31769,2740,46,46
3,1,1350,7560,1,0,0,4,7,950,400,47.3784,-122.303,1470,7560,8910,9030,1350,60,60
3,1.75,1630,9450,1,0,0,4,7,1080,550,47.3729,-122.295,1280,9100,11080,10380,1630,42,42
2,1,840,7200,1,0,0,4,5,840,0,47.3769,-122.237,1030,7200,8040,8230,840,112,112
3,1.75,1970,10270,1,0,0,4,8,1970,0,47.3619,-122.285,1970,8400,12240,10370,1970,53,53
3,1,1150,8050,1,0,0,4,7,1150,0,47.374,-122.296,1360,8050,9200,9410,1150,63,63
3,1,1240,9198,1,0,0,4,7,1240,0,47.37,-122.297,1170,8970,10438,10140,1240,60,60
3,2.75,3080,19635,1,0,2,4,7,1610,1470,47.3841,-122.284,2424,12410,22715,14834,3080,61,61
5,3.25,3800,15500,1,0,0,3,7,2490,1310,47.3862,-122.28,2000,13980,19300,15980,3800,54,54
3,1,830,9600,1,0,0,3,7,830,0,47.3698,-122.297,1240,9198,10430,10438,830,60,60
3,2,1810,7209,1,0,0,4,7,1240,570,47.3656,-122.278,1750,7209,9019,8959,1810,41,41
5,2.75,3030,7000,1,0,0,4,7,1540,1490,47.3661,-122.28,1790,7330,10030,9120,3030,41,41
2,1,910,9753,1,0,0,3,5,910,0,47.3897,-122.236,1160,7405,10663,8565,910,72,72
4,1.75,1820,13600,1,0,0,3,7,1120,700,47.3743,-122.295,1810,11970,15420,13780,1820,60,60
4,2.5,2229,5723,2,0,0,3,7,2229,0,47.3693,-122.286,2738,5742,7952,8480,2229,7,7
3,2.75,2170,7900,1,0,0,4,8,1380,790,47.362,-122.277,2170,7700,10070,9870,2170,41,41
4,2.5,2190,7125,2,0,0,5,8,2190,0,47.3709,-122.285,2190,8075,9315,10265,2190,41,41
3,2.25,1610,11920,1,0,0,4,7,1110,500,47.3683,-122.279,1690,11839,13530,13529,1610,51,51
3,1.75,2200,7200,1,0,0,3,8,1270,930,47.3745,-122.276,1800,8000,9400,9800,2200,57,57
4,2.25,2240,9600,2,0,0,3,8,2240,0,47.361,-122.281,2050,9240,11840,11290,2240,48,48
3,1.75,1480,8009,1,0,0,3,7,980,500,47.3657,-122.28,1790,7678,9489,9468,1480,39,39
3,1,1060,7350,1,0,0,4,7,1060,0,47.3809,-122.287,1060,7350,8410,8410,1060,60,60
3,1,1470,7350,1,0,0,3,7,1470,0,47.3616,-122.286,1720,8050,8820,9770,1470,50,50
5,1.5,1710,8100,1,0,0,4,7,1710,0,47.3839,-122.288,1480,8025,9810,9505,1710,58,58
4,2.25,2070,7350,2,0,0,4,8,2070,0,47.3615,-122.274,2080,7210,9420,9290,2070,42,42
2,1,960,21850,1,0,0,3,6,960,0,47.4122,-122.267,1020,21850,22810,22870,960,72,72
4,2.25,2670,10050,1,0,0,4,8,1420,1250,47.3792,-122.28,2190,10050,12720,12240,2670,57,57
4,1,1410,7000,1,0,0,3,7,1410,0,47.3767,-122.287,1540,7000,8410,8540,1410,56,56
3,1.75,1290,4811,1,0,0,3,7,1290,0,47.3912,-122.234,1310,4811,6101,6121,1290,23,23
4,2.25,2210,11700,2,0,0,4,8,2210,0,47.3648,-122.284,2040,9000,13910,11040,2210,52,52
4,1.75,2320,12000,1,0,0,4,8,2270,50,47.3644,-122.28,2120,9880,14320,12000,2320,46,46
3,2.25,1640,8400,1,0,0,3,8,1180,460,47.3733,-122.289,1600,8120,10040,9720,1640,51,51
4,1,1390,18000,1,0,0,3,7,1390,0,47.3885,-122.284,1390,18000,19390,19390,1390,64,1
3,1.5,1180,7384,1,0,0,5,7,1180,0,47.3838,-122.287,1150,7455,8564,8605,1180,60,60
3,2.25,1920,7840,2,0,0,4,8,1920,0,47.3631,-122.276,2170,7210,9760,9380,1920,37,37
4,2.25,1860,9576,1,0,0,3,7,1400,460,47.3612,-122.284,1860,9576,11436,11436,1860,57,57
4,2.25,2190,9020,2,0,0,3,8,2190,0,47.3742,-122.284,2170,8400,11210,10570,2190,41,41
3,1,1200,7280,1,0,0,4,7,1200,0,47.3724,-122.277,1200,8400,8480,9600,1200,52,52
4,2.25,2250,12000,2,0,0,3,8,2250,0,47.3715,-122.274,2140,11871,14250,14011,2250,34,34
3,1,1520,7800,1,0,0,4,7,1120,400,47.3784,-122.29,1740,8000,9320,9740,1520,52,52
3,1,1130,10018,1,0,0,4,6,1130,0,47.3733,-122.275,1770,7700,11148,9470,1130,65,65
4,2.75,2440,7150,1,0,0,3,7,1200,1240,47.3662,-122.282,1790,7150,9590,8940,2440,56,29
2,1,1040,13100,1,0,0,5,6,1040,0,47.3877,-122.234,910,5080,14140,5990,1040,107,107
3,1.5,2000,15265,1,0,0,3,8,1540,460,47.387,-122.281,1920,15265,17265,17185,2000,52,52
2,1,1010,5408,1,0,0,4,6,1010,0,47.3759,-122.238,980,7800,6418,8780,1010,93,93
3,1.75,1810,34500,1,0,0,3,8,1230,580,47.3707,-122.275,2090,9735,36310,11825,1810,39,39
4,2.25,1900,10950,1,0,0,4,7,1400,500,47.3582,-122.284,1700,11850,12850,13550,1900,60,60
3,2.5,1420,14850,1,0,0,4,7,1020,400,47.3661,-122.29,2060,8800,16270,10860,1420,56,56
3,2.5,1850,17808,1,0,0,4,8,1210,640,47.3631,-122.271,2260,16754,19658,19014,1850,37,37
4,1.5,1730,7464,2,0,0,4,7,1730,0,47.3782,-122.304,1370,7860,9194,9230,1730,60,60
3,1,1750,8820,1,0,0,4,7,1750,0,47.3608,-122.29,1400,9600,10570,11000,1750,58,58
2,1,860,5080,1,0,0,3,7,860,0,47.39,-122.236,1250,6477,5940,7727,860,59,59
2,1,830,9000,1,0,0,3,6,830,0,47.3813,-122.243,1160,7680,9830,8840,830,80,80
3,1,970,7700,1,0,0,4,7,970,0,47.3793,-122.304,1160,8250,8670,9410,970,60,60
3,1,1020,7538,1,0,0,3,7,1020,0,47.3587,-122.288,1650,7201,8558,8851,1020,38,38
4,1.5,2130,8800,1,0,0,3,7,1100,1030,47.383,-122.288,1480,8120,10930,9600,2130,57,57
4,2.25,1980,7081,1,0,0,3,7,1470,510,47.3669,-122.288,1980,7081,9061,9061,1980,42,42
4,1.5,1780,14810,1,0,0,4,8,1180,600,47.3581,-122.288,1450,6728,16590,8178,1780,69,69
5,1.5,1690,7725,1,0,0,4,7,1690,0,47.3859,-122.288,1690,7739,9415,9429,1690,58,58
2,1,800,8125,1,0,0,3,6,800,0,47.6836,-122.174,2390,8125,8925,10515,800,55,55
5,4.5,4590,14685,2,0,0,3,10,4590,0,47.664,-122.2,3030,9486,19275,12516,4590,10,10
4,4.25,4700,10800,2,0,1,3,11,3910,790,47.6882,-122.214,2370,7680,15500,10050,4700,17,17
3,2,1010,5973,1,0,0,5,6,1010,0,47.6652,-122.202,1920,6015,6983,7935,1010,77,77
4,4.25,4590,17621,2,0,0,3,10,3160,1430,47.6973,-122.205,3800,12268,22211,16068,4590,16,16
3,2.5,2605,2216,2,0,2,4,9,2090,515,47.6529,-122.202,2605,1979,4821,4584,2605,40,40
4,2.25,2050,7201,2,0,0,3,8,2050,0,47.7003,-122.165,1970,7350,9251,9320,2050,25,25
4,2.75,2840,8800,2,0,0,3,9,2840,0,47.7029,-122.171,1840,7700,11640,9540,2840,11,11
5,5.25,8010,45517,2,1,4,3,12,5990,2020,47.6767,-122.211,3430,26788,53527,30218,8010,20,20
4,2,2040,8281,2,0,1,3,7,2040,0,47.6689,-122.195,2560,8281,10321,10841,2040,58,58
3,2.75,2890,12130,2,0,3,4,10,2830,60,47.6505,-122.203,2415,11538,15020,13953,2890,32,32
3,2.5,1860,10027,2,0,0,3,8,1860,0,47.6775,-122.165,1530,9204,11887,10734,1860,26,26
4,2.5,2780,6837,2,0,0,3,9,2780,0,47.666,-122.201,1160,6837,9617,7997,2780,15,15
5,2.75,3550,9600,2,0,0,3,7,3550,0,47.6766,-122.186,3370,9600,13150,12970,3550,59,59
3,2,2920,13650,1,0,2,5,8,1460,1460,47.6652,-122.188,2920,10988,16570,13908,2920,44,44
4,2.5,3230,4290,2,0,0,3,9,3230,0,47.6874,-122.161,3220,5083,7520,8303,3230,15,15
5,2.5,3000,7912,1,0,0,3,9,1610,1390,47.6765,-122.175,2700,7205,10912,9905,3000,12,12
5,1,1700,11727,1,0,0,4,7,1700,0,47.686,-122.172,1740,8212,13427,9952,1700,65,65
4,2,2400,12753,1,0,0,4,7,2400,0,47.6947,-122.177,1830,12060,15153,13890,2400,57,57
5,3.25,3540,5971,1,0,2,3,10,2000,1540,47.6643,-122.202,2820,6029,9511,8849,3540,14,14
3,2.25,1580,8506,2,0,0,3,7,1580,0,47.686,-122.185,2253,8515,10086,10768,1580,32,32
3,2.5,2340,1919,2,0,2,4,9,2340,0,47.6512,-122.203,2415,2166,4259,4581,2340,38,38
3,2.5,1900,7604,2,0,0,3,8,1900,0,47.7002,-122.188,1980,9583,9504,11563,1900,29,29
4,2.5,2650,11520,2,0,0,3,8,2110,540,47.683,-122.187,2000,7680,14170,9680,2650,31,31
4,2.75,3820,8850,2,0,0,3,10,3820,0,47.6506,-122.195,2330,12000,12670,14330,3820,5,5
4,2.5,3170,8523,2,0,0,3,9,3170,0,47.6854,-122.184,3230,8523,11693,11753,3170,11,11
3,2.75,2770,10000,1,0,1,5,8,1640,1130,47.7011,-122.206,2450,10000,12770,12450,2770,57,57
3,1.75,1840,7350,1,0,0,3,8,1370,470,47.6729,-122.166,1920,8518,9190,10438,1840,45,45
4,2.75,2410,9549,1,0,0,4,7,1780,630,47.6503,-122.197,2090,9549,11959,11639,2410,63,63
2,2,1460,9052,1,0,2,5,6,1460,0,47.6857,-122.208,2554,7834,10512,10388,1460,119,119
4,2.5,2500,6005,2,0,0,3,9,2500,0,47.6922,-122.174,2680,7200,8505,9880,2500,18,18
4,1.5,1320,14250,1,0,0,4,7,1320,0,47.7016,-122.199,1720,14250,15570,15970,1320,65,65
3,1.5,1690,10500,1,0,0,4,7,1690,0,47.7018,-122.165,1570,10500,12190,12070,1690,52,52
4,2,1830,9610,1,0,0,3,7,1830,0,47.695,-122.176,1970,10754,11440,12724,1830,56,56
3,2.5,3430,28718,1,0,0,3,10,3430,0,47.6477,-122.183,3440,35021,32148,38461,3430,35,35
3,2,1770,7200,1,0,0,4,7,1770,0,47.6642,-122.173,2250,11250,8970,13500,1770,52,52
4,2,2510,13695,1,0,0,4,7,1280,1230,47.7005,-122.174,1220,12500,16205,13720,2510,58,13
4,2.75,3270,12880,2,0,0,3,9,3270,0,47.6679,-122.172,2420,7505,16150,9925,3270,5,5
4,2.75,2550,8632,1,0,0,3,8,1700,850,47.6477,-122.197,2550,9534,11182,12084,2550,47,47
3,1.75,1660,9549,1,0,0,3,7,1660,0,47.6503,-122.198,2090,9549,11209,11639,1660,63,63
5,2.5,3580,8921,2,0,0,3,9,3580,0,47.693,-122.202,2710,9308,12501,12018,3580,19,19
4,2.5,3360,11548,2,0,0,3,9,3360,0,47.6534,-122.182,3400,14091,14908,17491,3360,31,31
4,3.5,3770,8501,2,0,0,3,10,3770,0,47.6744,-122.196,1520,9660,12271,11180,3770,11,11
3,2.5,1900,3366,2,0,0,3,9,1900,0,47.6679,-122.184,2500,3954,5266,6454,1900,23,23
4,2.5,2860,9159,1,0,0,4,8,1530,1330,47.6923,-122.2,2070,8680,12019,10750,2860,30,30
3,2,1840,6000,2,0,0,5,7,1720,120,47.6828,-122.207,1390,6000,7840,7390,1840,73,73
4,2.75,2530,11549,1,0,0,3,7,1700,830,47.6557,-122.197,2530,10000,14079,12530,2530,77,77
4,2.5,2910,9131,2,0,0,3,10,2910,0,47.6826,-122.186,1880,11212,12041,13092,2910,5,5
3,2.5,2400,7745,2,0,0,3,9,2400,0,47.6734,-122.173,2080,8615,10145,10695,2400,18,18
4,3.75,4475,20424,2,1,4,3,12,2659,1816,47.6646,-122.208,4340,5250,24899,9590,4475,20,20
3,1.75,1390,11700,1,0,0,4,7,1390,0,47.7002,-122.192,1060,8686,13090,9746,1390,53,53
2,1,1140,23779,1,0,0,3,6,1140,0,47.6948,-122.172,2940,8417,24919,11357,1140,53,53
4,3.75,3280,11000,2,0,0,3,10,2320,960,47.6855,-122.201,2400,8351,14280,10751,3280,11,11
3,1.5,1680,17409,1,0,0,3,7,1680,0,47.6766,-122.176,1680,9101,19089,10781,1680,57,57
4,3.75,3180,9889,2,0,0,3,9,2500,680,47.6853,-122.204,2910,8558,13069,11468,3180,7,7
4,2.5,2850,12429,2,0,0,3,9,2850,0,47.6915,-122.177,2540,12000,15279,14540,2850,11,11
4,2.5,3030,7187,2,0,0,3,9,3030,0,47.6934,-122.166,3030,7187,10217,10217,3030,14,14
4,2.5,2190,6300,1,0,3,3,7,1240,950,47.6918,-122.216,2730,14659,8490,17389,2190,59,59
4,2.25,2040,7031,2,0,0,3,8,2040,0,47.7016,-122.17,1670,7031,9071,8701,2040,7,7
5,1.5,1750,12491,1,0,0,3,6,1390,360,47.6995,-122.174,1560,12473,14241,14033,1750,58,58
3,2.5,2190,7982,2,0,0,3,8,2190,0,47.6869,-122.187,2090,8888,10172,10978,2190,15,15
4,3.5,3500,9523,2,0,0,3,10,2460,1040,47.6848,-122.208,3160,5997,13023,9157,3500,23,23
3,1.75,1630,15600,1,0,0,3,7,1630,0,47.68,-122.165,1830,10850,17230,12680,1630,61,61
2,2.5,1470,2533,2,0,0,3,8,1470,0,47.6874,-122.165,1470,6511,4003,7981,1470,14,14
4,1.75,3140,12519,1,0,0,3,7,2320,820,47.6941,-122.173,2240,7308,15659,9548,3140,68,31
4,3.75,4030,10800,2,0,0,3,10,4030,0,47.6821,-122.196,2160,7200,14830,9360,4030,13,13
4,2.5,3220,4031,2,0,0,3,9,3220,0,47.688,-122.163,3150,5083,7251,8233,3220,17,17
4,2.25,2370,9636,1,0,0,3,8,1660,710,47.6497,-122.194,2350,9588,12006,11938,2370,43,43
3,1.75,1680,10685,1,0,0,4,7,1680,0,47.6556,-122.193,3340,10390,12365,13730,1680,53,53
3,1,1300,11520,1,0,0,3,6,1300,0,47.6829,-122.195,1440,8064,12820,9504,1300,61,61
5,3.75,4360,8504,2,0,4,3,10,3530,830,47.6936,-122.19,2680,9000,12864,11680,4360,5,5
3,2.5,2070,7200,2,0,0,3,8,2070,0,47.6946,-122.211,1650,8877,9270,10527,2070,18,18
4,2.25,2070,7200,1,0,0,5,8,1390,680,47.697,-122.169,2110,8400,9270,10510,2070,42,42
3,1.75,2180,14135,1,0,2,5,8,1300,880,47.673,-122.187,3540,10318,16315,13858,2180,72,72
3,1,1410,4840,1,0,2,4,6,1230,180,47.6646,-122.204,1410,5400,6250,6810,1410,77,77
3,2.5,1850,7777,2,0,0,5,8,1850,0,47.6908,-122.169,1850,8482,9627,10332,1850,30,30
4,3.25,4240,11189,2,0,2,3,10,4240,0,47.6526,-122.191,3390,12540,15429,15930,4240,13,13
3,2.25,1700,12615,1,0,0,4,7,1300,400,47.6965,-122.197,1950,13163,14315,15113,1700,29,29
4,2.5,2620,9157,2,0,0,3,8,2620,0,47.6916,-122.203,2240,7405,11777,9645,2620,23,23
3,1.5,2020,11358,1,0,0,4,6,1190,830,47.6641,-122.185,2370,9520,13378,11890,2020,63,63
4,2.5,3780,10962,2,0,0,3,10,3780,0,47.6533,-122.183,3310,11651,14742,14961,3780,29,29
2,1,960,6263,1,0,1,4,6,960,0,47.6646,-122.202,1460,6054,7223,7514,960,77,77
4,3.25,3330,9000,2,0,0,3,9,2870,460,47.6836,-122.208,2550,6349,12330,8899,3330,15,15
3,1.75,980,6002,1,0,0,4,6,980,0,47.6643,-122.203,1150,6054,6982,7204,980,77,77
3,1,860,9403,1,0,0,4,6,860,0,47.6815,-122.173,2136,13009,10263,15145,860,77,24
4,2.25,2360,8616,2,0,0,4,8,2360,0,47.6495,-122.198,2360,9337,10976,11697,2360,45,45
4,2.5,3220,5262,2,0,0,3,9,3220,0,47.6878,-122.162,3220,4921,8482,8141,3220,16,16
4,2,2130,5500,1,0,0,5,7,2130,0,47.6807,-122.199,1490,6000,7630,7490,2130,80,80
4,2,2190,8402,2,0,0,4,6,2190,0,47.6944,-122.175,2210,7802,10592,10012,2190,91,91
3,1.5,1220,3286,2,0,0,3,7,1220,0,47.7168,-122.189,1220,2640,4506,3860,1220,37,37
5,3.25,3370,7947,2,0,0,3,10,3370,0,47.6906,-122.202,2040,7900,11317,9940,3370,18,18
3,1.5,1840,10956,1,0,0,4,8,1840,0,47.6746,-122.164,1680,10950,12796,12630,1840,49,49
2,0.75,1260,4800,1,0,2,4,6,1080,180,47.6843,-122.212,2660,7200,6060,9860,1260,77,77
4,3.5,4610,12500,2,0,2,3,11,4610,0,47.6508,-122.203,2340,11538,17110,13878,4610,16,16
3,2.5,1750,4797,2,0,0,4,7,1750,0,47.6954,-122.199,1750,4293,6547,6043,1750,28,28
4,3.25,3470,5222,2,0,0,3,10,2830,640,47.6845,-122.209,3090,6758,8692,9848,3470,14,14
4,2.75,2040,8996,1,0,0,4,8,1260,780,47.666,-122.185,2470,9180,11036,11650,2040,45,45
3,2.75,2980,12600,1,0,0,3,8,1590,1390,47.674,-122.196,1520,9660,15580,11180,2980,78,2
3,1.5,980,7770,1,0,0,4,7,980,0,47.6923,-122.201,1470,7350,8750,8820,980,51,51
3,2.5,1550,12920,2,0,0,5,7,1550,0,47.6973,-122.194,2610,10800,14470,13410,1550,20,20
3,2.25,2400,12350,1,0,0,4,8,1420,980,47.6533,-122.192,2615,12043,14750,14658,2400,51,51
6,4.25,5550,11547,2,0,2,3,11,4270,1280,47.6547,-122.202,3480,11547,17097,15027,5550,5,5
3,2.25,1570,9500,1,0,0,4,7,1070,500,47.6843,-122.185,2250,9583,11070,11833,1570,42,42
3,3,3110,9015,1,0,4,4,10,1590,1520,47.6624,-122.202,3150,11447,12125,14597,3110,39,39
3,2,1710,10959,1,0,0,4,7,1030,680,47.697,-122.199,1710,10498,12669,12208,1710,38,38
3,1,1130,9147,1,0,0,5,7,1130,0,47.7006,-122.197,1930,9906,10277,11836,1130,67,67
4,2.25,2200,11250,1,0,0,5,7,1300,900,47.6845,-122.201,2320,10814,13450,13134,2200,99,99
3,2.25,2520,7975,2,0,0,4,9,1550,970,47.6704,-122.183,2520,9900,10495,12420,2520,29,29
5,2,2420,21000,1,0,0,3,8,2420,0,47.677,-122.165,1940,8085,23420,10025,2420,53,53
4,1.75,1440,8536,1,0,0,4,7,1440,0,47.6775,-122.18,1720,9748,9976,11468,1440,58,58
4,2.25,1990,8548,2,0,0,3,8,1990,0,47.667,-122.178,2320,8926,10538,11246,1990,46,46
3,1,1240,7300,1,0,0,3,7,1240,0,47.6775,-122.168,1240,8260,8540,9500,1240,51,51
3,1.75,1650,10150,1,0,0,3,8,1230,420,47.6963,-122.169,1930,8958,11800,10888,1650,43,43
4,3.5,4730,47870,1,1,4,3,10,2940,1790,47.6967,-122.216,3250,49346,52600,52596,4730,65,65
7,4,2690,10880,1,0,0,4,8,2690,0,47.6787,-122.168,1840,10836,13570,12676,2690,59,59
3,2.75,2290,5002,2,0,0,4,9,1950,340,47.6811,-122.207,2290,5100,7292,7390,2290,24,24
3,2.5,4110,35741,2,0,0,3,7,4110,0,47.6642,-122.171,2710,8865,39851,11575,4110,43,43
3,2,1080,11856,1,0,0,5,7,1080,0,47.6955,-122.175,1220,9247,12936,10467,1080,33,33
3,1.75,1220,7447,1,0,0,4,7,1220,0,47.6886,-122.211,1340,7200,8667,8540,1220,55,55
2,1,1220,17172,1,0,0,4,6,1220,0,47.6934,-122.163,1510,12915,18392,14425,1220,72,72
4,1.75,2260,7005,1,0,1,4,7,1130,1130,47.6895,-122.207,2330,9180,9265,11510,2260,72,72
1,2.25,1220,2100,2,0,2,4,8,1220,0,47.6703,-122.204,3150,6000,3320,9150,1220,73,35
4,1.75,1900,8800,1,0,0,3,8,1140,760,47.6579,-122.197,2280,8800,10700,11080,1900,44,44
3,2.75,2610,11290,1,0,0,3,7,1630,980,47.6632,-122.201,2570,9125,13900,11695,2610,34,34
3,1.75,3600,8666,2,0,0,4,6,2400,1200,47.6893,-122.167,2290,8200,12266,10490,3600,71,71
3,2.5,2190,2658,2,0,3,4,9,2190,0,47.6528,-122.203,2315,2538,4848,4853,2190,40,40
4,2.75,2910,10650,1,0,2,3,8,1780,1130,47.6658,-122.188,2920,10988,13560,13908,2910,44,44
3,1.75,1150,6600,1,0,0,4,6,1150,0,47.6709,-122.185,1530,6600,7750,8130,1150,49,49
3,2.5,2600,10183,1,0,0,3,8,1300,1300,47.6984,-122.201,1860,10401,12783,12261,2600,15,15
3,1.75,1560,9247,1,0,0,3,7,1160,400,47.6954,-122.174,1690,8772,10807,10462,1560,30,30
3,1.75,1710,7350,1,0,0,3,8,1280,430,47.699,-122.167,2100,7560,9060,9660,1710,38,38
4,1,2170,12100,1,0,0,5,7,2170,0,47.6893,-122.164,1270,12844,14270,14114,2170,58,58
3,1,1270,6500,1,0,0,4,7,1270,0,47.6874,-122.214,2260,7200,7770,9460,1270,63,63
4,2.5,2740,7571,2,0,0,3,9,2740,0,47.6962,-122.179,2880,7203,10311,10083,2740,10,10
4,2.75,3020,7203,2,0,0,3,9,3020,0,47.6948,-122.178,3010,7215,10223,10225,3020,5,5
5,2.25,2100,6936,1,0,0,3,8,1600,500,47.6737,-122.169,2100,8661,9036,10761,2100,45,45
3,1,1490,10650,1,0,0,3,7,1150,340,47.663,-122.178,1730,9800,12140,11530,1490,56,56
3,2.5,1630,1755,2,0,0,3,8,1320,310,47.691,-122.176,1920,14550,3385,16470,1630,22,22
4,2.25,2190,9009,2,0,0,4,8,1840,350,47.6916,-122.188,2190,10251,11199,12441,2190,42,42
4,1.75,1870,9500,1,0,0,4,7,1090,780,47.7012,-122.187,2010,10000,11370,12010,1870,57,57
3,2.5,3170,7187,2,0,0,3,9,3170,0,47.6934,-122.166,2790,7336,10357,10126,3170,14,14
4,2.75,3870,10046,2,0,0,3,11,3870,0,47.6651,-122.191,3560,10046,13916,13606,3870,14,14
3,2.25,2430,5500,2,0,0,3,8,1810,620,47.6812,-122.196,2040,5500,7930,7540,2430,30,30
2,1,1150,6000,1,0,1,4,7,710,440,47.6841,-122.213,2450,7200,7150,9650,1150,98,98
3,1.5,1110,5500,1,0,0,3,6,1110,0,47.6717,-122.184,1670,6600,6610,8270,1110,79,17
5,3.5,3450,28324,1,0,0,5,8,2350,1100,47.6991,-122.196,2640,14978,31774,17618,3450,47,47
3,2.5,2750,16000,2,0,0,4,9,2560,190,47.693,-122.187,2370,11279,18750,13649,2750,38,38
3,1.75,1290,8580,1,0,0,4,7,1290,0,47.6707,-122.174,1840,8580,9870,10420,1290,57,57
4,2.5,2620,16200,1,0,2,4,7,1570,1050,47.6623,-122.196,3050,11875,18820,14925,2620,69,21
4,2.5,1900,9775,1,0,0,5,7,1900,0,47.6856,-122.168,1990,10500,11675,12490,1900,52,52
3,1.75,1330,8136,1,0,0,4,7,1330,0,47.7001,-122.173,1330,8136,9466,9466,1330,42,42
3,1,2110,10005,1,0,0,5,7,1110,1000,47.688,-122.168,1360,9827,12115,11187,2110,95,95
3,2.25,1990,6256,1,0,0,3,7,1390,600,47.6903,-122.206,2080,9300,8246,11380,1990,59,59
4,3.75,4260,9800,2,0,0,3,10,4260,0,47.6739,-122.172,1950,8970,14060,10920,4260,11,11
5,4.5,4270,8076,2,0,0,3,11,3400,870,47.699,-122.206,4100,10631,12346,14731,4270,12,12
4,2.25,2070,8720,1,0,0,5,8,1360,710,47.6678,-122.182,2180,8510,10790,10690,2070,45,45
5,1.5,1550,9750,1,0,0,4,7,1550,0,47.6811,-122.169,1970,9750,11300,11720,1550,53,53
4,1.75,1690,7794,1,0,0,3,7,1090,600,47.6888,-122.203,1380,7325,9484,8705,1690,51,51
3,1.75,1610,11200,1,0,0,3,7,1610,0,47.6641,-122.176,1610,11200,12810,12810,1610,64,64
3,1.75,1660,9900,2,0,0,3,8,1660,0,47.6704,-122.184,1720,6600,11560,8320,1660,41,41
3,1.75,1490,3840,2,0,0,3,8,1490,0,47.6916,-122.214,3450,8500,5330,11950,1490,35,0
3,2.25,2060,8640,1,0,0,4,8,2060,0,47.6534,-122.195,2030,9000,10700,11030,2060,53,53
4,5,5810,7440,2,0,0,3,10,3790,2020,47.6878,-122.212,3010,7200,13250,10210,5810,15,15
3,2,1840,14985,1,0,0,3,7,1840,0,47.6916,-122.158,2300,16067,16825,18367,1840,51,51
4,2.25,2310,9800,1,0,0,3,8,1780,530,47.6657,-122.178,2310,9800,12110,12110,2310,51,51
4,2.25,2100,7350,2,0,0,3,8,2100,0,47.7019,-122.171,1780,7350,9450,9130,2100,40,40
3,2.5,2110,5608,1,0,0,3,8,1340,770,47.6743,-122.184,2040,9363,7718,11403,2110,6,6
5,3.75,3050,8972,2,0,0,3,9,3050,0,47.6819,-122.172,2750,8979,12022,11729,3050,5,5
3,1.5,960,4600,1,0,0,3,6,960,0,47.6937,-122.213,2230,9350,5560,11580,960,75,75
2,1.5,1370,4102,2,0,0,4,7,1370,0,47.6943,-122.184,1380,3211,5472,4591,1370,32,32
3,2.5,3210,8630,2,0,0,4,10,2530,680,47.6939,-122.189,2630,8630,11840,11260,3210,29,29
4,2,1740,9000,1,0,0,5,8,1740,0,47.6815,-122.198,1850,7700,10740,9550,1740,61,61
3,2,1470,6000,1,0,0,3,8,1090,380,47.6829,-122.202,1880,7799,7470,9679,1470,69,19
2,1,1670,14695,1,0,0,5,7,1670,0,47.7001,-122.2,1800,11355,16365,13155,1670,89,89
2,2,1140,8282,1,0,0,3,6,1140,0,47.6949,-122.21,1650,9000,9422,10650,1140,95,5
2,1.75,1280,8500,1,0,0,3,7,1280,0,47.6553,-122.19,1950,10356,9780,12306,1280,66,4
3,2.25,2110,7279,1,0,0,4,9,2110,0,47.6669,-122.17,2130,7279,9389,9409,2110,35,35
3,1.75,2080,75794,1,0,0,3,7,2080,0,47.7018,-122.189,1870,11020,77874,12890,2080,61,61
3,2.5,1480,14250,2,0,0,3,7,1480,0,47.6595,-122.186,1660,14250,15730,15910,1480,23,23
2,1,1010,9219,1,0,0,4,7,1010,0,47.6886,-122.202,1610,9219,10229,10829,1010,59,59
3,2.5,1430,10200,1,0,0,3,7,1430,0,47.7012,-122.166,1470,10350,11630,11820,1430,59,59
4,3.5,3850,8100,2,0,1,3,11,2430,1420,47.6855,-122.19,2620,9346,11950,11966,3850,24,24
3,1.5,2240,13288,1,0,0,3,7,2240,0,47.6762,-122.17,2150,9900,15528,12050,2240,66,66
5,3.25,3930,5500,2,0,0,3,9,2910,1020,47.6802,-122.208,2040,5115,9430,7155,3930,5,5
3,1.75,1970,10548,1,0,0,4,8,1300,670,47.6669,-122.179,2500,8548,12518,11048,1970,46,46
5,2,1900,6000,1,0,0,4,6,1900,0,47.6831,-122.186,2110,8400,7900,10510,1900,99,99
3,1.5,1390,10530,1,0,0,3,7,1390,0,47.7025,-122.196,1750,10530,11920,12280,1390,58,58
4,3.25,3810,8519,1,0,1,3,10,2680,1130,47.699,-122.207,3240,10748,12329,13988,3810,12,12
3,2.5,2610,7256,2,0,0,3,9,2610,0,47.695,-122.18,2610,7206,9866,9816,2610,5,5
4,2.5,1870,16200,1,0,0,5,8,1250,620,47.6651,-122.174,2000,11250,18070,13250,1870,45,45
2,2.5,1590,1845,2,0,0,3,9,1590,0,47.6897,-122.175,2320,3174,3435,5494,1590,22,22
3,2.5,1610,8064,1,0,2,4,7,1160,450,47.6818,-122.189,2260,8328,9674,10588,1610,38,38
3,2.25,2880,7599,1,0,2,3,9,1710,1170,47.6938,-122.215,2920,12401,10479,15321,2880,61,12
5,4.75,5305,8401,2,0,2,3,11,3745,1560,47.6864,-122.215,2960,7200,13706,10160,5305,14,14
5,3.25,3950,11438,2,0,2,3,10,3430,520,47.6898,-122.189,2070,10751,15388,12821,3950,13,13
3,2.25,1780,8784,1,0,0,3,7,1230,550,47.701,-122.172,1780,7704,10564,9484,1780,42,42
3,1.5,1750,12632,1,0,0,4,7,1750,0,47.6736,-122.176,1740,12196,14382,13936,1750,67,67
4,3.25,3910,7500,2,0,0,3,10,3910,0,47.6527,-122.198,2600,9235,11410,11835,3910,13,13
3,2.25,1850,7923,1,0,0,4,7,1150,700,47.7011,-122.171,1780,7420,9773,9200,1850,42,42
5,3,2960,15152,2,0,0,3,9,2960,0,47.6689,-122.179,1850,9453,18112,11303,2960,15,15
3,2.5,2070,3599,2,0,0,3,8,2070,0,47.6679,-122.165,2070,6844,5669,8914,2070,20,20
4,2.25,2260,41984,1,0,0,4,9,2260,0,47.6622,-122.171,2650,37318,44244,39968,2260,52,52
3,1,1540,9028,1,0,0,4,6,1540,0,47.6698,-122.177,1450,9028,10568,10478,1540,51,51
3,1.5,1300,7287,1,0,0,4,7,1300,0,47.6889,-122.187,1300,9129,8587,10429,1300,54,54
4,2.25,2170,7007,1,0,0,3,8,1540,630,47.672,-122.169,2040,7700,9177,9740,2170,45,45
4,2.5,3160,8281,2,0,0,4,9,3160,0,47.6699,-122.195,3000,8281,11441,11281,3160,24,24
3,2.5,1530,2913,2,0,0,4,7,1530,0,47.6939,-122.184,1370,3783,4443,5153,1530,33,33
4,2.5,2680,7200,1,0,0,3,8,1380,1300,47.6835,-122.187,1950,8520,9880,10470,2680,67,1
3,2.5,2080,3729,2,0,0,3,9,2080,0,47.6731,-122.199,2080,4000,5809,6080,2080,23,23
3,2.5,2044,5610,2,0,0,4,9,2044,0,47.6791,-122.209,2440,5610,7654,8050,2044,23,23
4,1.5,1940,12100,1,0,0,3,7,1940,0,47.6892,-122.164,1380,12100,14040,13480,1940,57,57
4,1.75,2490,7834,1,0,3,4,8,1240,1250,47.6851,-122.209,3210,7834,10324,11044,2490,61,61
3,2,1820,4418,2,0,0,4,8,1820,0,47.6947,-122.19,1920,13402,6238,15322,1820,25,25
3,1,1010,6120,1,0,0,3,6,1010,0,47.6648,-122.204,1260,5977,7130,7237,1010,77,77
3,2.25,1420,13468,1,0,0,3,7,960,460,47.6693,-122.176,1480,10980,14888,12460,1420,43,43
5,2.75,3020,9187,2,0,0,3,9,3020,0,47.6806,-122.167,2250,9675,12207,11925,3020,12,12
2,1,920,9000,1,0,0,1,6,920,0,47.6831,-122.189,1760,8400,9920,10160,920,65,65
3,2,2370,12196,2,0,0,4,7,2370,0,47.6734,-122.176,1380,12196,14566,13576,2370,49,49
3,2.5,2060,4730,2,0,0,4,8,2060,0,47.6874,-122.178,1980,5010,6790,6990,2060,25,25
3,1.75,1460,10128,1,0,0,3,8,1460,0,47.6709,-122.167,2240,10154,11588,12394,1460,51,15
4,2.5,3030,8507,2,0,0,3,9,3030,0,47.6675,-122.176,2570,8830,11537,11400,3030,16,16
4,3.5,3900,8391,2,0,0,3,10,3900,0,47.6979,-122.205,3820,12268,12291,16088,3900,13,13
4,3.5,2770,24140,2,0,0,3,8,2770,0,47.6585,-122.186,1720,16011,26910,17731,2770,52,52
2,2.5,1550,2657,2,0,0,4,8,1550,0,47.7034,-122.188,1570,2442,4207,4012,1550,32,32
3,2.5,2150,5193,2,0,0,3,8,2150,0,47.6952,-122.187,2150,7172,7343,9322,2150,24,24
4,2.5,2910,6555,2,0,0,3,9,2910,0,47.6659,-122.172,2910,10419,9465,13329,2910,14,14
3,2.25,1720,8521,1,0,0,4,7,1140,580,47.6882,-122.184,1530,8692,10241,10222,1720,35,35
4,2.5,2070,8473,1,0,0,4,8,1250,820,47.6608,-122.19,2070,9499,10543,11569,2070,43,43
3,1,1110,7520,1,0,0,4,7,1110,0,47.683,-122.176,1440,8400,8630,9840,1110,59,59
4,2.5,2370,10083,2,0,0,5,8,2370,0,47.6715,-122.166,2370,10133,12453,12503,2370,53,53
4,2.5,3170,47502,2,0,0,3,10,3170,0,47.6495,-122.185,3190,35110,50672,38300,3170,31,31
4,2.75,2560,7961,1,0,2,4,8,1450,1110,47.6499,-122.199,2500,9009,10521,11509,2560,44,44
2,1.75,1650,7500,1,0,0,4,7,1000,650,47.6871,-122.207,2530,9000,9150,11530,1650,60,60
4,3.5,4700,13730,2,0,3,3,11,3500,1200,47.6899,-122.217,3210,15306,18430,18516,4700,61,20
3,2.25,2020,3600,2,0,0,3,8,2020,0,47.6678,-122.165,2070,3699,5620,5769,2020,21,21
3,1.75,2170,12220,1,0,0,5,8,2170,0,47.6537,-122.195,1980,9000,14390,10980,2170,54,54
3,1.5,1560,9600,1,0,0,4,7,1560,0,47.6918,-122.163,1520,10000,11160,11520,1560,58,58
4,3.5,4680,12495,2,0,0,3,10,3040,1640,47.6984,-122.206,3240,10749,17175,13989,4680,11,11
3,3.25,3700,2264,2,0,0,3,11,2280,1420,47.6653,-122.205,3930,2567,5964,6497,3700,21,21
3,2.5,1810,7200,1,0,0,5,7,1310,500,47.6885,-122.211,2050,7200,9010,9250,1810,59,59
2,2.5,1590,2088,2,0,0,3,9,1590,0,47.6897,-122.175,2320,3174,3678,5494,1590,22,22
3,1,1020,7650,1,0,0,3,6,1020,0,47.6795,-122.202,1870,5500,8670,7370,1020,100,100
4,3.5,2350,13402,2,0,3,3,8,1670,680,47.6947,-122.19,2250,9474,15752,11724,2350,25,25
3,1.75,1530,8503,1,0,0,4,7,1150,380,47.6872,-122.185,1610,8549,10033,10159,1530,36,36
3,2,1360,8752,1,0,2,4,6,1360,0,47.6879,-122.208,2530,7680,10112,10210,1360,77,77
4,2.5,3560,8960,2,0,0,3,10,3560,0,47.6903,-122.213,1660,7680,12520,9340,3560,18,18
4,2.75,3080,7242,2,0,0,3,9,3080,0,47.6948,-122.178,3010,7205,10322,10215,3080,5,5
4,2.75,2150,16728,1,0,0,4,8,1240,910,47.6915,-122.183,2200,9257,18878,11457,2150,37,37
5,3.5,3680,8680,2,0,0,3,9,3680,0,47.6575,-122.197,2020,8847,12360,10867,3680,16,16
4,2.75,3610,8580,2,0,0,3,9,3610,0,47.6706,-122.173,2360,8580,12190,10940,3610,5,5
2,2.5,1741,1439,2,0,0,3,8,1446,295,47.7043,-122.209,2090,10454,3180,12544,1741,12,12
4,2.25,2500,10890,1,0,0,5,7,1800,700,47.7318,-122.239,2500,7467,13390,9967,2500,41,41
4,2.75,2560,8956,1,0,0,4,7,1500,1060,47.7278,-122.177,2280,9234,11516,11514,2560,51,51
4,2.5,2170,7700,1,0,0,3,7,1420,750,47.7216,-122.219,1710,7770,9870,9480,2170,50,50
4,2.5,2370,2971,2,0,2,3,9,2080,290,47.7064,-122.224,2970,7500,5341,10470,2370,11,11
4,2.25,2020,8424,1,0,0,4,7,1380,640,47.7262,-122.233,2030,7236,10444,9266,2020,40,40
3,2,1330,7419,1,0,0,3,7,1330,0,47.7322,-122.236,1330,7297,8749,8627,1330,34,34
4,2.25,2110,7560,2,0,0,4,8,2110,0,47.7331,-122.183,2110,7560,9670,9670,2110,45,45
4,2.25,2400,7000,1,0,0,4,8,1800,600,47.7207,-122.184,2210,7210,9400,9420,2400,54,54
3,1.5,1340,7200,1,0,0,3,7,1340,0,47.718,-122.193,1730,8820,8540,10550,1340,47,47
3,1.75,1340,13241,1,0,2,3,7,1340,0,47.7268,-122.213,2090,9704,14581,11794,1340,34,34
4,2.5,2270,11500,1,0,0,3,8,1540,730,47.7089,-122.241,2020,10918,13770,12938,2270,52,52
3,1.5,1240,15867,1,0,0,3,7,1240,0,47.7167,-122.202,1570,9600,17107,11170,1240,57,57
3,2.25,1780,9969,1,0,0,3,8,1450,330,47.7286,-122.168,1950,7974,11749,9924,1780,34,34
4,2.5,2670,5974,2,0,0,3,8,2670,0,47.7122,-122.231,2140,5729,8644,7869,2670,20,20
3,2.5,2074,4900,2,0,0,3,8,2074,0,47.7327,-122.233,1840,7382,6974,9222,2074,22,22
2,2.5,2000,5150,2,0,4,3,9,2000,0,47.7056,-122.223,2510,6800,7150,9310,2000,27,27
4,2.75,3010,10830,2,0,3,4,9,3010,0,47.7005,-122.232,3010,10650,13840,13660,3010,39,39
3,1,1150,7486,1,0,0,3,7,1150,0,47.7261,-122.219,1510,7486,8636,8996,1150,49,49
8,3,3840,15990,1,0,0,3,7,2530,1310,47.7111,-122.211,1380,8172,19830,9552,3840,58,58
4,1.75,1870,7575,1,0,0,3,7,1480,390,47.7205,-122.218,1670,7575,9445,9245,1870,47,47
4,2.5,2410,7950,2,0,0,3,8,2410,0,47.7185,-122.226,1920,7713,10360,9633,2410,22,22
3,1.75,1500,8173,1,0,0,3,7,1500,0,47.7293,-122.227,1970,8173,9673,10143,1500,22,22
4,2,2510,38141,1,0,0,3,9,2510,0,47.7219,-122.258,3180,11760,40651,14940,2510,59,59
2,1.5,1088,1360,2,0,0,3,7,1088,0,47.7094,-122.213,1098,1469,2448,2567,1088,36,36
4,2.5,1770,8155,1,0,0,4,6,1770,0,47.719,-122.173,1460,7360,9925,8820,1770,49,22
3,2.5,1950,13227,2,0,0,4,9,1950,0,47.7217,-122.256,2650,12943,15177,15593,1950,41,41
5,4,3600,14720,1,0,2,5,8,1800,1800,47.7022,-122.227,3600,15358,18320,18958,3600,59,59
3,2.25,1570,7200,2,0,0,3,8,1570,0,47.7332,-122.232,1620,7318,8770,8938,1570,28,28
4,2.75,2360,7716,1,0,0,3,7,1390,970,47.7301,-122.223,2160,8794,10076,10954,2360,41,41
3,2.75,1650,7272,1,0,0,4,7,1230,420,47.7232,-122.174,1770,7272,8922,9042,1650,47,47
3,2.25,2250,8000,1,0,0,3,8,1460,790,47.7229,-122.202,1930,9000,10250,10930,2250,43,43
4,2.5,1530,8375,1,0,0,3,7,1020,510,47.7174,-122.236,1650,9794,9905,11444,1530,45,45
3,2.25,2180,6850,1,0,0,3,7,1750,430,47.7246,-122.217,1740,7016,9030,8756,2180,46,46
3,2.25,2160,6527,2,0,0,4,7,1580,580,47.7292,-122.212,1950,9675,8687,11625,2160,32,32
4,3.5,3660,4903,2,0,0,3,9,2760,900,47.7184,-122.156,3630,4992,8563,8622,3660,5,5
4,2.25,3070,8400,2,0,0,4,8,3070,0,47.7316,-122.169,1880,8000,11470,9880,3070,49,49
4,2.75,2460,9520,1,0,1,3,8,1680,780,47.7021,-122.233,2380,9600,11980,11980,2460,43,43
3,1,950,8000,1,0,0,3,7,950,0,47.7193,-122.184,2270,8540,8950,10810,950,51,51
3,1.75,1480,2185,2,0,0,3,9,1480,0,47.6945,-122.17,1480,2441,3665,3921,1480,14,14
3,1,1180,7455,1,0,0,4,7,1180,0,47.7276,-122.241,1450,8154,8635,9604,1180,55,55
5,3.25,3160,10587,1,0,0,5,7,2190,970,47.7238,-122.165,2200,7761,13747,9961,3160,59,59
4,2.5,1990,2660,2,0,0,3,8,1990,0,47.732,-122.178,1990,2665,4650,4655,1990,7,7
4,4.25,4850,12445,2,1,4,5,10,3850,1000,47.7011,-122.244,3350,12210,17295,15560,4850,30,30
3,1,1270,6900,1,0,0,3,7,1270,0,47.7279,-122.192,1480,7280,8170,8760,1270,42,42
4,2,1600,15044,1,0,0,3,7,1600,0,47.72,-122.216,1660,8102,16644,9762,1600,47,47
5,3,2570,5590,1,0,0,3,8,1580,990,47.7271,-122.228,2020,10500,8160,12520,2570,10,10
4,2.5,3430,10157,2,0,0,3,10,3430,0,47.723,-122.158,3480,10157,13587,13637,3430,19,19
4,2,1650,4745,1,0,0,3,7,1130,520,47.7359,-122.18,1650,5184,6395,6834,1650,47,47
3,1.75,1260,12750,1,0,0,3,7,1260,0,47.7289,-122.233,1460,7865,14010,9325,1260,40,40
5,3.75,4570,10194,2,0,0,3,11,4570,0,47.718,-122.161,2040,7560,14764,9600,4570,13,13
3,1.75,1260,7200,1,0,0,3,7,1260,0,47.7189,-122.178,1460,7200,8460,8660,1260,48,48
2,1.5,1160,1848,2,0,0,3,7,1160,0,47.7366,-122.176,1160,1566,3008,2726,1160,47,47
6,1.75,2230,10080,1,0,0,3,7,1390,840,47.7089,-122.201,2110,8475,12310,10585,2230,50,50
3,1,960,10181,1,0,0,3,7,960,0,47.7231,-122.229,1740,10194,11141,11934,960,58,58
3,1.75,1660,10716,1,0,0,3,7,1100,560,47.7326,-122.234,1630,7626,12376,9256,1660,31,31
4,3,2430,11670,1,0,0,4,7,1330,1100,47.7307,-122.228,1580,10464,14100,12044,2430,41,41
3,2.5,1870,7344,1,0,0,3,8,1470,400,47.7265,-122.206,1930,7344,9214,9274,1870,39,39
3,1.75,2350,7641,1,0,0,3,7,1510,840,47.7307,-122.219,2190,7500,9991,9690,2350,41,41
3,1.75,1810,12600,1,0,0,3,7,1400,410,47.7143,-122.233,1934,12600,14410,14534,1810,42,42
3,1.75,1440,8775,1,0,0,3,7,1440,0,47.7231,-122.17,1790,7865,10215,9655,1440,46,46
3,1,1400,10800,1,0,0,3,6,1400,0,47.719,-122.202,1430,10000,12200,11430,1400,57,57
3,2.25,1700,7650,1,0,0,4,7,1340,360,47.7214,-122.166,1980,7200,9350,9180,1700,44,44
3,1.5,1600,7500,1,0,0,3,7,1600,0,47.721,-122.182,1700,7500,9100,9200,1600,53,53
3,2,1450,9132,1,0,0,3,7,1450,0,47.7288,-122.226,1580,9104,10582,10684,1450,32,32
4,3.5,3090,10510,1,0,0,3,8,2190,900,47.7176,-122.214,2200,7408,13600,9608,3090,28,28
4,1.75,1980,7350,1,0,0,3,7,1430,550,47.7088,-122.202,1870,7920,9330,9790,1980,46,46
3,1.75,1300,7030,1,0,0,3,7,1300,0,47.721,-122.179,1450,7650,8330,9100,1300,51,51
3,1.75,1510,8301,1,0,0,3,7,1510,0,47.7243,-122.222,1460,7910,9811,9370,1510,52,52
4,1.75,2030,18295,1,0,0,4,7,2030,0,47.7326,-122.179,1970,7307,20325,9277,2030,44,44
4,3.5,4120,12626,2,0,1,3,11,3970,150,47.7089,-122.245,4120,11913,16746,16033,4120,5,5
4,1.75,1900,7313,1,0,0,3,7,1900,0,47.7311,-122.232,1420,7384,9213,8804,1900,46,46
3,1.75,1260,7373,1,0,0,4,7,1260,0,47.7296,-122.233,1360,7373,8633,8733,1260,40,40
3,1.75,2280,16671,1,0,0,4,6,1760,520,47.7096,-122.219,1850,9351,18951,11201,2280,110,110
2,1,790,2640,1,0,0,3,7,790,0,47.7351,-122.178,1310,2064,3430,3374,790,46,46
4,1,1520,9800,1,0,0,4,7,1520,0,47.7303,-122.236,1540,7700,11320,9240,1520,48,48
4,1.5,1860,12197,1,0,0,3,7,1860,0,47.729,-122.235,1510,11761,14057,13271,1860,55,55
3,1.75,1650,9480,1,0,0,3,7,1220,430,47.726,-122.191,1540,8400,11130,9940,1650,42,42
3,2,1910,13505,1,0,0,3,8,1910,0,47.7114,-122.23,2010,8000,15415,10010,1910,64,64
4,2.75,2270,7375,1,0,0,4,7,1290,980,47.7222,-122.168,1750,7760,9645,9510,2270,46,46
3,2.75,3470,9610,3,1,4,3,11,3470,0,47.7205,-122.26,4130,11875,13080,16005,3470,30,15
3,1.5,1370,9720,2,0,0,3,7,1370,0,47.7302,-122.197,1510,8775,11090,10285,1370,51,51
3,2.75,2390,21804,1,0,0,3,8,1450,940,47.7339,-122.183,2390,10136,24194,12526,2390,46,46
5,3.5,5110,10018,2,0,0,3,10,3850,1260,47.7261,-122.17,1790,10018,15128,11808,5110,16,16
3,2,1590,10229,1,0,0,3,7,1590,0,47.7239,-122.227,1320,10222,11819,11542,1590,53,53
3,2.5,2510,12779,1,0,4,3,10,2510,0,47.6982,-122.231,2810,12225,15289,15035,2510,51,51
3,1.75,2090,7505,1,0,0,3,7,2090,0,47.7326,-122.194,1510,7416,9595,8926,2090,52,52
4,2.75,2760,18306,1,0,0,3,7,1630,1130,47.7302,-122.215,2470,9856,21066,12326,2760,41,41
3,1.75,1470,6682,1,0,0,3,7,1470,0,47.7315,-122.226,1790,7379,8152,9169,1470,32,32
3,2.5,1710,5633,2,0,0,3,7,1710,0,47.7232,-122.161,1540,5000,7343,6540,1710,38,38
4,3,2440,9600,2,0,0,5,7,2440,0,47.7044,-122.2,2290,9600,12040,11890,2440,58,58
5,2.5,2250,7945,1,0,0,4,7,1360,890,47.7316,-122.221,1820,7866,10195,9686,2250,42,42
3,2,1870,7080,1,0,0,4,7,1210,660,47.7244,-122.179,1620,8000,8950,9620,1870,50,50
4,2.5,2840,11044,2,0,0,3,8,2840,0,47.7134,-122.237,1934,9605,13884,11539,2840,18,18
4,2.25,2080,15750,1,0,0,3,8,1460,620,47.7225,-122.2,1960,10500,17830,12460,2080,43,43
4,2.25,2060,10070,2,0,0,3,7,2060,0,47.7258,-122.177,2060,8155,12130,10215,2060,44,44
3,2,1670,7700,1,0,0,3,7,1170,500,47.725,-122.2,1500,7875,9370,9375,1670,47,47
4,1.5,1810,7200,1,0,0,3,7,1810,0,47.7207,-122.186,2060,7200,9010,9260,1810,53,53
4,1,1440,7215,1,0,0,3,7,1440,0,47.7133,-122.212,1150,7215,8655,8365,1440,50,50
5,1.5,1900,10226,1,0,0,3,7,1130,770,47.7226,-122.227,1690,10227,12126,11917,1900,58,58
3,3.5,3470,4171,3,0,0,3,9,3470,0,47.711,-122.229,3430,4268,7641,7698,3470,11,11
3,1,950,9451,1,0,0,4,7,950,0,47.7308,-122.19,1480,8352,10401,9832,950,42,42
3,3.5,2514,1559,2,0,0,3,8,2024,490,47.7044,-122.209,2090,10454,4073,12544,2514,12,12
3,1,2160,11484,1,0,0,4,7,2160,0,47.7277,-122.185,2270,10080,13644,12350,2160,51,51
3,1.75,1810,7300,1,0,0,4,7,1240,570,47.7299,-122.192,1460,7560,9110,9020,1810,43,43
3,2.5,1861,1587,2,0,0,3,8,1578,283,47.7043,-122.209,2090,10454,3448,12544,1861,12,12
3,1.75,1260,7128,1,0,0,4,7,1260,0,47.7263,-122.205,1330,7326,8388,8656,1260,50,50
3,1,960,8556,1,0,0,3,7,960,0,47.7245,-122.22,1320,7528,9516,8848,960,48,48
3,2.5,1920,4534,2,0,0,3,8,1920,0,47.7144,-122.204,1380,5100,6454,6480,1920,33,33
4,2.25,2270,8196,1,0,0,5,7,1150,1120,47.7214,-122.227,1920,10122,10466,12042,2270,56,56
3,1.5,1330,9900,1,0,0,3,7,1330,0,47.7167,-122.233,1940,9900,11230,11840,1330,63,63
2,1.5,1090,2686,2,0,0,3,7,1090,0,47.717,-122.19,1160,2158,3776,3318,1090,37,37
3,2.25,1790,7700,1,0,0,4,7,1340,450,47.7205,-122.168,1610,7350,9490,8960,1790,43,43
3,1.75,1320,10500,1,0,0,3,7,1320,0,47.7267,-122.226,1310,10500,11820,11810,1320,53,53
4,2.5,2460,4166,2,0,0,3,9,2460,0,47.7072,-122.232,2460,4964,6626,7424,2460,16,16
3,2.25,1180,14258,2,0,0,3,7,1180,0,47.7112,-122.238,1860,10390,15438,12250,1180,32,32
3,1.75,1650,7965,1,0,0,4,7,1650,0,47.7335,-122.193,1560,7350,9615,8910,1650,52,52
3,1.75,1670,6720,1,0,0,3,7,1140,530,47.7198,-122.193,1670,7320,8390,8990,1670,39,39
3,1,1010,7680,1,0,0,4,7,1010,0,47.732,-122.231,1320,7373,8690,8693,1010,52,52
3,1.5,1490,7275,1,0,0,3,7,1090,400,47.7148,-122.213,1420,7330,8765,8750,1490,45,45
3,2.5,2010,4059,2,0,0,3,8,2010,0,47.7317,-122.197,2010,5779,6069,7789,2010,21,21
3,2.75,2100,20150,1,0,0,4,7,2100,0,47.7206,-122.248,2100,15500,22250,17600,2100,64,64
3,2.5,1510,7300,1,0,0,3,7,1040,470,47.7153,-122.211,1360,7300,8810,8660,1510,45,45
3,2.25,1840,10500,2,0,0,3,7,1840,0,47.7326,-122.234,1840,7374,12340,9214,1840,26,26
3,2.5,2300,4307,2,0,0,3,8,2300,0,47.7326,-122.197,2010,4307,6607,6317,2300,21,21
3,1.75,1510,8385,1,0,0,3,7,1510,0,47.7279,-122.195,1570,7480,9895,9050,1510,51,51
3,2.5,1940,9775,1,0,2,3,8,1440,500,47.7142,-122.222,2830,9775,11715,12605,1940,44,44
3,1,1120,10032,1,0,0,3,7,1120,0,47.7182,-122.194,1210,9918,11152,11128,1120,57,57
3,2.5,2010,5200,2,0,0,3,8,2010,0,47.7142,-122.203,1860,4400,7210,6260,2010,30,30
3,2.5,3350,4007,2,0,0,3,8,2550,800,47.7277,-122.207,2340,4167,7357,6507,3350,14,14
3,1.75,1640,10695,1,0,2,3,8,1640,0,47.7145,-122.222,2790,9775,12335,12565,1640,44,44
3,1,1470,9750,1,0,0,3,7,1470,0,47.7155,-122.194,1300,9750,11220,11050,1470,56,56
3,2.75,1830,3200,2,0,0,3,8,1830,0,47.7155,-122.218,2030,3331,5030,5361,1830,28,28
3,1,1040,7490,1,0,0,3,7,1040,0,47.7137,-122.213,1520,7410,8530,8930,1040,50,50
5,4.5,4280,8465,2,0,0,3,10,4280,0,47.7325,-122.165,2990,11067,12745,14057,4280,5,5
3,1,1450,7200,1,0,0,3,7,1010,440,47.7311,-122.199,1500,6767,8650,8267,1450,50,50
3,2.5,1960,8000,1,0,0,4,7,1290,670,47.7249,-122.178,1960,8000,9960,9960,1960,42,42
3,1,1600,7500,1,0,0,3,7,1600,0,47.7198,-122.182,2050,7200,9100,9250,1600,53,53
3,2.25,1820,8446,2,0,0,3,8,1820,0,47.7208,-122.236,1850,8437,10266,10287,1820,41,41
4,2.75,3120,7898,1,1,4,4,8,1560,1560,47.7165,-122.259,2630,13868,11018,16498,3120,56,56
3,1.75,1620,7330,1,0,0,4,7,1090,530,47.7148,-122.213,1380,7191,8950,8571,1620,45,45
3,2.25,1790,7500,1,0,0,3,7,1390,400,47.7321,-122.198,1940,7192,9290,9132,1790,46,46
3,1,1010,7200,1,0,0,3,7,1010,0,47.7225,-122.179,1120,7200,8210,8320,1010,51,51
4,2.5,2250,11370,2,0,0,3,8,2250,0,47.7115,-122.239,2190,9611,13620,11801,2250,28,28
2,1,1620,9205,1,0,0,5,6,850,770,47.7119,-122.23,2460,5469,10825,7929,1620,98,98
3,2.25,1780,7280,1,0,2,3,7,1340,440,47.723,-122.215,2060,7280,9060,9340,1780,47,47
3,2.5,3930,55867,1,1,4,4,8,2330,1600,47.7022,-122.224,2730,26324,59797,29054,3930,62,62
4,3,2260,7336,2,0,0,4,7,2260,0,47.7297,-122.219,2200,7724,9596,9924,2260,42,42
3,2,2420,17859,1,0,1,5,9,1500,920,47.7074,-122.246,2955,17859,20279,20814,2420,40,40
3,1.5,2240,28750,1,0,0,3,8,1620,620,47.7137,-122.254,3200,23873,30990,27073,2240,63,63
3,2,1260,5460,1,0,0,3,7,1260,0,47.7355,-122.18,1510,5460,6720,6970,1260,47,47
4,2,1720,7210,1,0,0,3,7,860,860,47.7307,-122.239,1250,7210,8930,8460,1720,48,48
3,1,990,7050,1,0,0,3,7,990,0,47.7274,-122.202,1200,8125,8040,9325,990,52,52
3,1.75,1780,8033,1,0,0,2,7,1210,570,47.7275,-122.219,1630,7508,9813,9138,1780,42,42
3,1.5,1380,6657,2,0,0,3,7,1380,0,47.7085,-122.217,1420,8187,8037,9607,1380,33,33
4,2.75,2160,7200,1,0,0,4,7,1220,940,47.7177,-122.224,1790,7614,9360,9404,2160,43,43
4,2.5,3000,8645,2,0,0,3,8,3000,0,47.7315,-122.224,1930,8866,11645,10796,3000,34,34
4,1.75,1520,7700,1,0,0,4,7,1520,0,47.7356,-122.191,1520,7500,9220,9020,1520,52,52
3,1,900,37800,1,0,0,4,5,700,200,47.7146,-122.234,1750,11998,38700,13748,900,96,96
3,1.5,1250,7194,1,0,0,4,7,1250,0,47.7298,-122.231,1340,7242,8444,8582,1250,50,50
4,2.5,2250,11349,2,0,0,3,8,2250,0,47.7111,-122.239,2110,9964,13599,12074,2250,28,28
3,2.5,1500,7420,1,0,0,3,7,1000,500,47.7236,-122.174,1840,7272,8920,9112,1500,47,47
3,2.25,1630,10500,1,0,0,3,7,1100,530,47.7176,-122.236,1640,9794,12130,11434,1630,45,45
3,1,1410,7854,1,0,0,4,7,1410,0,47.7303,-122.192,1460,7500,9264,8960,1410,48,48
5,1.75,1880,10000,1,0,0,3,7,960,920,47.7182,-122.201,1580,10000,11880,11580,1880,56,56
4,2,1180,7275,1,0,0,3,7,1180,0,47.7301,-122.2,1210,7275,8455,8485,1180,54,54
4,2.25,1710,7000,1,0,0,4,7,1040,670,47.719,-122.217,1780,6500,8710,8280,1710,47,47
3,3.5,4110,15720,1,0,1,3,10,2230,1880,47.6996,-122.229,2500,15400,19830,17900,4110,19,19
5,2.25,2500,8621,1,0,0,4,7,2500,0,47.7379,-122.185,1980,7395,11121,9375,2500,51,51
3,2.5,2680,9750,1,0,0,4,8,1610,1070,47.7028,-122.231,2480,8750,12430,11230,2680,40,40
3,2.25,1870,9315,1,0,0,3,7,1350,520,47.705,-122.202,2230,9579,11185,11809,1870,44,44
3,3,1520,7500,1,0,0,3,7,1180,340,47.7276,-122.181,2080,8000,9020,10080,1520,52,52
4,2.5,2570,4412,2,0,0,3,9,2570,0,47.7076,-122.232,2460,5470,6982,7930,2570,18,18
3,1,910,8008,1,0,0,3,7,910,0,47.726,-122.22,1480,7404,8918,8884,910,48,48
3,1,1250,9427,1,0,0,3,6,1250,0,47.7254,-122.175,1590,8250,10677,9840,1250,88,88
4,2.5,2410,7069,2,0,0,3,9,2410,0,47.7094,-122.234,2240,7184,9479,9424,2410,26,26
4,2.75,3140,7258,2,0,1,3,10,3140,0,47.7064,-122.232,2990,13600,10398,16590,3140,13,13
5,2.5,1990,6840,2,0,0,4,7,1990,0,47.7162,-122.166,1990,7150,8830,9140,1990,45,45
3,1.75,1300,7800,1,0,0,5,7,1300,0,47.7321,-122.195,1520,7344,9100,8864,1300,51,51
3,1.75,1780,9660,1,0,0,3,7,1780,0,47.7171,-122.193,1200,9660,11440,10860,1780,57,57
3,2.25,1830,13477,1,0,3,4,7,1170,660,47.7243,-122.21,1960,11344,15307,13304,1830,38,38
3,2,1260,5612,1,0,0,4,7,1260,0,47.7362,-122.179,1640,4745,6872,6385,1260,47,47
4,1.75,1880,7303,1,0,0,3,7,1010,870,47.7129,-122.203,1710,7200,9183,8910,1880,43,43
3,2,1430,9583,1,0,0,4,7,1430,0,47.7206,-122.197,1890,11100,11013,12990,1430,55,55
4,2,2100,12620,1,0,0,4,7,2100,0,47.7239,-122.173,1720,7840,14720,9560,2100,47,47
3,1.75,1780,7567,1,0,0,3,7,1290,490,47.7314,-122.225,1910,8645,9347,10555,1780,39,39
3,1,1160,10500,1,0,0,4,7,1160,0,47.7267,-122.227,1520,10500,11660,12020,1160,53,53
3,1,900,7500,1,0,0,4,7,900,0,47.7314,-122.237,1960,7500,8400,9460,900,47,47
6,4.5,2940,7500,1,0,0,4,8,2940,0,47.7208,-122.182,2010,7500,10440,9510,2940,53,53
4,2.75,2020,7357,1,0,0,3,7,1350,670,47.7145,-122.225,1690,7804,9377,9494,2020,33,33
3,2.25,1570,7475,1,0,0,4,7,1200,370,47.7223,-122.174,1700,7230,9045,8930,1570,36,36
3,1.5,1590,6750,1,0,0,3,7,1080,510,47.73,-122.191,1590,7400,8340,8990,1590,43,43
3,2.5,2680,17707,2,0,1,3,9,2680,0,47.7031,-122.224,2840,21743,20387,24583,2680,36,36
4,1,1230,8316,1,0,0,3,7,1230,0,47.7269,-122.24,1490,8316,9546,9806,1230,56,56
4,2.25,2270,7800,1,0,0,3,7,1290,980,47.7278,-122.192,1480,7280,10070,8760,2270,42,42
3,2.5,2820,14890,1,0,4,3,9,1770,1050,47.7019,-122.228,3740,14890,17710,18630,2820,34,34
3,1.5,1310,8100,1,0,0,3,7,1310,0,47.7328,-122.201,1330,8100,9410,9430,1310,54,54
3,1,1120,7250,1,0,0,4,7,1120,0,47.7143,-122.211,1340,7302,8370,8642,1120,47,47
3,1.75,1210,6175,1,0,0,3,7,1210,0,47.7291,-122.202,1520,7475,7385,8995,1210,43,43
4,2.5,3100,7807,2,0,0,3,9,3100,0,47.7151,-122.227,3100,7807,10907,10907,3100,16,16
3,2.75,3040,24192,2,0,0,4,10,3040,0,47.7108,-122.225,2770,5728,27232,8498,3040,32,32
3,2.25,2280,8500,1,0,0,4,7,1680,600,47.7211,-122.166,1890,7700,10780,9590,2280,42,42
3,2.25,1640,7261,2,0,0,3,7,1640,0,47.7192,-122.176,1640,6789,8901,8429,1640,30,30
2,2,2180,21392,2,0,0,3,8,2180,0,47.7162,-122.246,2890,22000,23572,24890,2180,85,35
4,2,1650,9305,1,0,0,4,6,1650,0,47.7183,-122.213,1860,7486,10955,9346,1650,59,59
4,2.5,1850,5444,2,0,0,5,7,1850,0,47.7227,-122.16,1540,5000,7294,6540,1850,38,38
3,2.25,2370,7878,2,0,0,3,8,2370,0,47.7281,-122.168,1870,7766,10248,9636,2370,34,34
3,1.75,1310,9761,1,0,0,3,7,1310,0,47.721,-122.228,1490,9600,11071,11090,1310,52,52
3,1,1120,10500,1,0,0,4,7,1120,0,47.7267,-122.226,1320,10500,11620,11820,1120,53,53
4,2.25,1310,8400,1,0,0,4,7,1310,0,47.7317,-122.181,1600,8400,9710,10000,1310,53,53
4,2.25,2270,9100,2,0,0,3,7,2270,0,47.7242,-122.17,1710,7910,11370,9620,2270,41,41
4,2.5,3320,7429,2,0,0,3,9,3320,0,47.7189,-122.225,1840,7429,10749,9269,3320,5,5
3,1.75,1490,10757,1,0,0,3,7,1060,430,47.72,-122.229,1490,10609,12247,12099,1490,53,53
4,1.5,1540,7886,2,0,0,3,7,1540,0,47.734,-122.193,1550,7396,9426,8946,1540,52,52
3,2,1510,6710,1,0,0,3,7,1070,440,47.7193,-122.216,1660,6600,8220,8260,1510,47,47
5,2.75,2830,8925,1,0,0,3,7,2830,0,47.731,-122.179,1700,8539,11755,10239,2830,52,52
3,2.25,1420,3433,2,0,0,4,7,1420,0,47.7245,-122.163,1150,3432,4853,4582,1420,38,38
4,2.5,3180,20870,2,0,0,3,8,2120,1060,47.7176,-122.241,2700,14190,24050,16890,3180,52,52
3,1,980,7296,1,0,0,3,7,980,0,47.7292,-122.231,1280,7296,8276,8576,980,52,52
3,1.75,1400,7920,1,0,0,3,7,1400,0,47.7312,-122.202,1310,7876,9320,9186,1400,54,54
4,2.75,3140,10918,1,0,0,3,8,1900,1240,47.7086,-122.243,3170,10918,14058,14088,3140,51,28
3,2.5,1860,3150,2,0,0,3,8,1860,0,47.719,-122.182,2050,3375,5010,5425,1860,18,18
4,2.25,2140,10943,1,0,0,3,7,1550,590,47.7271,-122.215,2350,9000,13083,11350,2140,42,42
4,2.75,2080,9600,1,0,0,3,8,1240,840,47.7149,-122.235,1880,9525,11680,11405,2080,40,40
4,2.25,2060,8540,1,0,0,4,7,1540,520,47.734,-122.19,1560,7700,10600,9260,2060,52,52
2,1,870,4025,1,0,0,3,7,870,0,47.7243,-122.161,1370,3488,4895,4858,870,38,38
3,1.5,1330,8636,1,0,0,4,7,1330,0,47.7289,-122.203,1370,7475,9966,8845,1330,51,51
3,1.75,2330,16300,2,0,0,3,9,2330,0,47.7037,-122.24,2330,16300,18630,18630,2330,55,55
3,2.5,1990,8325,2,0,0,4,8,1310,680,47.705,-122.201,2450,10606,10315,13056,1990,22,22
5,3.5,3860,9600,1,0,3,4,8,2660,1200,47.7139,-122.223,2440,9600,13460,12040,3860,46,46
4,2.25,1630,7969,1,0,0,3,7,1100,530,47.7336,-122.19,1580,7440,9599,9020,1630,42,42
2,0.75,750,16321,1,0,1,3,4,750,0,47.6985,-122.229,3020,10625,17071,13645,750,83,83
3,2.5,2540,6093,2,0,0,3,9,2540,0,47.7042,-122.236,2540,5924,8633,8464,2540,20,20
5,3.5,4090,290980,1,0,0,3,11,2920,1170,47.7161,-122.219,1880,9255,295070,11135,4090,17,17
3,1,960,7218,1,0,0,4,7,960,0,47.7278,-122.226,1580,9104,8178,10684,960,50,50
4,2.75,1830,8384,1,0,0,3,7,1320,510,47.733,-122.22,2190,7695,10214,9885,1830,40,40
3,2.5,2390,6435,1,0,0,3,8,1600,790,47.726,-122.194,2020,7300,8825,9320,2390,41,41
4,2.25,2010,7575,1,0,0,3,7,1220,790,47.7328,-122.2,1820,7831,9585,9651,2010,45,45
4,2.5,2540,4727,2,0,0,3,9,2540,0,47.7034,-122.236,3640,5129,7267,8769,2540,20,20
6,3.5,2400,8620,2,0,0,3,8,1640,760,47.7152,-122.162,1940,7350,11020,9290,2400,32,32
5,2.75,3050,7500,1,0,0,4,8,1800,1250,47.7249,-122.187,2060,7848,10550,9908,3050,53,53
3,2.75,2730,11936,2,0,2,3,8,1530,1200,47.6987,-122.231,2810,12333,14666,15143,2730,41,41
4,2,1450,8400,1,0,0,4,7,1450,0,47.7285,-122.24,1450,7440,9850,8890,1450,57,57
3,3,2330,10327,1,0,0,3,9,2330,0,47.7239,-122.164,2200,4629,12657,6829,2330,21,21
3,1,1140,10320,1,0,0,4,7,1140,0,47.7168,-122.196,1140,10412,11460,11552,1140,56,56
4,2.5,2980,13341,1,1,4,5,8,1800,1180,47.704,-122.245,2340,19810,16321,22150,2980,91,91
5,2.5,2340,7200,1,0,0,3,7,1300,1040,47.7206,-122.211,1930,7221,9540,9151,2340,44,44
4,2.25,2560,9731,2,0,0,4,7,2560,0,47.7261,-122.246,1860,9731,12291,11591,2560,46,46
3,3,2080,10521,1,0,0,3,9,2080,0,47.6987,-122.228,3730,11840,12601,15570,2080,15,15
3,2.5,1370,4400,1,0,0,3,8,1370,0,47.7139,-122.203,1630,4400,5770,6030,1370,31,31
5,1.5,1890,10880,1,0,0,3,7,1890,0,47.7196,-122.197,1670,9750,12770,11420,1890,57,57
4,1.75,1520,10630,1,0,0,4,7,1520,0,47.7347,-122.193,1550,8039,12150,9589,1520,52,52
3,1,1220,7876,1,0,0,3,7,1220,0,47.7317,-122.201,1340,7876,9096,9216,1220,53,53
3,2.25,1600,10240,1,0,0,3,7,1090,510,47.7281,-122.232,1520,9394,11840,10914,1600,40,40
4,3,2410,8284,1,0,0,5,7,1210,1200,47.7202,-122.22,2050,7940,10694,9990,2410,50,50
3,1.75,1600,10280,1,0,0,3,7,1050,550,47.725,-122.174,1590,8100,11880,9690,1600,42,42
5,2.5,2310,8303,1,0,0,3,7,1300,1010,47.7212,-122.211,1930,8303,10613,10233,2310,44,44
3,1.75,2490,7210,1,0,0,3,7,1290,1200,47.726,-122.198,1610,7210,9700,8820,2490,47,47
3,3.5,4490,56609,2,1,4,3,12,4490,0,47.6997,-122.24,2710,51330,61099,54040,4490,26,26
4,1.75,1720,8750,1,0,0,3,7,860,860,47.726,-122.21,1790,8750,10470,10540,1720,48,48
3,1,910,7700,1,0,0,4,7,910,0,47.7303,-122.238,1250,7700,8610,8950,910,48,48
3,2.5,1400,7508,2,0,0,4,7,1400,0,47.7233,-122.167,1710,7700,8908,9410,1400,32,32
4,3,1820,8261,1,0,0,3,7,1420,400,47.7197,-122.219,1920,7961,10081,9881,1820,50,50
5,2.5,2820,14062,2,0,0,4,7,2380,440,47.7081,-122.215,1910,10392,16882,12302,2820,59,59
2,1,900,8374,1,0,0,3,7,900,0,47.7282,-122.225,1580,8965,9274,10545,900,35,35
3,2,1310,9855,1,0,0,3,7,1310,0,47.7296,-122.241,1310,8370,11165,9680,1310,57,57
3,1.75,1510,7700,1,0,0,3,7,1510,0,47.7283,-122.194,1440,7416,9210,8856,1510,51,51
4,2.5,3220,8379,2,0,0,3,10,3220,0,47.7043,-122.192,2720,7635,11599,10355,3220,15,15
3,2,1440,7425,1,0,0,4,7,1440,0,47.7243,-122.185,1800,8344,8865,10144,1440,54,54
2,1.5,1150,3927,2,0,0,3,7,1150,0,47.7248,-122.162,1400,3425,5077,4825,1150,37,37
3,2.5,1800,5372,2,0,0,3,8,1800,0,47.7188,-122.177,1650,6014,7172,7664,1800,32,32
3,1,1090,6712,1,0,0,4,7,1090,0,47.7155,-122.211,1440,7350,7802,8790,1090,47,47
3,2.5,2000,8424,1,0,0,4,7,1300,700,47.7089,-122.201,2110,8400,10424,10510,2000,51,51
4,3.25,3600,38016,2,0,2,3,11,3310,290,47.7124,-122.253,2440,22693,41616,25133,3600,28,28
4,2.5,3160,7210,1,0,0,4,7,1880,1280,47.7368,-122.183,2070,7560,10370,9630,3160,50,50
4,2.25,1970,8941,2,0,0,3,7,1970,0,47.7223,-122.172,1880,7793,10911,9673,1970,46,46
4,2.25,2130,8640,1,0,0,3,7,1430,700,47.7087,-122.198,2120,8826,10770,10946,2130,50,50
3,2.5,1470,4488,2,0,0,5,7,1470,0,47.723,-122.162,1400,4441,5958,5841,1470,39,39
3,1.75,1640,6435,1,0,0,3,7,1190,450,47.7197,-122.217,1770,6930,8075,8700,1640,47,47
3,2,1560,8640,1,0,0,5,7,1560,0,47.7294,-122.186,1970,8625,10200,10595,1560,52,52
3,1.75,1850,16863,1,0,0,4,7,1280,570,47.7166,-122.225,1790,9000,18713,10790,1850,39,39
4,2.5,2150,10098,1,0,0,3,7,1090,1060,47.7166,-122.201,1880,10000,12248,11880,2150,56,56
3,2.5,2780,11964,2,0,0,3,9,2780,0,47.7127,-122.216,1760,9640,14744,11400,2780,10,10
3,1.5,1340,6500,1,0,0,3,7,1340,0,47.7168,-122.192,1620,7107,7840,8727,1340,47,47
4,1.75,1940,8990,1,0,0,4,8,1560,380,47.7021,-122.241,2310,11745,10930,14055,1940,63,63
4,2.5,3170,3862,3,0,0,3,8,3170,0,47.6705,-122.145,2840,4181,7032,7021,3170,11,11
4,2.25,1870,9680,1,0,0,4,7,1170,700,47.7157,-122.234,2000,9790,11550,11790,1870,60,60
4,2.75,2420,10200,1,0,0,3,8,1220,1200,47.72,-122.236,2240,9750,12620,11990,2420,57,57
3,2,1410,8088,1,0,0,3,7,1410,0,47.7303,-122.227,1770,7401,9498,9171,1410,32,32
3,2.25,1560,12000,1,0,0,4,7,1110,450,47.7256,-122.166,2190,4612,13560,6802,1560,51,51
3,2.5,1720,7950,1,0,0,4,7,1720,0,47.7178,-122.168,1790,7030,9670,8820,1720,47,47
4,2.75,2900,17802,1,0,2,3,9,1750,1150,47.7004,-122.229,2900,15720,20702,18620,2900,38,38
4,2.75,3030,18400,1,0,3,3,9,2360,670,47.7019,-122.243,3030,12486,21430,15516,3030,46,46
4,3.25,3160,10043,2,0,2,3,9,3160,0,47.7001,-122.238,3450,10043,13203,13493,3160,8,8
3,1.75,2090,8910,1,0,0,3,8,1230,860,47.7149,-122.222,2310,10695,11000,13005,2090,44,44
3,1.5,980,7790,1,0,0,5,7,980,0,47.7141,-122.213,1390,7280,8770,8670,980,50,50
6,1.75,2230,10080,1,0,0,3,7,1390,840,47.7089,-122.201,2110,8475,12310,10585,2230,50,50
3,4,5120,4600,3,0,2,3,11,4490,630,47.7052,-122.223,2510,5918,9720,8428,5120,11,11
3,4,3880,13095,2,0,3,3,11,3700,180,47.6996,-122.233,3880,10830,16975,14710,3880,10,10
3,1.5,1060,10464,1,0,0,4,7,1060,0,47.7313,-122.229,1420,10464,11524,11884,1060,46,46
4,3,2530,5625,1,0,0,3,8,1470,1060,47.7094,-122.233,1840,7070,8155,8910,2530,43,43
3,1.75,1830,9758,1,0,0,3,8,1300,530,47.7107,-122.23,1850,8000,11588,9850,1830,42,42
4,1.75,2190,9752,1,0,0,3,8,2190,0,47.7108,-122.239,2040,9964,11942,12004,2190,55,55
3,1.75,1530,7245,1,0,0,4,7,1530,0,47.731,-122.191,1530,7490,8775,9020,1530,35,35
5,2.5,2620,12763,1,0,0,3,7,1400,1220,47.72,-122.213,2390,9156,15383,11546,2620,40,40
4,2.5,2780,6369,1,0,0,3,8,1590,1190,47.7284,-122.216,2170,7490,9149,9660,2780,41,41
3,1.5,1630,16170,1,0,0,3,7,1630,0,47.7104,-122.235,1630,9931,17800,11561,1630,31,31
4,2.75,3210,6825,1,0,0,5,7,1810,1400,47.7338,-122.169,1840,8000,10035,9840,3210,44,44
6,1.75,2490,8732,1,0,0,4,8,2490,0,47.7252,-122.187,1840,8024,11222,9864,2490,53,53
4,1.75,3050,9440,1,0,0,3,8,1800,1250,47.7228,-122.183,2020,8660,12490,10680,3050,53,53
3,1,1060,9663,1,0,0,3,7,1060,0,47.7244,-122.226,1320,10162,10723,11482,1060,52,52
3,1,1130,11250,1,0,0,3,7,1130,0,47.7254,-122.227,1410,11250,12380,12660,1130,54,54
3,1,1030,9916,1,0,0,4,7,1030,0,47.7218,-122.176,1470,9044,10946,10514,1030,47,47
3,2,1560,8509,1,0,0,3,8,790,770,47.7261,-122.22,1410,7428,10069,8838,1560,50,50
4,2.25,2240,8322,2,0,0,3,8,2240,0,47.728,-122.206,2240,6448,10562,8688,2240,40,40
3,2.25,1200,2845,2,0,0,3,7,1200,0,47.7151,-122.203,1220,2140,4045,3360,1200,33,33
3,3.5,4560,14608,2,0,2,3,12,4560,0,47.6995,-122.228,4050,14226,19168,18276,4560,29,29
3,2.25,1480,7565,1,0,0,3,7,1220,260,47.7288,-122.191,1660,7565,9045,9225,1480,42,42
3,2.25,1660,10247,1,0,0,5,7,1130,530,47.7262,-122.222,1680,7637,11907,9317,1660,51,51
3,1,1430,13370,1,0,0,3,7,1430,0,47.7317,-122.241,1670,10075,14800,11745,1430,57,57
3,2.25,2300,8067,1,0,0,4,8,1300,1000,47.7091,-122.198,2120,9524,10367,11644,2300,40,40
4,1.75,2310,9002,1,0,0,3,7,1780,530,47.731,-122.166,2090,8814,11312,10904,2310,49,49
3,1.75,1180,6260,1,0,0,4,8,1180,0,47.3531,-122.048,1580,7272,7440,8852,1180,26,26
3,2.5,1440,3800,2,0,0,3,7,1440,0,47.3606,-122.039,1890,3819,5240,5709,1440,14,14
4,2,2500,36900,1,0,0,3,7,1540,960,47.3708,-122.049,1960,36900,39400,38860,2500,47,47
3,1.75,1890,10661,1,0,0,5,7,1460,430,47.3583,-122.056,1680,9604,12551,11284,1890,41,41
3,2.5,1820,4200,2,0,0,3,8,1820,0,47.3693,-122.017,2370,4200,6020,6570,1820,5,5
3,1,840,5700,1,0,0,4,5,840,0,47.3948,-122.028,1430,12600,6540,14030,840,74,74
3,1,1400,10403,1,0,0,4,6,1400,0,47.362,-122.029,1230,10209,11803,11439,1400,43,43
3,2.5,1560,5845,2,0,0,3,7,1560,0,47.3851,-122.029,1860,5752,7405,7612,1560,16,16
3,2.5,2075,39553,1,0,0,3,7,2075,0,47.3601,-122.032,1960,9047,41628,11007,2075,7,7
4,2.5,1950,8628,2,0,0,3,8,1950,0,47.3817,-122.035,2210,9019,10578,11229,1950,25,25
4,2.5,1780,6000,2,0,0,3,9,1780,0,47.3774,-122.027,2650,6000,7780,8650,1780,19,19
4,2.5,1770,9239,2,0,0,3,7,1770,0,47.3512,-122.006,2150,5450,11009,7600,1770,15,15
3,2.5,1570,6932,2,0,0,3,7,1570,0,47.3902,-122.049,1570,6271,8502,7841,1570,26,26
3,2,1060,7412,1,0,0,3,7,1060,0,47.3897,-122.051,1080,7093,8472,8173,1060,32,32
4,2.5,3130,5240,2,0,0,3,8,3130,0,47.3446,-122.042,2470,5240,8370,7710,3130,15,15
3,2.5,2190,5091,2,0,0,3,8,2190,0,47.3506,-122.039,2200,5948,7281,8148,2190,15,15
3,2.25,1640,7730,1,0,0,4,7,1220,420,47.3576,-122.039,1560,7566,9370,9126,1640,30,30
3,1.5,1690,9600,1,0,0,3,7,1210,480,47.3857,-122.079,1450,9647,11290,11097,1690,43,43
3,1.5,1400,6865,1,0,0,4,7,1400,0,47.3639,-122.048,1480,8125,8265,9605,1400,33,33
4,2.5,2570,4865,2,0,0,3,8,2570,0,47.3588,-122.038,2570,4933,7435,7503,2570,14,14
4,2.5,2110,5306,2,0,0,3,8,2110,0,47.356,-122.057,2250,5306,7416,7556,2110,7,7
4,2.5,2820,5510,2,0,0,3,9,2820,0,47.3477,-122.024,2820,5510,8330,8330,2820,14,14
3,2.5,2250,8076,2,0,0,3,8,2250,0,47.3667,-122.041,2180,7244,10326,9424,2250,24,24
3,2.5,1750,4200,2,0,0,3,7,1750,0,47.3605,-122.04,1890,4048,5950,5938,1750,14,14
5,2.75,2400,4900,2,0,0,3,8,2400,0,47.355,-122.057,2110,5696,7300,7806,2400,8,8
4,2.5,2600,5188,2,0,0,3,8,2600,0,47.3451,-122.04,2610,5188,7788,7798,2600,14,14
4,2.5,2240,3712,2,0,0,3,8,2240,0,47.3551,-122.061,2530,4315,5952,6845,2240,5,5
3,1.75,1340,8000,1,0,0,3,7,1340,0,47.3651,-122.044,1690,8000,9340,9690,1340,39,39
3,2.5,2620,108464,2,0,0,4,8,2620,0,47.4583,-122.036,3190,105850,111084,109040,2620,29,29
4,3,3400,5100,2,0,0,3,9,3400,0,47.3548,-122.002,3400,5672,8500,9072,3400,13,13
4,2.25,2380,128937,1,0,0,4,7,2380,0,47.4253,-122.043,1030,114998,131317,116028,2380,59,59
3,1.75,1490,8357,1,0,0,4,7,1490,0,47.3473,-122.037,1490,7376,9847,8866,1490,26,26
4,2.5,2210,213008,1,0,0,4,7,1210,1000,47.4039,-121.98,2270,52707,215218,54977,2210,44,44
3,1,1200,9936,1,0,0,4,6,1200,0,47.3609,-122.029,1200,10189,11136,11389,1200,50,50
4,2.5,2610,5240,2,0,0,3,8,2610,0,47.345,-122.042,2480,5240,7850,7720,2610,15,15
3,2.5,2750,37096,2,0,0,3,9,2750,0,47.3732,-122.023,2700,40091,39846,42791,2750,30,30
4,2.5,2400,4848,2,0,0,3,8,2400,0,47.3626,-122.04,1980,5199,7248,7179,2400,15,15
3,2,1640,4802,1,0,0,3,8,1640,0,47.3538,-122.021,1940,4802,6442,6742,1640,9,9
4,2.5,2640,47480,1,0,0,4,8,1590,1050,47.4258,-122.021,2390,67415,50120,69805,2640,40,40
4,2.5,2160,6223,2,0,0,3,8,2160,0,47.3494,-122.042,2160,5555,8383,7715,2160,9,9
3,2.5,1810,5192,2,0,0,3,8,1810,0,47.3724,-122.042,1810,6200,7002,8010,1810,26,26
3,2.5,1740,5267,2,0,0,3,7,1740,0,47.3777,-122.023,2180,5000,7007,7180,1740,20,20
5,3.5,2880,5000,2,0,0,3,8,2260,620,47.3455,-122.023,2590,4800,7880,7390,2880,7,7
4,2.5,1930,7862,2,0,0,3,7,1930,0,47.3644,-122.04,1640,9145,9792,10785,1930,25,25
3,2,1370,7500,1,0,0,3,7,1370,0,47.3634,-122.046,1420,7500,8870,8920,1370,22,22
3,2.25,1520,7199,2,0,0,4,7,1520,0,47.3492,-122.034,1410,6751,8719,8161,1520,27,27
3,2.25,1580,7034,1,0,0,4,7,1180,400,47.3564,-122.04,1470,7358,8614,8828,1580,30,30
4,2.5,2570,7859,2,0,0,3,8,2570,0,47.3736,-122.045,2150,7284,10429,9434,2570,27,27
5,2.5,2460,5604,2,0,0,3,8,2460,0,47.3658,-122.037,2210,6395,8064,8605,2460,8,8
3,1.5,1090,9605,1,0,0,4,6,1090,0,47.3609,-122.028,1160,10487,10695,11647,1090,50,50
3,2.25,1646,9519,2,0,0,3,7,1646,0,47.3646,-122.036,1975,8889,11165,10864,1646,25,25
4,2.5,2260,5824,2,0,0,3,8,2260,0,47.3496,-122.042,2240,5561,8084,7801,2260,8,8
4,2.5,2835,6598,2,0,0,3,8,2835,0,47.3878,-122.034,2770,6969,9433,9739,2835,17,17
3,1.75,1810,41800,1,0,0,5,7,1210,600,47.4109,-121.958,1650,135036,43610,136686,1810,39,39
3,1.5,1250,219978,1,0,0,4,6,1250,0,47.4056,-121.955,1930,210394,221228,212324,1250,39,39
4,2.5,2960,6219,2,0,0,3,9,2960,0,47.3603,-122.037,2960,5361,9179,8321,2960,13,13
4,2.75,2420,39704,1,0,0,3,9,2420,0,47.4053,-122.03,2760,36303,42124,39063,2420,34,34
3,2.5,2340,59058,1,0,0,3,8,2340,0,47.4052,-122.028,2700,37263,61398,39963,2340,34,34
5,2.75,2710,4685,2,0,0,3,8,2710,0,47.3555,-122.062,2710,4449,7395,7159,2710,5,5
4,2.5,1980,9757,2,0,0,5,7,1980,0,47.3675,-122.019,1610,6147,11737,7757,1980,24,24
3,2.5,2370,4375,2,0,0,3,8,2370,0,47.354,-121.999,2380,4606,6745,6986,2370,13,13
4,2.5,2340,8990,2,0,0,3,8,2340,0,47.3781,-122.03,2980,6718,11330,9698,2340,16,16
3,2.5,1690,4533,2,0,0,3,7,1690,0,47.3575,-122.016,1830,5175,6223,7005,1690,16,16
4,2.5,2440,4000,2,0,0,3,7,2440,0,47.3841,-122.036,2410,4502,6440,6912,2440,10,10
3,1.75,1350,7686,1,0,0,3,7,1350,0,47.3617,-122.052,1370,7686,9036,9056,1350,32,32
4,2.5,1630,4473,2,0,0,3,7,1630,0,47.3546,-122.015,1830,5082,6103,6912,1630,16,16
3,3.25,3660,66211,2,0,0,3,10,3660,0,47.4087,-122.062,3660,107153,69871,110813,3660,16,16
3,1.75,1260,7362,1,0,0,3,7,1260,0,47.3602,-122.052,1530,7232,8622,8762,1260,35,35
3,1.5,1920,61014,1,0,0,3,6,1920,0,47.4446,-122.074,1616,61014,62934,62630,1920,66,66
4,2.5,2070,4500,2,0,0,3,7,2070,0,47.3497,-122.026,2760,5173,6570,7933,2070,15,15
3,1.5,1530,7500,1,0,0,3,7,1530,0,47.3639,-122.055,2080,11250,9030,13330,1530,33,33
3,2.5,1610,5024,2,0,0,3,7,1610,0,47.3833,-122.043,1790,3717,6634,5507,1610,15,15
3,1.75,1180,21275,1,0,0,4,6,1180,0,47.4018,-122.037,1490,35100,22455,36590,1180,61,61
3,2.5,1690,5175,2,0,0,3,7,1690,0,47.3564,-122.016,1830,5175,6865,7005,1690,17,17
3,2,1310,6265,1,0,0,3,7,1310,0,47.3893,-122.051,1100,6360,7575,7460,1310,31,31
3,2.5,1670,4220,2,0,0,3,7,1670,0,47.3834,-122.028,1670,4238,5890,5908,1670,17,17
3,2.75,2670,4800,2,0,0,3,8,2670,0,47.3483,-122.042,2340,5000,7470,7340,2670,5,5
3,2.5,1600,7000,2,0,0,4,8,1600,0,47.3534,-122.057,1700,7000,8600,8700,1600,26,26
4,2.5,2980,10179,2,0,2,3,9,2980,0,47.3895,-122.033,2980,8828,13159,11808,2980,16,16
3,2.5,2370,4200,2,0,0,3,8,2370,0,47.3699,-122.019,2370,4370,6570,6740,2370,5,5
4,2.5,2090,4200,2,0,0,3,7,2090,0,47.3659,-122.017,2090,4200,6290,6290,2090,12,12
4,2,2180,8800,1,0,0,5,7,1170,1010,47.3676,-122.046,1630,8800,10980,10430,2180,42,42
4,2.5,2530,5048,2,0,0,3,8,2530,0,47.3559,-122.063,2530,4359,7578,6889,2530,5,5
3,1.75,2040,12065,1,0,0,3,8,2040,0,47.3756,-122.044,2010,11717,14105,13727,2040,32,32
3,1.5,1450,4694,2,0,0,3,7,1450,0,47.3654,-122.021,1870,4198,6144,6068,1450,8,8
3,1.75,1590,7620,1,0,0,4,7,1090,500,47.3655,-122.048,1590,7620,9210,9210,1590,35,35
3,1.75,1870,40250,1,0,0,5,7,1870,0,47.4038,-122.036,1870,40250,42120,42120,1870,60,60
3,2,1700,6498,1,0,0,3,7,1700,0,47.3781,-122.044,1700,6654,8198,8354,1700,33,33
3,2.25,1450,4040,2,0,0,3,7,1450,0,47.3665,-122.022,1610,4040,5490,5650,1450,9,9
4,2.5,2850,4650,2,0,0,3,8,2850,0,47.3552,-122.026,2850,4650,7500,7500,2850,15,15
3,2.5,1650,4725,2,0,0,3,8,1650,0,47.3548,-122.055,2000,4725,6375,6725,1650,8,8
2,2,1420,5185,1,0,0,3,7,1420,0,47.3543,-122.022,2140,4890,6605,7030,1420,15,15
3,2.25,2140,10256,2,0,0,3,8,2140,0,47.3751,-122.044,2040,11717,12396,13757,2140,32,32
3,2.5,1560,4244,2,0,0,3,7,1560,0,47.3834,-122.027,1670,4251,5804,5921,1560,17,17
3,2.5,1560,4200,2,0,0,3,7,1560,0,47.3838,-122.026,1560,4200,5760,5760,1560,16,16
3,2.5,1750,4076,2,0,0,3,7,1750,0,47.3597,-122.045,1810,4090,5826,5900,1750,6,6
4,2.5,2811,7251,2,0,0,3,9,2811,0,47.3686,-122.058,3040,7250,10062,10290,2811,10,10
4,3,2750,7965,2,0,0,3,9,2750,0,47.3479,-122.028,2750,6000,10715,8750,2750,7,7
4,2.5,3060,6000,2,0,0,3,9,3060,0,47.3689,-122.058,3040,6000,9060,9040,3060,7,7
4,2.5,2690,46609,2,0,0,3,8,2690,0,47.3843,-122.006,1500,34800,49299,36300,2690,39,23
4,2.5,2910,7631,2,0,2,3,9,2910,0,47.3552,-122.001,3190,5552,10541,8742,2910,13,13
4,2.5,2180,5367,2,0,0,3,7,2180,0,47.3775,-122.022,2180,5130,7547,7310,2180,19,19
2,1.75,910,2693,1,0,0,3,6,910,0,47.3493,-122.025,1360,2693,3603,4053,910,16,16
3,2.5,3100,100188,1,0,0,4,7,1820,1280,47.3928,-122.066,2430,104979,103288,107409,3100,38,38
2,1.75,1210,9750,1,0,0,3,7,1210,0,47.3438,-122.037,1650,9750,10960,11400,1210,35,35
3,2.5,2240,6097,2,0,0,3,8,2240,0,47.3503,-122.042,2240,5574,8337,7814,2240,17,17
3,2.25,1800,10500,2,0,0,3,7,1800,0,47.3879,-122.032,1870,8555,12300,10425,1800,24,24
3,2.5,1960,3540,2,0,0,3,8,1960,0,47.3568,-122.055,1840,3825,5500,5665,1960,7,7
4,2.5,2000,10051,2,0,0,3,7,2000,0,47.3625,-122.025,2000,6686,12051,8686,2000,22,22
4,2.75,2810,5046,2,0,0,3,9,2810,0,47.3559,-122.022,3060,4934,7856,7994,2810,5,5
3,2.5,3090,67082,2,0,0,3,9,3090,0,47.4032,-122.023,3650,62290,70172,65940,3090,29,29
4,2.25,2360,6260,2,0,0,3,7,2360,0,47.3882,-122.053,2144,6773,8620,8917,2360,21,21
3,2.5,1600,7936,2,0,0,3,7,1600,0,47.3673,-122.017,1830,7936,9536,9766,1600,23,23
3,2.75,2170,8396,2,0,0,3,7,2170,0,47.3812,-122.023,2170,8378,10566,10548,2170,24,24
3,2.5,1860,415126,2,0,0,3,7,1860,0,47.3974,-122.005,2070,54014,416986,56084,1860,13,13
3,2,1440,5457,2,0,0,3,7,1440,0,47.3784,-122.046,1480,6286,6897,7766,1440,33,33
4,2.5,2640,7388,2,0,0,3,7,2640,0,47.3505,-122.027,2640,6383,10028,9023,2640,16,16
3,2.5,1540,7120,1,0,0,3,7,770,770,47.3729,-122.037,1000,6638,8660,7638,1540,81,2
3,2.25,1654,8479,2,0,0,3,7,1654,0,47.3627,-122.037,1654,8479,10133,10133,1654,24,24
5,2.75,3750,12077,2,0,4,3,10,3750,0,47.3525,-122.002,3120,7255,15827,10375,3750,14,14
4,4.75,5230,89298,2,0,0,3,11,5230,0,47.4097,-122.063,4110,107153,94528,111263,5230,17,17
3,1.75,1760,6500,1,0,0,3,7,1150,610,47.3647,-122.05,1760,8125,8260,9885,1760,32,32
4,2.5,1830,4694,2,0,0,3,7,1830,0,47.3573,-122.016,1830,5175,6524,7005,1830,16,16
3,2.25,1800,15903,1,0,0,3,8,1340,460,47.3813,-122.043,2000,15233,17703,17233,1800,33,33
5,2.5,4320,107157,1,0,0,4,8,2160,2160,47.4009,-122.059,2480,107157,111477,109637,4320,52,52
5,3,3610,9775,2,0,0,3,8,3610,0,47.3545,-122.011,2800,8582,13385,11382,3610,16,16
3,3,3730,383328,1,0,0,4,9,2230,1500,47.4257,-122.03,1940,217800,387058,219740,3730,29,29
3,2.5,3310,387684,1,0,0,3,8,2160,1150,47.4167,-121.936,2340,189050,390994,191390,3310,100,19
3,3,1590,7750,1,0,0,3,7,1060,530,47.3624,-122.045,1680,7500,9340,9180,1590,22,22
3,1.75,1530,7930,1,0,0,5,7,1530,0,47.3609,-122.05,1610,7930,9460,9540,1530,33,33
4,2.25,1660,3200,2,0,0,3,7,1660,0,47.3666,-122.019,1960,3558,4860,5518,1660,8,8
4,2.5,2480,8563,2,0,0,3,8,2480,0,47.381,-122.033,2460,8660,11043,11120,2480,27,27
4,2.5,2245,4330,2,0,0,3,8,2245,0,47.3557,-122.063,2530,4478,6575,7008,2245,5,5
4,2.5,2560,5800,2,0,0,3,9,2560,0,47.3474,-122.025,3040,5800,8360,8840,2560,14,14
2,2,1310,2550,2,0,0,3,6,1310,0,47.3496,-122.022,1310,2550,3860,3860,1310,15,15
4,2.5,1830,4500,2,0,0,3,7,1830,0,47.3504,-122.005,2080,5100,6330,7180,1830,15,15
5,3.25,3620,4650,2,0,0,3,8,2790,830,47.3552,-122.026,2850,4650,8270,7500,3620,15,15
3,2.5,2620,8403,2,0,0,3,8,2620,0,47.3675,-122.042,2190,7842,11023,10032,2620,28,28
4,2.5,2560,4020,2,0,0,3,9,2560,0,47.3533,-122.027,3010,4916,6580,7926,2560,13,13
4,2.5,2050,4953,2,0,0,3,9,2050,0,47.3448,-122.024,2340,6175,7003,8515,2050,5,5
3,2.25,1420,8549,2,0,0,4,7,1420,0,47.3576,-122.039,1560,7471,9969,9031,1420,30,30
3,2.5,2070,4689,2,0,0,3,8,2070,0,47.3545,-122.056,1880,4593,6759,6473,2070,6,6
4,2.5,2280,3800,2,0,0,3,7,2280,0,47.3586,-122.036,2630,4045,6080,6675,2280,13,13
3,2.5,2540,4760,2,0,0,3,8,2540,0,47.3452,-122.022,2540,4571,7300,7111,2540,9,9
2,1.5,1680,17400,1,0,0,3,7,1680,0,47.3836,-122.006,1610,27600,19080,29210,1680,28,28
3,2.5,1530,6000,2,0,0,4,7,1530,0,47.3487,-122.036,1360,6000,7530,7360,1530,28,28
3,3.5,3580,95832,1,0,0,3,9,3580,0,47.4239,-122.015,2880,60548,99412,63428,3580,14,14
4,3,2810,6000,2,0,0,3,9,2810,0,47.3689,-122.057,2790,6000,8810,8790,2810,12,12
4,2.75,3000,213008,1,0,0,4,8,3000,0,47.4032,-121.982,2300,74191,216008,76491,3000,44,44
4,2.5,1970,7098,2,0,0,3,7,1970,0,47.3576,-122.058,1970,5361,9068,7331,1970,12,12
4,2.5,2250,5306,2,0,0,3,8,2250,0,47.356,-122.057,2250,5306,7556,7556,2250,7,7
4,2.5,2040,5770,2,0,0,3,7,2040,0,47.3522,-122.059,1570,6753,7810,8323,2040,25,25
3,2.25,1620,7566,2,0,0,3,7,1620,0,47.3566,-122.039,1470,7566,9186,9036,1620,29,29
4,2.5,2750,5767,2,0,0,3,9,2750,0,47.3595,-122.038,2800,5376,8517,8176,2750,14,14
3,2,2510,35255,1,0,2,3,9,2510,0,47.4012,-122.025,3140,36450,37765,39590,2510,25,25
4,2.5,2020,3600,2,0,0,3,7,2020,0,47.3535,-122.017,2210,3800,5620,6010,2020,7,7
4,2.5,3200,6691,2,0,0,3,7,3200,0,47.367,-122.031,2610,6510,9891,9120,3200,17,17
4,2.5,2980,8786,2,0,0,3,8,2980,0,47.378,-122.03,2980,6718,11766,9698,2980,16,16
4,3.25,3230,4838,2,0,0,3,9,3230,0,47.3559,-122.023,2980,5094,8068,8074,3230,5,5
4,2.5,2920,24074,2,0,0,3,9,2920,0,47.381,-122.056,2760,26023,26994,28783,2920,22,22
2,2,1360,3300,2,0,0,3,6,1360,0,47.3489,-122.022,1310,3300,4660,4610,1360,15,15
4,2.5,2000,5500,2,0,0,3,8,2000,0,47.3552,-122.014,2000,5512,7500,7512,2000,16,16
4,2.5,3170,186436,2,0,0,3,9,3170,0,47.4475,-122.034,3250,215186,189606,218436,3170,19,19
3,2.5,1750,6725,1,0,0,3,7,1330,420,47.352,-122.058,1670,7744,8475,9414,1750,26,26
3,2.5,1600,4271,2,0,0,3,7,1600,0,47.386,-122.036,1520,3225,5871,4745,1600,16,16
4,2.5,2560,43560,2,0,0,3,8,2560,0,47.3692,-122.047,2130,10150,46120,12280,2560,30,30
3,2.5,2350,5100,2,0,0,3,8,2350,0,47.3512,-122.008,2350,5363,7450,7713,2350,16,16
4,2.5,2500,5264,2,0,0,3,7,2500,0,47.3853,-122.028,1960,5250,7764,7210,2500,16,16
4,3,4180,35169,2,0,0,3,11,4180,0,47.4,-122.027,3010,35190,39349,38200,4180,33,16
3,2.5,1690,7165,2,0,0,4,7,1690,0,47.3498,-122.058,1410,8590,8855,10000,1690,27,27
4,3.5,2840,40139,1,0,4,4,10,2840,0,47.401,-122.026,3180,36852,42979,40032,2840,33,33
4,2.25,1550,7579,2,0,0,3,8,1550,0,47.354,-122.047,1630,6397,9129,8027,1550,26,26
4,2.5,1930,8458,2,0,0,3,7,1930,0,47.3645,-122.039,1670,9485,10388,11155,1930,26,26
3,2.5,2080,167270,1,0,0,3,7,2080,0,47.4032,-121.963,2080,55321,169350,57401,2080,19,19
4,2.5,1700,6675,2,0,0,3,7,1700,0,47.3638,-122.053,1570,7540,8375,9110,1700,22,22
4,2.5,2320,4142,2,0,0,3,7,2320,0,47.3662,-122.019,2150,4140,6462,6290,2320,9,9
4,2.5,4040,25752,2,0,0,3,10,4040,0,47.4579,-122.068,3230,22247,29792,25477,4040,19,19
4,2.5,1880,7965,2,0,0,3,7,1880,0,47.3642,-122.052,1570,7584,9845,9154,1880,19,19
4,2.5,4060,8547,2,0,0,3,9,2790,1270,47.3694,-122.056,2810,8313,12607,11123,4060,12,12
2,1.5,1050,3419,2,0,0,3,7,1050,0,47.3848,-122.039,1050,3417,4469,4467,1050,23,23
3,3,1850,19966,1,0,0,4,7,1090,760,47.3493,-122.034,1410,6715,21816,8125,1850,27,27
3,1.75,1520,15090,1,0,0,4,7,1520,0,47.398,-121.964,1580,18618,16610,20198,1520,51,51
4,2.5,3420,115434,2,0,0,3,9,3420,0,47.3932,-121.988,3250,111513,118854,114763,3420,30,30
4,2.5,1830,5175,2,0,0,3,7,1830,0,47.3565,-122.016,1830,5175,7005,7005,1830,16,16
3,2,1590,8100,1,0,0,3,7,1060,530,47.3611,-122.047,1590,8100,9690,9690,1590,23,23
3,1,1200,7810,1,0,0,4,7,1200,0,47.3631,-122.05,1590,7800,9010,9390,1200,52,52
3,2.25,2110,13300,2,0,0,4,8,2110,0,47.3725,-122.06,2470,14000,15410,16470,2110,34,34
3,2.5,1830,13042,2,0,0,3,8,1830,0,47.3738,-122.042,1940,6996,14872,8936,1830,29,29
3,2.5,2530,16102,2,0,0,3,9,2530,0,47.371,-122.055,2370,14957,18632,17327,2530,30,30
4,2.5,2400,6053,2,0,0,3,8,2400,0,47.3869,-122.033,2460,6519,8453,8979,2400,18,18
4,3,2800,7198,2,0,0,3,8,2800,0,47.3538,-122.013,3610,7845,9998,11455,2800,17,17
3,2.5,1780,4650,2,0,0,3,7,1780,0,47.386,-122.047,3050,3848,6430,6898,1780,8,8
3,2.5,2190,5071,2,0,0,3,8,2190,0,47.3506,-122.04,2300,5654,7261,7954,2190,15,15
3,2.5,2020,4183,2,0,0,3,7,2020,0,47.3658,-122.017,2030,4140,6203,6170,2020,7,7
2,1,830,2699,1,0,0,3,7,830,0,47.3839,-122.038,1030,3574,3529,4604,830,23,23
4,2.25,1600,6202,2,0,0,4,7,1600,0,47.3784,-122.046,1530,6298,7802,7828,1600,33,33
3,2.5,2470,4948,2,0,0,3,8,2470,0,47.3438,-122.039,2500,4993,7418,7493,2470,16,16
3,2.5,2370,4324,2,0,0,3,8,2370,0,47.3515,-121.999,2370,4348,6694,6718,2370,13,13
4,2.5,1860,6325,2,0,0,4,7,1860,0,47.3492,-122.03,1860,6449,8185,8309,1860,28,28
3,1.75,1380,7500,1,0,0,3,7,1380,0,47.3628,-122.045,1530,7500,8880,9030,1380,31,31
3,2.25,1654,8464,2,0,0,3,7,1654,0,47.3618,-122.033,1975,8515,10118,10490,1654,24,24
4,3,2430,7163,2,0,0,3,8,2430,0,47.3558,-122.013,2430,6028,9593,8458,2430,16,16
3,2.5,1520,4170,2,0,0,3,7,1520,0,47.3842,-122.04,1560,4237,5690,5797,1520,15,15
4,2.5,1830,8601,2,0,0,3,7,1830,0,47.3576,-122.016,1830,5184,10431,7014,1830,16,16
4,2.25,2200,3404,2,0,0,3,8,2200,0,47.3895,-122.034,2200,3449,5604,5649,2200,14,14
4,2.5,1620,4000,2,0,0,3,7,1620,0,47.3661,-122.02,1580,3780,5620,5360,1620,11,11
3,2.25,1700,8100,1,0,0,3,7,1200,500,47.3601,-122.046,1700,8100,9800,9800,1700,39,39
5,3,3640,6930,2,0,0,3,8,3640,0,47.3521,-122.012,3740,7182,10570,10922,3640,15,15
2,1,1220,75794,1,0,0,4,7,1220,0,47.4219,-122.007,2010,98010,77014,100020,1220,56,56
3,2.25,1340,7202,2,0,0,4,7,1340,0,47.3563,-122.039,1470,7395,8542,8865,1340,30,30
4,2.5,2350,5100,2,0,0,3,8,2350,0,47.3507,-122.007,2190,5100,7450,7290,2350,16,16
3,2,1730,38884,1,0,0,3,8,1730,0,47.4164,-121.951,2130,91040,40614,93170,1730,22,22
4,2.75,1940,6555,2,0,0,3,8,1940,0,47.3701,-122.041,1840,6912,8495,8752,1940,29,29
3,2.25,1860,11227,2,0,0,3,7,1860,0,47.3879,-122.031,1820,8800,13087,10620,1860,24,24
3,2.25,1870,5876,2,0,0,3,7,1870,0,47.3779,-122.045,1670,6203,7746,7873,1870,33,33
4,2.5,3580,97574,2,0,0,3,9,3580,0,47.3901,-122.071,2510,27068,101154,29578,3580,15,15
4,2.5,1830,5612,2,0,0,3,7,1830,0,47.3572,-122.015,1830,5998,7442,7828,1830,16,16
3,1.75,1590,27200,1,0,0,4,6,1590,0,47.4238,-122.052,1820,74052,28790,75872,1590,93,93
3,2,2570,233481,1,0,0,4,8,2570,0,47.4199,-122.034,2280,157687,236051,159967,2570,33,33
4,2.5,1975,8734,2,0,0,3,7,1975,0,47.363,-122.034,1975,8538,10709,10513,1975,23,23
1,1,670,7957,1,0,0,4,6,670,0,47.3594,-122.056,1600,7957,8627,9557,670,41,41
4,2.5,1820,7930,2,0,0,5,7,1820,0,47.359,-122.05,1490,7930,9750,9420,1820,30,30
3,2.5,1620,7686,2,0,0,3,7,1620,0,47.3613,-122.053,1370,7686,9306,9056,1620,30,30
3,2.5,2210,6280,2,0,0,3,8,2210,0,47.35,-122.043,2250,5972,8490,8222,2210,16,16
3,2.5,1780,7859,2,0,0,3,7,1780,0,47.3772,-122.045,1670,6618,9639,8288,1780,31,31
3,2.5,2370,5321,2,0,0,3,8,2370,0,47.37,-122.019,2370,4357,7691,6727,2370,5,5
4,2.5,1780,3600,2,0,0,3,7,1780,0,47.3665,-122.017,2020,3802,5380,5822,1780,13,13
3,2.5,1740,5267,2,0,0,3,7,1740,0,47.3777,-122.023,2180,5000,7007,7180,1740,20,20
3,2.25,1646,7364,2,0,0,3,7,1646,0,47.3646,-122.037,1975,9161,9010,11136,1646,25,25
4,3.5,3400,5222,2,0,0,3,9,3400,0,47.3559,-122,3190,5326,8622,8516,3400,14,14
3,2.5,2370,4200,2,0,0,3,8,2370,0,47.3696,-122.018,2370,4200,6570,6570,2370,5,5
2,2.5,1360,2693,2,0,0,3,6,1360,0,47.3492,-122.025,1360,2693,4053,4053,1360,16,16
3,2.5,1860,5025,2,0,0,3,8,1860,0,47.3557,-122.059,2000,5550,6885,7550,1860,9,9
4,2.5,2300,4249,2,0,0,3,8,2300,0,47.3516,-122,2390,4385,6549,6775,2300,13,13
3,2.5,1660,7388,2,0,0,3,7,1660,0,47.3865,-122.027,2240,6228,9048,8468,1660,16,16
4,2.5,2610,4978,2,0,0,3,8,2610,0,47.3438,-122.04,2470,5024,7588,7494,2610,15,15
5,3.25,3910,7077,2,0,0,3,9,2710,1200,47.3766,-122.027,2650,7077,10987,9727,3910,19,19
3,2.5,3580,54450,1,0,0,3,9,3580,0,47.4026,-122.033,3090,35943,58030,39033,3580,29,29
5,2.5,2090,4698,2,0,0,3,7,2090,0,47.3538,-122.025,2070,4698,6788,6768,2090,21,21
2,1.75,1320,7540,1,0,0,3,7,1320,0,47.3634,-122.052,1570,7540,8860,9110,1320,51,51
3,2.5,1660,4083,2,0,0,3,7,1660,0,47.3595,-122.045,1800,4087,5743,5887,1660,6,6
3,2.25,1370,6000,2,0,0,4,7,1370,0,47.3484,-122.033,1370,6200,7370,7570,1370,27,27
4,3,2430,7243,2,0,0,3,8,2430,0,47.3533,-122.016,2430,7084,9673,9514,2430,16,16
4,2.75,4010,87555,2,0,0,3,10,4010,0,47.4299,-121.998,2451,209523,91565,211974,4010,15,15
3,1.75,1520,6559,1,0,0,4,7,1170,350,47.35,-122.037,1520,6095,8079,7615,1520,27,27
3,1,1250,53143,1,0,0,5,6,1250,0,47.4235,-122.051,1820,217800,54393,219620,1250,74,74
4,2.5,2040,109336,1,0,0,4,8,2040,0,47.4193,-121.958,2370,133729,111376,136099,2040,46,46
3,2.5,2420,10733,2,0,0,3,8,2420,0,47.3835,-122.035,1950,8534,13153,10484,2420,23,23
3,2,1640,8395,1,0,0,4,7,1640,0,47.348,-122.035,1510,7180,10035,8690,1640,28,28
3,1,1050,16050,1,0,0,4,7,1050,0,47.3841,-122.006,1610,27600,17100,29210,1050,59,33
3,2.5,1990,3644,2,0,0,3,7,1990,0,47.3531,-122.017,2580,3800,5634,6380,1990,9,9
3,2.5,1990,3614,2,0,0,3,7,1990,0,47.36,-122.039,1980,3800,5604,5780,1990,14,14
4,3,2430,5502,2,0,0,3,8,2430,0,47.356,-122.014,2000,5702,7932,7702,2430,17,17
4,2,2430,199940,1,0,0,3,8,1310,1120,47.4116,-122.029,2220,150282,202370,152502,2430,58,58
3,1.75,1060,8100,2,0,0,4,7,1060,0,47.3617,-122.047,1410,8100,9160,9510,1060,36,36
3,2.5,1610,6000,2,0,0,4,7,1610,0,47.349,-122.036,1570,6000,7610,7570,1610,26,26
5,2.75,2710,6220,2,0,0,3,8,2710,0,47.3555,-122.061,2530,4759,8930,7289,2710,5,5
2,2.5,1860,6359,2,0,0,3,7,1860,0,47.3847,-122.029,1860,6359,8219,8219,1860,16,16
4,2.5,2990,6383,2,0,0,3,7,2990,0,47.3499,-122.027,2640,6454,9373,9094,2990,16,16
4,2.5,2470,5074,2,0,0,3,8,2470,0,47.3457,-122.041,2470,5078,7544,7548,2470,15,15
4,3.25,3760,4675,2,0,0,3,8,2740,1020,47.3862,-122.048,3280,4033,8435,7313,3760,12,12
3,2.75,2660,223027,1,0,0,3,8,1330,1330,47.4127,-122.071,1560,222591,225687,224151,2660,57,0
4,2.5,2220,4720,2,0,0,3,7,2220,0,47.3541,-122.024,2090,4717,6940,6807,2220,21,21
5,2.25,2180,7813,2,0,0,3,7,2180,0,47.3651,-122.051,1880,8649,9993,10529,2180,33,33
3,2,1900,6660,1,0,0,5,7,950,950,47.3594,-122.054,1690,8111,8560,9801,1900,53,53
3,2.25,2200,16921,2,0,0,3,8,2200,0,47.3727,-122.051,2060,16921,19121,18981,2200,32,32
2,1.75,1910,3376,2,0,0,3,8,1910,0,47.3733,-122.057,1470,3623,5286,5093,1910,39,39
3,1.75,1580,9187,1,0,0,3,8,1180,400,47.3538,-122.047,1620,6397,10767,8017,1580,26,26
4,2.5,2140,7095,2,0,0,3,8,2140,0,47.3528,-122.057,1600,7182,9235,8782,2140,27,27
2,1.75,910,2550,1,0,0,3,6,910,0,47.3494,-122.022,1310,2550,3460,3860,910,15,15
3,2.5,1610,8544,2,0,0,5,7,1610,0,47.3714,-122.054,1840,8190,10154,10030,1610,25,25
3,2.25,1510,6000,1,0,0,4,7,1150,360,47.3484,-122.036,1510,6000,7510,7510,1510,26,26
3,2,1640,4714,1,0,0,3,8,1640,0,47.3539,-122.021,1770,4802,6354,6572,1640,10,10
4,2.5,3190,8195,2,0,0,3,10,3190,0,47.3555,-122.003,3400,7607,11385,11007,3190,13,13
3,1.75,1400,7735,1,0,0,4,7,1400,0,47.357,-122.04,1530,7754,9135,9284,1400,30,30
3,2.5,2420,4725,2,0,0,3,8,2420,0,47.371,-122.018,2370,4200,7145,6570,2420,5,5
4,2.5,1900,5889,2,0,0,3,7,1900,0,47.349,-122.031,1870,6405,7789,8275,1900,27,27
3,2.5,2150,161607,2,0,0,3,7,1330,820,47.4178,-121.937,2400,207781,163757,210181,2150,24,24
3,2.5,1730,6368,2,0,0,3,7,1730,0,47.3505,-122.032,1780,6597,8098,8377,1730,26,26
4,2.5,2960,5054,2,0,0,3,9,2960,0,47.3601,-122.035,2960,5000,8014,7960,2960,13,13
4,2.5,2470,5100,2,0,0,3,8,2470,0,47.3622,-122.041,2240,5123,7570,7363,2470,14,14
4,2.5,1940,7107,2,0,0,3,7,1940,0,47.3843,-122.032,1850,5705,9047,7555,1940,19,19
3,2.25,1620,6415,2,0,0,4,7,1620,0,47.3577,-122.038,1640,7253,8035,8893,1620,30,30
3,2.25,1780,7332,2,0,0,3,7,1780,0,47.3593,-122.051,1510,7625,9112,9135,1780,32,32
3,2.25,1900,7479,2,0,0,4,7,1900,0,47.3495,-122.037,1520,6559,9379,8079,1900,27,27
3,2,1280,7633,1,0,0,3,7,1280,0,47.3883,-122.05,1450,6783,8913,8233,1280,28,28
4,2.5,2820,5056,2,0,0,3,9,2820,0,47.3591,-122.038,2820,5150,7876,7970,2820,13,13
3,2.5,1780,4077,2,0,0,3,8,1780,0,47.3568,-122.056,1970,4077,5857,6047,1780,8,8
3,2,1470,2781,2,0,0,3,6,1470,0,47.349,-122.024,1360,3008,4251,4368,1470,16,16
3,2,2800,185130,1,0,0,3,8,2320,480,47.4133,-122.006,2200,72055,187930,74255,2800,23,23
4,2.5,2710,8127,2,0,0,3,8,2710,0,47.379,-122.032,2520,8436,10837,10956,2710,25,25
3,2,1960,6450,1,0,0,4,7,1000,960,47.3972,-122.029,1660,20720,8410,22380,1960,42,42
4,2.5,3910,8442,2,0,0,3,9,2710,1200,47.3766,-122.027,2650,7576,12352,10226,3910,19,19
3,2.5,2170,9900,1,0,0,3,7,1690,480,47.3634,-122.031,1420,10614,12070,12034,2170,39,39
3,2,1350,8960,1,0,0,4,7,1350,0,47.3614,-122.045,1470,8288,10310,9758,1350,33,33
4,2.75,2000,5827,2,0,0,3,7,2000,0,47.3629,-122.026,1710,6929,7827,8639,2000,22,22
4,2.5,1850,5388,2,0,0,3,8,1850,0,47.3494,-122.041,2140,5086,7238,7226,1850,10,10
3,1,1160,10384,1,0,0,4,6,1160,0,47.3634,-122.027,1200,9880,11544,11080,1160,50,50
3,2.5,1680,8284,2,0,0,3,7,1680,0,47.3609,-122.048,1550,8284,9964,9834,1680,30,30
4,2.5,1580,3632,2,0,0,3,7,1580,0,47.3672,-122.019,1950,3800,5212,5750,1580,8,8
3,2,1460,7930,1,0,0,3,7,1460,0,47.359,-122.049,1630,7930,9390,9560,1460,30,30
4,2.5,2790,4650,2,0,0,3,8,2790,0,47.3557,-122.026,2850,4650,7440,7500,2790,15,15
3,2.5,2170,4905,2,0,0,3,8,2170,0,47.3503,-122.039,2300,4935,7075,7235,2170,15,15
5,2.5,2200,6250,2,0,0,3,7,2200,0,47.3675,-122.021,1850,6091,8450,7941,2200,23,23
3,2.5,2000,7414,2,0,0,4,7,2000,0,47.3508,-122.057,2000,7414,9414,9414,2000,26,26
4,2.75,3000,5470,2,0,0,3,8,3000,0,47.3613,-122.038,2420,4891,8470,7311,3000,14,14
4,2.5,2245,4301,2,0,0,3,8,2245,0,47.3555,-122.063,2530,4478,6546,7008,2245,5,5
4,2.5,1980,7334,2,0,0,3,7,1980,0,47.3528,-122.041,1850,7134,9314,8984,1980,16,16
3,2,1470,7694,1,0,0,4,7,1470,0,47.3539,-122.054,1580,7480,9164,9060,1470,27,27
2,1.75,1800,224769,1,0,0,3,7,1420,380,47.4327,-122.06,1620,112384,226569,114004,1800,69,6
3,2.5,1450,4106,2,0,0,3,7,1450,0,47.3655,-122.019,2000,4000,5556,6000,1450,8,8
3,2,1260,8092,1,0,0,3,7,1260,0,47.3635,-122.054,1950,8092,9352,10042,1260,33,33
2,1,1030,4188,1,0,0,3,8,1030,0,47.3738,-122.057,1450,3376,5218,4826,1030,38,38
3,2.25,2680,175982,1,0,0,3,9,2680,0,47.4487,-122.033,3170,215186,178662,218356,2680,15,15
3,2,2680,8429,1,0,0,4,9,1880,800,47.372,-122.036,1570,8640,11109,10210,2680,69,23
4,2.5,2680,4500,2,0,0,3,8,2680,0,47.3561,-122.056,2010,4500,7180,6510,2680,8,8
3,3.5,2080,5100,2,0,0,3,8,2080,0,47.35,-122.005,2080,5100,7180,7180,2080,15,15
4,2.5,2000,6921,2,0,0,3,8,2000,0,47.3559,-122.014,2430,6339,8921,8769,2000,16,16
4,2.5,1840,220308,2,0,0,3,8,1840,0,47.4306,-122.049,1890,65340,222148,67230,1840,19,19
3,2.5,1990,3600,2,0,0,3,7,1990,0,47.3841,-122.041,1790,3600,5590,5390,1990,15,15
3,2.5,1460,7936,2,0,0,3,7,1460,0,47.3673,-122.017,1830,7936,9396,9766,1460,24,24
4,3.5,3200,6420,2,0,0,3,9,3200,0,47.3545,-122.001,3200,6291,9620,9491,3200,13,13
3,2.5,1560,4200,2,0,0,3,7,1560,0,47.3838,-122.026,1560,4200,5760,5760,1560,16,16
3,1.75,1590,7931,1,0,0,3,7,1190,400,47.3628,-122.05,1680,7931,9521,9611,1590,40,40
4,2.5,2580,4818,2,0,0,3,8,2580,0,47.3607,-122.038,2570,5386,7398,7956,2580,14,14
3,2.5,1860,5321,2,0,0,3,7,1860,0,47.3848,-122.033,1940,5205,7181,7145,1860,19,19
4,2.5,2790,4650,2,0,0,3,8,2790,0,47.3556,-122.026,2820,4650,7440,7470,2790,15,15
4,2.5,2890,6322,2,0,0,3,8,2890,0,47.3494,-122.044,2380,5738,9212,8118,2890,8,8
5,5,3960,94089,2,0,0,3,10,3960,0,47.38,-122.011,2240,64468,98049,66708,3960,21,21
3,1.75,1340,63597,1,0,0,4,7,1340,0,47.4379,-122.011,1950,87120,64937,89070,1340,56,56
3,1,1060,10350,1,0,0,4,7,1060,0,47.365,-122.028,1500,9660,11410,11160,1060,39,39
4,2.5,3780,6800,2,0,0,3,8,3780,0,47.3526,-122.012,3640,7326,10580,10966,3780,15,15
3,1.75,1360,15210,1,0,0,3,7,1360,0,47.3657,-122.047,1610,7800,16570,9410,1360,32,32
3,1.75,1450,5858,1,0,0,4,7,1450,0,47.3482,-122.037,1520,6573,7308,8093,1450,28,28
4,2.5,1820,6753,2,0,0,3,7,1820,0,47.3845,-122.032,1820,7107,8573,8927,1820,25,25
4,2.5,1830,7308,2,0,0,3,7,1830,0,47.3565,-122.015,1830,5692,9138,7522,1830,17,17
3,2.5,1890,3629,2,0,0,3,7,1890,0,47.3613,-122.041,1980,4000,5519,5980,1890,14,14
4,2.5,2710,35868,2,0,0,3,9,2710,0,47.375,-122.022,2780,36224,38578,39004,2710,30,30
3,2.5,2090,3821,2,0,0,3,7,2090,0,47.3655,-122.017,2040,4200,5911,6240,2090,11,11
3,2.5,2550,5349,2,0,0,3,7,2550,0,47.3504,-122.026,2640,5400,7899,8040,2550,15,15
3,2.5,1880,6047,2,0,0,3,8,1880,0,47.3722,-122.044,2120,7188,7927,9308,1880,26,26
2,2,1470,3128,2,0,0,3,6,1470,0,47.349,-122.021,1180,2576,4598,3756,1470,14,14
3,2.25,1490,7589,2,0,0,3,7,1490,0,47.3474,-122.037,1510,6603,9079,8113,1490,26,26
3,1.75,1940,219527,1,0,0,3,7,1940,0,47.4214,-122.02,2060,108900,221467,110960,1940,28,28
4,2.5,1980,7264,2,0,0,3,7,1980,0,47.3678,-122.019,1600,6380,9244,7980,1980,23,23
4,2.25,1800,5555,2,0,0,3,7,1800,0,47.3498,-122.052,1810,5669,7355,7479,1800,16,16
3,2.25,2020,8379,2,0,0,3,7,2020,0,47.3828,-122.023,2020,8031,10399,10051,2020,25,25
4,2.5,2610,5866,2,0,0,3,8,2610,0,47.3441,-122.04,2480,5188,8476,7668,2610,14,14
4,2.5,2650,6000,2,0,0,3,9,2650,0,47.3768,-122.028,2630,6381,8650,9011,2650,19,19
3,2.5,1700,7000,2,0,0,3,7,1700,0,47.3798,-122.025,1950,7000,8700,8950,1700,23,23
4,2.5,3200,7545,2,0,0,3,7,3200,0,47.3666,-122.03,2840,7137,10745,9977,3200,16,16
3,2.5,2060,4200,2,0,0,3,8,2060,0,47.3706,-122.017,2370,4200,6260,6570,2060,5,5
3,2.5,1580,4698,2,0,0,3,7,1580,0,47.3539,-122.025,2070,4698,6278,6768,1580,21,21
3,3,1530,2132,2,0,0,3,8,1530,0,47.3746,-122.056,1530,3384,3662,4914,1530,26,26
3,1.5,1900,43186,1,0,0,4,7,1300,600,47.4199,-121.99,2080,108028,45086,110108,1900,48,48
4,2.5,1920,7345,2,0,0,3,8,1920,0,47.3526,-122.055,1860,7364,9265,9224,1920,27,27
3,2,1970,7000,1,0,0,3,8,1970,0,47.3744,-122.043,1970,7365,8970,9335,1970,33,33
4,2.75,2420,6495,2,0,0,3,8,2420,0,47.3771,-122.029,2420,6200,8915,8620,2420,14,14
4,2.5,3440,6915,2,0,0,3,10,3440,0,47.3538,-122.004,3200,6915,10355,10115,3440,13,13
4,2.5,2800,8494,2,0,0,3,8,2800,0,47.3521,-122.009,3740,8494,11294,12234,2800,15,15
3,2.5,1690,8564,2,0,0,4,7,1690,0,47.3518,-122.057,1690,7532,10254,9222,1690,27,27
4,5.25,6500,14986,2,0,0,3,11,5180,1320,47.6304,-122.236,2270,8119,21486,10389,6500,18,18
2,2.25,2950,15593,1,0,0,4,8,1560,1390,47.6209,-122.236,2060,19855,18543,21915,2950,77,28
4,3.25,4040,18916,1,0,0,4,9,4040,0,47.6155,-122.238,3000,18831,22956,21831,4040,65,65
3,2,3570,30456,1,0,1,3,8,2070,1500,47.6413,-122.24,3570,27418,34026,30988,3570,73,32
4,2.25,2350,17709,2,0,0,4,9,2350,0,47.6232,-122.236,3360,19855,20059,23215,2350,42,42
4,3.5,4860,23885,2,0,0,3,12,4860,0,47.6172,-122.23,3580,16054,28745,19634,4860,23,23
5,2.5,2660,6572,1,0,0,5,9,1960,700,47.6176,-122.223,3960,14595,9232,18555,2660,60,60
3,1,1220,8119,1,0,0,4,7,1220,0,47.6328,-122.236,1910,8119,9339,10029,1220,64,64
4,3.5,4460,16953,1,0,0,3,9,2550,1910,47.6338,-122.232,1980,13370,21413,15350,4460,57,20
4,3,2680,15438,2,0,2,3,8,2680,0,47.6109,-122.226,4480,14406,18118,18886,2680,117,59
5,2.75,3090,19865,1,0,0,4,9,3090,0,47.6232,-122.235,2970,19862,22955,22832,3090,66,66
4,3.25,3640,13530,1,0,0,3,9,2570,1070,47.6293,-122.238,2760,15000,17170,17760,3640,95,15
4,2.5,2740,16007,2,0,0,3,9,2740,0,47.6353,-122.229,2760,16008,18747,18768,2740,35,35
3,1,1220,8119,1,0,0,4,7,1220,0,47.6328,-122.236,1910,8119,9339,10029,1220,64,64
3,2.5,3110,9930,1,0,1,3,8,1640,1470,47.6112,-122.226,3650,14399,13040,18049,3110,65,65
3,1,1320,8500,1,0,0,4,7,1320,0,47.6187,-122.226,2790,10800,9820,13590,1320,65,65
4,3.5,5550,28078,2,0,2,4,12,3350,2200,47.6395,-122.234,2980,19602,33628,22582,5550,19,19
3,2.75,2620,17919,1,0,1,4,9,2620,0,47.6144,-122.228,3400,14400,20539,17800,2620,70,70
4,3,2150,8119,2,0,0,3,8,2150,0,47.6335,-122.236,1590,8119,10269,9709,2150,66,11
5,5.75,9200,35069,2,0,0,3,13,6200,3000,47.6289,-122.233,3560,24345,44269,27905,9200,18,18
7,4.25,4670,23115,2,0,2,3,11,4670,0,47.6183,-122.227,3240,13912,27785,17152,4670,27,27
5,6,5490,19897,2,0,0,3,12,5490,0,47.6165,-122.236,2910,17600,25387,20510,5490,14,14
3,1.5,1530,10827,1,0,0,4,8,1530,0,47.6354,-122.234,2050,10827,12357,12877,1530,64,64
5,2.5,2870,16238,2,0,0,4,8,2870,0,47.6308,-122.238,2870,16238,19108,19108,2870,57,57
4,3.5,4065,18713,2,0,0,4,10,4065,0,47.6209,-122.237,3070,18713,22778,21783,4065,32,32
4,2.75,3260,19542,1,0,0,4,10,2170,1090,47.6245,-122.236,3480,19863,22802,23343,3260,51,51
4,2.25,2580,21115,2,0,0,4,9,2580,0,47.5566,-122.219,2690,10165,23695,12855,2580,42,42
4,3,2720,11740,1,0,0,5,9,2720,0,47.5833,-122.242,2640,11740,14460,14380,2720,62,62
3,2,1550,12262,1,0,0,4,7,1550,0,47.5755,-122.216,2900,12372,13812,15272,1550,55,55
4,3.5,4300,8406,2,0,1,3,11,3580,720,47.5396,-122.214,2770,10006,12706,12776,4300,32,32
3,1.75,1890,10292,1,0,0,4,8,1890,0,47.535,-122.234,2630,10625,12182,13255,1890,50,50
4,4.25,4890,15188,2,0,2,3,11,3090,1800,47.5602,-122.227,3470,16201,20078,19671,4890,20,20
5,3.75,3490,15246,1,0,1,4,10,1940,1550,47.5479,-122.212,3410,15682,18736,19092,3490,51,51
3,1.5,1680,13751,1,0,0,4,7,1680,0,47.5716,-122.227,1760,13500,15431,15260,1680,68,68
5,6.75,9640,13068,1,1,4,3,12,4820,4820,47.557,-122.21,3270,10454,22708,13724,9640,36,5
5,5.25,4830,18707,2,0,1,5,9,3930,900,47.5858,-122.247,2880,10520,23537,13400,4830,67,16
5,2.25,2510,9887,2,0,0,3,8,2510,0,47.5339,-122.223,2510,10006,12397,12516,2510,47,47
4,2.25,3080,10487,2,0,0,4,9,3080,0,47.5344,-122.224,2480,10607,13567,13087,3080,51,51
4,3.5,4390,11600,2,0,3,3,11,3060,1330,47.5862,-122.246,3240,12000,15990,15240,4390,29,29
4,4.5,5550,16065,2,0,0,3,9,3880,1670,47.5455,-122.214,3470,16488,21615,19958,5550,16,16
4,2,2490,9525,2,0,0,5,9,2490,0,47.5639,-122.217,2770,9525,12015,12295,2490,51,51
4,2.75,3950,12840,2,0,0,5,8,3950,0,47.5489,-122.219,2350,12507,16790,14857,3950,59,59
5,4.75,5780,17004,2,0,0,3,11,4260,1520,47.5802,-122.212,3460,10855,22784,14315,5780,13,13
5,2.75,2520,16100,1,0,3,4,8,1570,950,47.528,-122.224,2760,16988,18620,19748,2520,59,59
4,1.75,2480,11010,1,0,0,4,9,1630,850,47.5378,-122.219,2770,10744,13490,13514,2480,53,53
3,2.75,3050,44867,1,0,4,3,9,2330,720,47.5316,-122.233,4110,20336,47917,24446,3050,51,51
3,2,1870,9527,1,0,0,4,7,1870,0,47.5777,-122.224,1970,11904,11397,13874,1870,68,17
4,2.25,2240,9684,2,0,0,4,9,2240,0,47.5489,-122.225,2440,9618,11924,12058,2240,49,49
7,3.5,4640,15235,2,0,1,3,11,2860,1780,47.5666,-122.231,3230,20697,19875,23927,4640,54,11
4,3.75,4520,9240,1,0,2,3,10,3270,1250,47.5897,-122.229,3380,9240,13760,12620,4520,27,27
4,2.5,3440,23954,1,1,3,5,10,2260,1180,47.5636,-122.231,4230,18723,27394,22953,3440,88,88
5,3.75,4220,9240,2,0,2,5,11,3420,800,47.5895,-122.229,3380,9240,13460,12620,4220,28,28
5,4,4440,9270,1,0,0,5,10,2220,2220,47.5708,-122.212,2720,9614,13710,12334,4440,51,51
4,2,2530,10800,1,0,0,5,8,1350,1180,47.5705,-122.225,2960,12150,13330,15110,2530,65,65
5,2.75,2540,8250,1,0,0,4,7,1440,1100,47.5875,-122.24,2540,11000,10790,13540,2540,66,66
3,2.5,2190,10000,1,0,0,4,7,1540,650,47.5419,-122.214,2880,11782,12190,14662,2190,62,62
3,1,1300,6710,1,0,0,4,6,1300,0,47.5851,-122.242,1630,9946,8010,11576,1300,67,67
4,3.5,4440,20668,2,0,2,5,10,3240,1200,47.5472,-122.235,4240,18650,25108,22890,4440,54,54
4,2.5,2270,13449,1,0,0,4,9,1310,960,47.5416,-122.232,2810,13475,15719,16285,2270,44,44
4,2.5,3180,11652,2,0,1,3,9,3180,0,47.567,-122.212,3110,15183,14832,18293,3180,42,42
3,1.75,1650,8400,1,0,0,3,8,1470,180,47.5766,-122.236,2020,7777,10050,9797,1650,60,60
4,2.5,2790,15653,2,0,0,4,10,2790,0,47.5477,-122.215,3520,15653,18443,19173,2790,55,55
5,2.5,2490,9639,1,0,0,4,8,1610,880,47.551,-122.22,2290,9958,12129,12248,2490,60,60
4,2.25,3270,15760,1,0,0,4,10,2000,1270,47.5295,-122.229,4100,15760,19030,19860,3270,45,45
5,3,3880,13000,2,0,0,3,10,3880,0,47.5467,-122.234,3470,13701,16880,17171,3880,47,11
4,3.75,3560,13959,2,0,0,4,9,3560,0,47.5575,-122.211,3320,11834,17519,15154,3560,47,47
3,1.75,2020,9478,1,0,0,4,9,2020,0,47.5383,-122.238,3050,15594,11498,18644,2020,58,58
3,1.5,1340,6000,1,0,0,4,7,1340,0,47.5866,-122.25,1590,9000,7340,10590,1340,59,59
4,1.75,2170,9525,1,0,0,3,8,2170,0,47.5685,-122.217,1910,9525,11695,11435,2170,59,59
5,2.5,4570,19252,2,0,0,5,10,4570,0,47.5553,-122.22,3180,13314,23822,16494,4570,54,54
5,3,3420,18129,2,0,0,3,9,2540,880,47.5333,-122.217,3750,16316,21549,20066,3420,67,9
6,4,5310,12741,2,0,2,3,10,3600,1710,47.5696,-122.213,4190,12632,18051,16822,5310,52,52
4,1.75,2350,11914,1,0,0,4,8,2350,0,47.5392,-122.228,2240,10706,14264,12946,2350,58,58
4,2.5,2450,7700,1,0,0,3,8,1250,1200,47.5731,-122.212,2450,8000,10150,10450,2450,61,61
5,3,2830,8854,1,0,0,4,8,1500,1330,47.5743,-122.209,2260,8604,11684,10864,2830,40,40
4,3,2320,7200,1,0,0,3,7,1260,1060,47.5893,-122.232,1760,7200,9520,8960,2320,76,15
4,3.25,3820,24166,2,0,1,4,11,3310,510,47.5263,-122.227,2900,18786,27986,21686,3820,29,29
4,4,5280,17677,2,0,3,3,11,3220,2060,47.5323,-122.238,3470,17474,22957,20944,5280,41,41
5,3,2876,13927,1,0,2,4,9,1970,906,47.5528,-122.229,3500,14454,16803,17954,2876,46,46
3,1.75,3330,12566,1,1,4,4,8,1940,1390,47.5287,-122.22,3730,16560,15896,20290,3330,59,59
4,2.25,3290,12329,1,0,0,4,10,3290,0,47.5639,-122.216,3170,12329,15619,15499,3290,51,51
4,3,4260,18000,2,0,2,3,11,4260,0,47.5355,-122.24,3540,17015,22260,20555,4260,19,19
3,1.75,1540,10800,1,0,0,5,6,770,770,47.5763,-122.222,2020,10800,12340,12820,1540,72,72
3,2.25,2380,11824,1,0,0,4,9,1450,930,47.5371,-122.218,2750,11491,14204,14241,2380,47,47
3,2.25,2060,9552,1,0,0,4,9,1610,450,47.5402,-122.231,2930,11212,11612,14142,2060,44,44
4,1.75,2260,17711,1,0,1,4,9,2260,0,47.5498,-122.214,2880,16594,19971,19474,2260,51,51
4,3.5,3440,9776,2,0,0,3,10,3440,0,47.5374,-122.216,2400,11000,13216,13400,3440,13,13
4,2.25,2770,13500,2,0,0,3,8,2770,0,47.543,-122.231,2300,13500,16270,15800,2770,45,45
5,3.5,4050,20925,2,0,3,3,10,3020,1030,47.5348,-122.241,3880,18321,24975,22201,4050,46,10
4,2.5,2900,10500,1,0,3,5,8,1450,1450,47.5838,-122.246,2900,9201,13400,12101,2900,56,56
3,2.25,2180,9865,1,0,0,4,8,1660,520,47.5358,-122.235,2600,10034,12045,12634,2180,53,53
5,2.25,2910,9525,2,0,0,4,9,2910,0,47.5633,-122.218,2740,9525,12435,12265,2910,51,51
5,4.75,6240,47480,1,0,3,3,11,4610,1630,47.5317,-122.233,4170,17668,53720,21838,6240,16,16
5,4.25,6510,16471,2,0,3,4,11,3250,3260,47.5758,-122.242,4480,16471,22981,20951,6510,39,39
3,2.25,2120,13644,2,0,1,4,9,1420,700,47.5574,-122.214,2950,17060,15764,20010,2120,46,46
4,2.5,3510,13100,2,0,0,4,10,3510,0,47.5306,-122.227,3230,12745,16610,15975,3510,53,53
5,2.25,3320,11350,1,0,0,5,8,1660,1660,47.5749,-122.213,3320,11085,14670,14405,3320,56,56
5,2.75,3090,12031,1,0,0,5,9,1600,1490,47.5342,-122.226,2280,10800,15121,13080,3090,51,51
3,1.75,2330,9652,1,0,0,4,8,1590,740,47.5714,-122.211,2420,9631,11982,12051,2330,51,51
4,3.75,3730,17000,2,0,3,4,10,2820,910,47.5355,-122.242,3880,15550,20730,19430,3730,33,33
5,2.25,3270,16553,2,0,2,5,9,2470,800,47.5428,-122.236,3690,17916,19823,21606,3270,51,51
5,2.75,3831,13800,2,1,4,3,9,3831,0,47.5919,-122.251,3850,36563,17631,40413,3831,60,34
4,2.25,2070,13084,1,0,0,4,8,1700,370,47.5606,-122.222,2520,10180,15154,12700,2070,52,52
5,2.75,3100,10014,1,0,2,4,9,1660,1440,47.5734,-122.213,3230,10279,13114,13509,3100,46,46
4,3.5,4330,15335,2,0,0,4,11,3230,1100,47.5315,-122.231,3840,14311,19665,18151,4330,31,31
3,2,2050,9000,1,0,0,4,7,2050,0,47.5885,-122.245,2910,8856,11050,11766,2050,68,68
5,3.5,3760,10207,2,0,0,3,10,3150,610,47.5605,-122.225,3550,12118,13967,15668,3760,50,50
4,1.75,2500,92347,1,0,0,4,8,1500,1000,47.5345,-122.216,3750,20267,94847,24017,2500,49,49
4,2.5,2260,13600,1,0,0,4,8,1770,490,47.5436,-122.233,2630,13995,15860,16625,2260,45,45
4,2.5,2410,9886,1,0,0,5,8,1990,420,47.5351,-122.223,2530,10658,12296,13188,2410,44,44
3,3.5,4240,21578,2,0,0,3,10,3500,740,47.5614,-122.215,3120,16440,25818,19560,4240,25,25
5,4.25,6490,10862,2,0,3,4,11,3940,2550,47.5728,-122.205,3290,14080,17352,17370,6490,28,28
4,2.25,2340,13406,1,0,0,4,9,2340,0,47.5377,-122.221,2340,10743,15746,13083,2340,56,56
4,2.5,3240,13044,2,0,0,4,9,3240,0,47.5825,-122.242,2920,13044,16284,15964,3240,35,35
4,3,4500,21780,2,0,2,3,9,3040,1460,47.5581,-122.213,3540,20473,26280,24013,4500,39,39
4,2.25,4250,16940,1,0,2,4,9,2380,1870,47.5453,-122.234,3460,17693,21190,21153,4250,45,45
4,3.75,3160,9525,2,0,0,3,10,3160,0,47.5623,-122.221,2400,9525,12685,11925,3160,22,22
3,4.5,5230,17826,2,1,4,3,10,3740,1490,47.5348,-122.243,3670,17826,23056,21496,5230,14,14
4,2.75,2580,8100,2,0,1,4,8,1780,800,47.5387,-122.215,2840,10006,10680,12846,2580,55,55
3,3.25,3620,8131,2,0,0,4,10,2730,890,47.5776,-122.214,2040,3776,11751,5816,3620,31,31
5,2.5,3160,8000,1,0,0,4,7,1580,1580,47.5735,-122.208,2440,8079,11160,10519,3160,59,59
5,3.25,2590,11500,1,0,2,4,9,2590,0,47.545,-122.229,2780,11989,14090,14769,2590,51,51
3,1.5,1380,4500,1,0,0,5,7,1380,0,47.5866,-122.25,1590,9000,5880,10590,1380,59,59
3,2.75,2700,22343,1,0,1,4,10,2700,0,47.5706,-122.209,3390,15682,25043,19072,2700,42,42
4,4,4050,9517,2,0,0,3,11,3360,690,47.5769,-122.215,3330,9436,13567,12766,4050,29,29
3,2.25,2950,15207,1,0,0,4,10,2070,880,47.5571,-122.216,2950,22000,18157,24950,2950,53,53
4,2.25,3020,11489,1,1,3,5,10,2110,910,47.5395,-122.21,3890,11489,14509,15379,3020,103,27
3,3,3920,13085,2,1,4,4,11,3920,0,47.5716,-122.204,3450,13287,17005,16737,3920,23,23
5,3.25,5270,17232,2,0,1,3,10,4010,1260,47.5536,-122.228,3550,13917,22502,17467,5270,42,11
4,2.25,2870,8393,1,0,0,4,8,1480,1390,47.5787,-122.245,2930,9850,11263,12780,2870,42,42
6,3.5,3720,11690,2,0,0,3,10,3720,0,47.5699,-122.226,3030,11686,15410,14716,3720,16,16
4,2.25,2420,10200,2,0,0,4,9,2420,0,47.5336,-122.225,2390,10200,12620,12590,2420,46,46
4,2.5,2360,9600,1,0,2,3,8,1630,730,47.5889,-122.249,2140,6300,11960,8440,2360,46,46
4,1.75,2180,9726,1,0,0,4,9,2180,0,47.5359,-122.233,2560,10244,11906,12804,2180,53,53
5,2.75,3050,8904,1,0,0,4,8,1650,1400,47.5709,-122.214,2920,8904,11954,11824,3050,63,63
4,4.25,4070,13860,2,0,3,3,10,4070,0,47.59,-122.229,3430,9240,17930,12670,4070,15,15
3,2.25,2130,11782,1,0,0,4,8,1590,540,47.5423,-122.215,2700,11782,13912,14482,2130,42,42
4,1.75,1980,10800,1,0,0,5,6,990,990,47.5768,-122.222,2180,10800,12780,12980,1980,71,71
3,2,1780,9732,1,0,0,3,8,1780,0,47.5796,-122.229,1900,10200,11512,12100,1780,52,52
4,3.25,4140,11007,2,0,0,3,10,4140,0,47.5707,-122.217,2150,9663,15147,11813,4140,6,6
5,2.75,2890,22547,1,0,0,4,10,2150,740,47.5476,-122.219,3010,17809,25437,20819,2890,56,56
5,2.75,3650,13297,2,0,0,5,9,2750,900,47.5497,-122.228,2900,11568,16947,14468,3650,50,50
4,3.5,2970,14486,2,0,0,3,9,2340,630,47.5627,-122.215,3680,14486,17456,18166,2970,22,22
6,3.25,4440,17424,1,0,1,4,9,2220,2220,47.5791,-122.23,2660,10768,21864,13428,4440,60,60
5,3,3300,33474,1,0,3,3,9,1870,1430,47.5673,-122.21,3836,20953,36774,24789,3300,62,24
4,1.75,2390,17717,1,0,0,4,8,2390,0,47.5755,-122.218,2390,10730,20107,13120,2390,55,55
5,3.5,3620,7821,2,0,2,3,10,2790,830,47.5738,-122.215,2690,9757,11441,12447,3620,61,4
5,2.25,2690,10800,1,0,3,4,8,2020,670,47.5821,-122.247,3380,9134,13490,12514,2690,63,63
4,3.5,4010,10880,2,0,3,4,11,3150,860,47.5359,-122.213,3530,17310,14890,20840,4010,29,29
4,2.25,3240,12930,2,0,0,4,9,2730,510,47.5373,-122.22,2610,12884,16170,15494,3240,51,51
4,2.5,2190,7350,2,0,0,5,8,2190,0,47.5786,-122.236,1880,7350,9540,9230,2190,61,61
4,2.25,2130,11843,2,0,0,4,9,2130,0,47.5358,-122.225,2380,11643,13973,14023,2130,47,47
4,2,2090,10800,1,0,0,4,7,2090,0,47.5759,-122.223,2090,10800,12890,12890,2090,68,68
5,4,4510,15175,2,0,0,3,10,4510,0,47.5309,-122.228,3510,13500,19685,17010,4510,50,12
4,2.25,3070,16028,1,0,3,3,9,1870,1200,47.5271,-122.228,3070,19822,19098,22892,3070,43,43
4,2.5,3180,10105,2,0,0,4,9,3180,0,47.5328,-122.226,2670,10355,13285,13025,3180,33,33
3,1.75,1830,9720,1,0,1,3,7,1150,680,47.5511,-122.23,3380,10854,11550,14234,1830,91,38
4,2.5,3840,16619,2,0,1,4,10,3840,0,47.5634,-122.213,3600,16553,20459,20153,3840,36,36
4,2.5,2340,10800,1,0,0,3,8,2340,0,47.5715,-122.225,2650,13500,13140,16150,2340,66,7
3,2.5,3630,11019,1,0,0,4,9,2150,1480,47.561,-122.226,3150,13555,14649,16705,3630,47,47
3,3.25,4160,35153,3,0,2,3,12,3690,470,47.5749,-122.214,3290,11533,39313,14823,4160,18,18
4,3.25,4060,13000,2,0,3,3,11,4060,0,47.581,-122.246,3220,13800,17060,17020,4060,19,19
3,1.75,2340,10495,1,0,0,4,8,2340,0,47.5386,-122.226,3120,11068,12835,14188,2340,52,52
4,2.75,2070,10125,1,0,0,3,7,1390,680,47.5697,-122.219,1850,10125,12195,11975,2070,57,57
5,2.5,3160,11470,1,0,0,4,9,1780,1380,47.5368,-122.216,3260,11470,14630,14730,3160,48,48
5,3,3480,15185,2,0,0,4,8,3480,0,47.5757,-122.216,3030,14257,18665,17287,3480,55,55
3,1.5,2230,8558,2,0,0,3,8,2230,0,47.5833,-122.219,2200,8558,10788,10758,2230,59,59
3,2,2250,14274,1,0,0,4,8,1500,750,47.5762,-122.217,2820,13813,16524,16633,2250,55,55
5,4.5,6200,23373,3,0,1,4,11,5050,1150,47.5632,-122.215,3700,14486,29573,18186,6200,31,31
4,1.75,1550,7350,1,0,0,4,8,1550,0,47.5795,-122.235,1860,7350,8900,9210,1550,61,61
4,2.25,3010,9800,2,0,0,4,9,3010,0,47.5336,-122.223,2510,9800,12810,12310,3010,46,46
4,4.5,3080,10550,2,0,3,3,8,1940,1140,47.5806,-122.244,2780,10550,13630,13330,3080,43,7
4,2.5,2720,16454,1,0,1,5,9,1870,850,47.5489,-122.216,3560,15993,19174,19553,2720,56,56
4,2.5,3150,13700,2,0,0,4,9,3150,0,47.5309,-122.224,3200,11900,16850,15100,3150,53,53
4,2.75,2270,10460,2,0,0,3,9,2270,0,47.5603,-122.222,2610,10180,12730,12790,2270,54,54
4,2.25,2570,9600,2,0,0,4,9,2570,0,47.5791,-122.241,2570,13200,12170,15770,2570,57,57
5,2.75,2830,18050,1,0,0,5,7,1630,1200,47.5773,-122.226,2370,14250,20880,16620,2830,61,61
3,2.5,3470,12076,2,0,3,3,10,2560,910,47.5319,-122.238,3590,17677,15546,21267,3470,31,31
4,3.5,2790,10125,1,0,0,5,8,2790,0,47.5651,-122.22,2570,10125,12915,12695,2790,34,34
2,1,820,3700,1,0,0,5,7,820,0,47.588,-122.251,1750,9000,4520,10750,820,51,51
3,1,1720,9830,1,0,0,4,7,1720,0,47.5905,-122.245,3200,8923,11550,12123,1720,73,73
4,2.75,3630,15405,1,0,2,4,8,1850,1780,47.566,-122.225,3380,11184,19035,14564,3630,51,51
5,1.75,2500,11617,1,0,0,4,9,1560,940,47.5361,-122.217,3370,11617,14117,14987,2500,53,53
4,2.25,2160,9525,1,0,0,3,8,1080,1080,47.5651,-122.221,2780,9525,11685,12305,2160,58,58
3,1.75,1930,9600,1,0,0,3,8,1930,0,47.5747,-122.237,2350,9840,11530,12190,1930,61,61
5,2.25,3650,13068,1,0,0,4,10,1850,1800,47.5458,-122.231,2760,13927,16718,16687,3650,43,43
4,3.75,4100,22798,1,0,3,5,11,2540,1560,47.5648,-122.21,3880,18730,26898,22610,4100,85,35
4,2.25,1900,8272,1,0,0,4,9,1460,440,47.5803,-122.227,2040,8479,10172,10519,1900,53,53
4,2.25,4070,23321,2,0,0,4,10,4070,0,47.5563,-122.219,2820,10871,27391,13691,4070,51,51
3,1.75,2640,8000,1,0,3,4,9,1320,1320,47.5826,-122.246,2740,6000,10640,8740,2640,59,59
4,1.75,2630,9645,1,0,0,4,9,2630,0,47.5459,-122.228,2690,10439,12275,13129,2630,56,56
3,1.75,2020,9718,1,0,0,3,8,2020,0,47.574,-122.21,2370,8604,11738,10974,2020,63,63
5,3.25,3160,13238,2,0,0,5,8,3160,0,47.5373,-122.224,2360,12042,16398,14402,3160,47,47
4,3.25,3300,15907,2,0,0,5,10,3300,0,47.5413,-122.216,2740,11358,19207,14098,3300,34,34
3,2.25,1810,9845,1,0,0,4,8,1810,0,47.5505,-122.221,1900,10083,11655,11983,1810,60,23
3,1.75,2180,10221,1,0,2,4,7,1140,1040,47.5885,-122.248,2180,8535,12401,10715,2180,73,73
3,3.25,2170,12508,1,0,0,5,9,1650,520,47.5665,-122.229,2720,21070,14678,23790,2170,91,44
3,2.5,1460,8800,1,0,0,4,7,1460,0,47.5895,-122.232,2200,8800,10260,11000,1460,63,63
4,2.75,3120,20031,1,0,2,4,9,1980,1140,47.5389,-122.242,3330,18777,23151,22107,3120,65,18
5,3.75,3570,10125,2,0,0,3,10,3570,0,47.5639,-122.223,1760,10125,13695,11885,3570,5,5
5,4,3760,22763,1,0,3,4,11,1910,1850,47.5333,-122.22,3730,11201,26523,14931,3760,50,50
3,1.75,1560,8078,1,1,4,4,6,1560,0,47.5779,-122.246,2890,16710,9638,19600,1560,91,91
3,2.25,2060,9953,1,0,0,5,8,1070,990,47.5767,-122.233,2340,9600,12013,11940,2060,55,55
4,2.25,2240,9990,2,0,0,4,10,2240,0,47.5516,-122.217,2600,11480,12230,14080,2240,52,52
5,2.5,2400,4548,2,0,0,3,7,2400,0,47.371,-122.127,2200,4465,6948,6665,2400,16,16
3,1,990,10125,1,0,0,3,7,990,0,47.3422,-122.089,1360,10125,11115,11485,990,47,47
3,2.5,1950,3825,2,0,0,3,7,1950,0,47.3588,-122.082,1950,3825,5775,5775,1950,6,6
3,2.5,2529,9653,2,0,0,3,7,2529,0,47.3738,-122.161,2533,6125,12182,8658,2529,7,7
3,2.5,1680,4226,2,0,0,3,8,1680,0,47.3684,-122.123,1800,5559,5906,7359,1680,16,16
3,2.5,2020,6564,1,0,0,3,7,1310,710,47.3545,-122.158,1710,5151,8584,6861,2020,25,25
4,2.75,2260,5705,2,0,0,3,8,2260,0,47.3726,-122.159,2260,5727,7965,7987,2260,5,5
3,1.75,2530,35150,1,0,0,4,7,1800,730,47.3913,-122.121,2460,36386,37680,38846,2530,42,42
5,2.5,3220,5806,2,0,0,3,8,3220,0,47.3714,-122.103,2760,5813,9026,8573,3220,17,17
3,2.5,2540,4775,2,0,0,3,7,2540,0,47.3341,-122.052,2270,5000,7315,7270,2540,13,13
4,3,2290,8250,2,0,0,3,9,2290,0,47.3739,-122.156,2290,8250,10540,10540,2290,29,29
3,1,1390,12145,1,0,0,4,7,1390,0,47.4225,-122.15,1030,10800,13535,11830,1390,55,55
3,1.75,1260,9600,1,0,0,4,7,1260,0,47.3592,-122.076,1640,9946,10860,11586,1260,31,31
4,3,3000,10297,2,0,0,3,8,3000,0,47.3684,-122.073,2520,8366,13297,10886,3000,16,16
4,2.5,1850,7324,2,0,0,3,8,1850,0,47.3701,-122.107,2100,7329,9174,9429,1850,22,22
4,3,2490,5706,2,0,0,3,9,2490,0,47.3509,-122.165,2650,5880,8196,8530,2490,14,14
3,1,840,5525,1,0,0,5,6,840,0,47.3607,-122.085,920,5330,6365,6250,840,50,50
3,1,870,5200,1,0,0,5,6,870,0,47.3702,-122.078,870,5200,6070,6070,870,50,50
3,1.5,1140,4875,1,0,0,5,6,1140,0,47.3684,-122.08,980,5070,6015,6050,1140,49,49
5,2.75,3260,9253,2,0,0,3,8,3260,0,47.3674,-122.07,2770,8067,12513,10837,3260,15,15
3,2.5,2670,13218,1,0,0,4,10,2670,0,47.3683,-122.153,1960,13130,15888,15090,2670,31,31
3,1.5,1210,5200,1,0,0,5,6,1210,0,47.3615,-122.087,1120,5200,6410,6320,1210,50,50
3,1.5,1210,5200,1,0,0,5,6,1210,0,47.3615,-122.087,1120,5200,6410,6320,1210,50,50
4,2.5,2770,9751,2,0,0,3,8,2770,0,47.3739,-122.126,2370,6950,12521,9320,2770,30,30
4,2.5,3480,12696,1,0,0,4,9,1980,1500,47.3816,-122.153,3480,14175,16176,17655,3480,42,42
3,2.25,1700,9600,2,0,0,3,7,1700,0,47.39,-122.158,1930,9600,11300,11530,1700,35,35
3,2.5,2490,4244,2,0,0,3,9,2490,0,47.3705,-122.131,2490,4748,6734,7238,2490,14,14
3,2.5,2010,5399,2,0,0,3,7,2010,0,47.3338,-122.052,2280,5141,7409,7421,2010,13,13
3,2.5,1780,5015,2,0,0,3,7,1780,0,47.3352,-122.052,2010,5250,6795,7260,1780,9,9
3,1.75,1730,9893,1,0,0,4,9,1730,0,47.3747,-122.164,2120,9108,11623,11228,1730,31,31
4,2,1710,5440,1,0,0,5,8,1030,680,47.366,-122.093,1620,6696,7150,8316,1710,43,43
3,1,1230,9720,1,0,0,5,7,1230,0,47.3266,-122.138,1230,9720,10950,10950,1230,50,50
3,1.75,1570,4875,1,0,0,4,7,1310,260,47.3621,-122.094,1380,5200,6445,6580,1570,42,42
3,2.5,1600,6700,2,0,0,3,8,1600,0,47.3618,-122.074,1790,7577,8300,9367,1600,28,28
3,2.5,1720,99916,2,0,0,4,7,1720,0,47.3391,-122.093,1340,73180,101636,74520,1720,29,29
5,2.25,3470,28212,1,0,0,4,8,2790,680,47.3342,-122.108,2020,28177,31682,30197,3470,41,41
3,2.25,1670,7150,2,0,0,4,7,1670,0,47.3603,-122.088,1570,7040,8820,8610,1670,29,29
3,3.25,4460,51177,2,0,0,3,9,4460,0,47.3648,-122.143,2670,38925,55637,41595,4460,14,14
3,2.5,2280,6386,2,0,0,3,8,2280,0,47.3861,-122.096,2550,4835,8666,7385,2280,11,11
4,3,1530,8306,2,0,0,3,7,1530,0,47.3528,-122.146,1930,6925,9836,8855,1530,9,9
3,1.75,1640,10762,1,0,0,3,7,1130,510,47.3586,-122.074,1680,10259,12402,11939,1640,31,31
3,2.5,2588,5701,2,0,0,3,8,2588,0,47.3449,-122.151,2389,5702,8289,8091,2588,11,11
3,2,1500,5200,1,0,0,3,7,1060,440,47.3653,-122.09,1640,5200,6700,6840,1500,42,42
3,2.5,2110,4038,2,0,0,4,8,2110,0,47.3875,-122.153,2110,3727,6148,5837,2110,30,30
3,2.75,2600,10874,2,0,0,3,9,2600,0,47.3815,-122.146,2800,11504,13474,14304,2600,25,25
3,2.5,1630,7950,1,0,0,3,8,1320,310,47.4224,-122.159,1650,7952,9580,9602,1630,34,34
3,1.75,1460,8372,1,0,0,4,7,1460,0,47.3683,-122.087,1220,7803,9832,9023,1460,38,38
3,1,1020,55756,1,0,0,3,7,1020,0,47.3836,-122.082,1490,12745,56776,14235,1020,58,58
4,1.75,1720,10018,1,0,0,5,7,1720,0,47.3614,-122.119,1220,10018,11738,11238,1720,59,59
4,2,1670,5200,1,0,0,4,7,1030,640,47.3652,-122.09,1500,5200,6870,6700,1670,42,42
4,2.5,2240,5105,2,0,0,4,8,2240,0,47.3922,-122.165,1920,5288,7345,7208,2240,17,17
4,2.5,2200,5893,2,0,0,3,7,2200,0,47.3333,-122.055,2200,5757,8093,7957,2200,11,11
3,2.5,1870,4060,2,0,0,3,7,1870,0,47.3986,-122.163,2190,4060,5930,6250,1870,14,14
5,1.75,1730,5200,1,0,0,4,7,1050,680,47.3628,-122.089,1350,5200,6930,6550,1730,41,41
2,1,910,295772,1,0,0,3,5,910,0,47.3752,-122.11,2050,48351,296682,50401,910,66,66
3,2.5,1370,9253,1,0,0,3,7,1090,280,47.3717,-122.073,1470,9253,10623,10723,1370,25,25
4,2.25,2350,36116,1,0,0,4,9,2350,0,47.3533,-122.082,2580,36116,38466,38696,2350,36,36
3,1,1200,10080,1,0,0,4,7,1200,0,47.3261,-122.135,1230,9800,11280,11030,1200,50,50
4,2.5,2260,5702,2,0,0,3,8,2260,0,47.3488,-122.151,2450,6381,7962,8831,2260,17,17
3,1,1670,5200,1,0,0,5,7,1030,640,47.3659,-122.092,1620,6696,6870,8316,1670,42,42
3,2.25,3530,13000,2,0,0,4,10,3530,0,47.3823,-122.159,2960,13000,16530,15960,3530,34,34
4,2.75,3030,117378,1,0,0,4,8,1680,1350,47.401,-122.135,2060,110957,120408,113017,3030,60,60
4,2.5,2000,5390,2,0,0,3,7,2000,0,47.3732,-122.129,2330,5390,7390,7720,2000,16,16
4,1.75,1850,65340,1,0,0,4,7,1850,0,47.3468,-122.11,1750,40946,67190,42696,1850,47,47
3,2.5,1560,10608,2,0,0,3,7,1560,0,47.3572,-122.161,1360,10608,12168,11968,1560,25,25
4,3.5,2700,443440,1,0,0,3,8,2700,0,47.333,-122.098,3210,298182,446140,301392,2700,71,18
4,2.5,2300,3825,2,0,0,3,7,2300,0,47.3594,-122.082,2110,3825,6125,5935,2300,7,7
4,2.5,2150,37647,2,0,0,3,8,2150,0,47.3117,-122.083,2410,42193,39797,44603,2150,28,28
4,2.5,2310,7384,2,0,0,3,8,2310,0,47.3737,-122.165,2310,7800,9694,10110,2310,9,9
5,3.25,3990,13087,2,0,0,3,9,2400,1590,47.3632,-122.061,2580,13633,17077,16213,3990,28,28
3,1.75,1010,9600,1,0,0,5,7,1010,0,47.3828,-122.09,1320,9600,10610,10920,1010,50,50
4,2.5,3200,5772,2,0,0,3,8,3200,0,47.3486,-122.153,3010,5772,8972,8782,3200,16,16
3,1.5,1250,9484,1,0,0,4,7,1250,0,47.3675,-122.147,1320,9600,10734,10920,1250,50,50
3,1,920,4875,1,0,0,5,6,920,0,47.3648,-122.081,960,5200,5795,6160,920,50,50
4,2.75,2950,15540,1,0,0,4,8,2120,830,47.3845,-122.152,2840,17136,18490,19976,2950,45,45
4,2.25,2050,26000,2,0,0,4,8,2050,0,47.3423,-122.063,2330,31100,28050,33430,2050,42,42
4,1.75,1820,9824,1,0,0,5,7,1820,0,47.3833,-122.093,1410,11013,11644,12423,1820,51,51
4,2.75,1300,9638,1,0,0,2,7,1300,0,47.3683,-122.109,1670,9638,10938,11308,1300,36,36
3,2.5,1670,5298,2,0,0,3,8,1670,0,47.3925,-122.165,1920,5298,6968,7218,1670,17,17
3,2.25,1830,7770,1,0,0,4,7,1400,430,47.3925,-122.161,1960,7272,9600,9232,1830,42,42
2,1.75,1460,7926,1,0,0,4,7,1460,0,47.3665,-122.092,1680,8206,9386,9886,1460,32,32
3,2.25,2080,2856,1,0,0,3,7,1550,530,47.4198,-122.158,2080,2275,4936,4355,2080,16,16
3,2.5,1850,4597,2,0,0,3,8,1850,0,47.3755,-122.136,2210,5000,6447,7210,1850,16,16
3,2.5,2540,5050,2,0,0,3,7,2540,0,47.3358,-122.055,2280,5050,7590,7330,2540,13,13
4,2.5,2030,5754,2,0,0,3,8,2030,0,47.3542,-122.137,2030,5784,7784,7814,2030,18,18
3,2,1410,10625,1,0,0,3,7,1410,0,47.3649,-122.117,1410,9744,12035,11154,1410,39,39
4,2.5,3630,8387,2,0,0,3,10,3630,0,47.3623,-122.127,3370,8869,12017,12239,3630,22,22
4,2.5,2340,52272,2,0,0,2,8,2340,0,47.3468,-122.091,2480,40500,54612,42980,2340,41,41
3,2.25,1420,7800,1,0,0,4,7,1130,290,47.3598,-122.157,1460,7800,9220,9260,1420,34,34
3,1,1380,30940,2,0,0,3,8,1380,0,47.334,-122.106,2350,32500,32320,34850,1380,43,43
4,2.5,1600,9921,2,0,0,3,7,1600,0,47.3678,-122.124,2140,5806,11521,7946,1600,10,10
3,1,870,5200,1,0,0,5,6,870,0,47.3701,-122.078,1020,5200,6070,6220,870,50,50
3,1.75,1580,9705,1,0,0,4,7,1580,0,47.3819,-122.09,1580,9942,11285,11522,1580,42,42
4,2.25,2460,14600,1,0,0,4,8,1720,740,47.3762,-122.16,2460,14600,17060,17060,2460,42,42
3,1.75,1530,14087,1,0,0,3,7,1070,460,47.3146,-122.043,1770,13660,15617,15430,1530,40,40
3,2.5,2440,18674,2,0,0,4,8,2440,0,47.3672,-122.126,2530,10603,21114,13133,2440,25,25
2,1,770,5200,1,0,0,5,6,770,0,47.3627,-122.087,1150,5330,5970,6480,770,50,50
3,2.5,2230,32660,1,0,0,4,8,2230,0,47.3321,-122.105,2400,33120,34890,35520,2230,42,42
3,1.75,1240,10361,1,0,0,3,6,1240,0,47.37,-122.151,1240,8834,11601,10074,1240,32,32
3,1.5,1072,4339,2,0,0,3,7,1072,0,47.386,-122.162,1443,4341,5411,5784,1072,10,10
3,1.75,1780,13095,1,0,0,4,9,1780,0,47.367,-122.152,2750,13095,14875,15845,1780,36,36
4,2.5,2420,3825,2,0,0,3,8,2420,0,47.3687,-122.126,1880,4250,6245,6130,2420,16,16
4,2.5,3140,94525,2,0,0,4,8,2280,860,47.4155,-122.163,1910,14300,97665,16210,3140,42,42
3,2,1640,4875,1,0,0,4,7,1040,600,47.3661,-122.094,1640,5200,6515,6840,1640,42,42
3,1.75,1150,8690,1,0,0,4,7,1150,0,47.3729,-122.115,1330,7040,9840,8370,1150,42,42
4,2.5,1740,4642,2,0,0,3,7,1740,0,47.3686,-122.117,1950,4642,6382,6592,1740,7,7
3,2.5,2090,4700,2,0,0,3,8,2090,0,47.3724,-122.104,2740,5040,6790,7780,2090,17,17
4,2.5,2630,5701,2,0,0,3,7,2630,0,47.375,-122.16,2770,5939,8331,8709,2630,9,9
3,2.5,2160,59241,1,0,0,3,7,2160,0,47.3304,-122.13,2290,125017,61401,127307,2160,12,12
3,2,1410,7265,1,0,0,4,7,1410,0,47.3654,-122.076,1390,8060,8675,9450,1410,36,36
3,3,3200,35782,1,0,0,3,8,2360,840,47.4121,-122.154,3090,37887,38982,40977,3200,41,41
4,2.5,1810,39639,1,0,0,3,7,1230,580,47.3472,-122.11,1810,44866,41449,46676,1810,49,49
3,2.5,1880,6008,2,0,0,3,7,1880,0,47.3366,-122.052,2180,5185,7888,7365,1880,10,10
3,1,840,6500,1,0,0,5,6,840,0,47.3637,-122.083,920,4680,7340,5600,840,50,50
4,3,5370,69848,2,0,0,3,10,3500,1870,47.3166,-122.046,4443,94403,75218,98846,5370,14,14
4,2.5,2700,6769,2,0,0,3,9,2700,0,47.3753,-122.155,2880,7968,9469,10848,2700,20,20
4,3.25,5450,37058,1,0,0,5,9,5450,0,47.351,-122.087,2800,35716,42508,38516,5450,35,35
3,2,1950,8698,1,0,0,3,8,1950,0,47.39,-122.153,2330,7212,10648,9542,1950,20,20
4,2.5,3020,8302,2,0,0,4,10,3020,0,47.363,-122.127,3020,8406,11322,11426,3020,25,25
5,2.5,3020,21441,1,0,0,4,8,1510,1510,47.3392,-122.131,1610,16445,24461,18055,3020,41,41
3,1.75,1100,5525,1,0,0,5,6,1100,0,47.3625,-122.084,1050,5200,6625,6250,1100,51,51
4,2.5,3100,10000,2,0,0,3,9,3100,0,47.3741,-122.15,1850,9438,13100,11288,3100,41,41
3,1,1830,12036,1,0,0,3,7,1550,280,47.3126,-122.043,1810,12036,13866,13846,1830,42,42
3,1,1470,32670,1,0,0,3,7,1020,450,47.3811,-122.144,2640,24100,34140,26740,1470,61,61
4,2,1900,76877,1,0,0,3,8,1900,0,47.3491,-122.113,1740,34848,78777,36588,1900,15,15
4,2.25,3250,34293,2,0,0,4,9,3250,0,47.3496,-122.094,3110,35982,37543,39092,3250,36,36
3,2,1280,13356,1,0,0,3,7,1280,0,47.3715,-122.074,1590,8071,14636,9661,1280,25,25
4,2.25,1620,106722,1,0,0,3,8,1200,420,47.3394,-122.091,1620,38400,108342,40020,1620,39,39
3,1.75,1820,78408,1,0,0,3,6,1220,600,47.3364,-122.128,1340,78408,80228,79748,1820,69,69
3,1,1040,8645,1,0,0,4,7,1040,0,47.3631,-122.116,1290,8645,9685,9935,1040,57,57
3,1.5,1440,12040,1,0,0,4,7,1440,0,47.3715,-122.16,1720,12040,13480,13760,1440,60,60
3,2.5,2430,5000,2,0,0,3,8,2430,0,47.3786,-122.127,2910,5620,7430,8530,2430,18,18
3,1.5,1160,5200,1,0,0,5,7,1160,0,47.364,-122.094,1170,5200,6360,6370,1160,49,49
3,2.25,1500,15334,2,0,0,4,7,1500,0,47.3719,-122.091,1530,8102,16834,9632,1500,27,27
6,2.5,2590,10890,1,0,0,4,7,1340,1250,47.4126,-122.165,2474,10454,13480,12928,2590,49,49
3,2,1660,8641,2,0,0,4,8,1660,0,47.3663,-122.088,1490,8641,10301,10131,1660,32,32
3,2.5,1770,6033,2,0,0,4,7,1770,0,47.3764,-122.119,1590,6510,7803,8100,1770,32,32
5,2.5,1630,20750,1,0,0,4,7,1100,530,47.3657,-122.113,1630,8640,22380,10270,1630,44,44
4,1,1530,4875,2,0,0,3,7,1530,0,47.3638,-122.091,1470,4875,6405,6345,1530,42,42
3,2.5,2080,4828,2,0,0,3,8,2080,0,47.3737,-122.132,2190,4620,6908,6810,2080,17,17
4,3.5,3150,6202,2,0,0,3,7,3150,0,47.3993,-122.162,2950,5940,9352,8890,3150,14,14
4,2.5,2780,3969,2,0,0,3,7,2780,0,47.3992,-122.164,2260,4160,6749,6420,2780,14,14
3,2.5,2370,15375,2,0,2,3,9,2370,0,47.3803,-122.147,2450,9800,17745,12250,2370,26,26
3,2.25,2080,4252,1,0,0,3,7,1550,530,47.4203,-122.157,2080,2275,6332,4355,2080,16,16
4,2,2760,21465,1,0,0,4,9,2120,640,47.3818,-122.165,2550,13144,24225,15694,2760,40,40
3,1,870,5330,1,0,0,3,6,870,0,47.369,-122.077,840,5200,6200,6040,870,50,0
3,1.75,1160,5200,1,0,0,4,7,1160,0,47.3643,-122.09,1470,5200,6360,6670,1160,42,42
4,2.5,2100,7366,2,0,0,3,8,2100,0,47.3703,-122.107,2060,7324,9466,9384,2100,22,22
4,1.75,1610,9652,1,0,0,5,7,1610,0,47.3281,-122.135,1220,9800,11262,11020,1610,50,50
4,2.5,2350,5835,2,0,0,3,8,2350,0,47.3494,-122.153,3010,5772,8185,8782,2350,16,16
3,1.75,1010,6552,1,0,0,3,7,1010,0,47.375,-122.117,1010,6552,7562,7562,1010,50,50
4,2.5,3320,5034,2,0,0,4,7,3320,0,47.4011,-122.164,2580,4950,8354,7530,3320,13,13
3,2,1450,8928,1,0,0,3,7,1450,0,47.3637,-122.075,2050,8523,10378,10573,1450,21,21
3,1.75,2040,22693,1,0,0,4,8,2040,0,47.3519,-122.14,1950,6280,24733,8230,2040,39,39
3,2.5,1427,4337,2,0,0,3,7,1427,0,47.3857,-122.162,1443,4347,5764,5790,1427,10,10
3,1,1000,19204,1,0,0,3,7,1000,0,47.3167,-122.081,2450,25927,20204,28377,1000,51,4
4,2.5,2230,4541,2,0,0,3,7,2230,0,47.3848,-122.1,2800,4860,6771,7660,2230,13,13
3,2.5,1660,2415,2,0,0,3,7,1660,0,47.3763,-122.148,1740,2624,4075,4364,1660,36,36
4,2.5,2200,5730,2,0,0,3,8,2200,0,47.3482,-122.153,2200,5772,7930,7972,2200,16,16
6,3.75,3190,4700,2,0,0,3,8,3190,0,47.3724,-122.105,2680,5640,7890,8320,3190,16,16
3,1,1010,10125,1,0,0,4,7,1010,0,47.3423,-122.088,1230,10125,11135,11355,1010,47,47
3,2.25,2530,12042,2,0,0,3,8,2530,0,47.3742,-122.125,2480,10172,14572,12652,2530,30,30
3,1.5,1120,8366,1,0,0,3,7,1120,0,47.3632,-122.11,1260,9000,9486,10260,1120,51,51
3,1,1180,9832,1,0,0,3,7,1180,0,47.3845,-122.085,1220,9894,11012,11114,1180,49,49
4,2.5,3110,5048,2,0,0,3,8,3110,0,47.3782,-122.125,3110,5190,8158,8300,3110,17,17
3,2.25,2670,37089,2,0,0,3,9,2670,0,47.3347,-122.077,2290,36284,39759,38574,2670,29,29
3,2,1310,8069,1,0,0,3,7,1310,0,47.3694,-122.083,1310,8392,9379,9702,1310,29,29
4,2.5,2040,8076,2,0,0,3,7,2040,0,47.3691,-122.074,2040,8408,10116,10448,2040,25,25
3,1,1340,7000,1,0,0,4,7,1340,0,47.3742,-122.149,1850,7904,8340,9754,1340,41,41
3,2,1690,9087,1,0,0,3,8,1690,0,47.3724,-122.108,2090,8100,10777,10190,1690,22,22
4,2.5,2910,5000,2,0,0,3,8,2910,0,47.3782,-122.127,2740,5045,7910,7785,2910,17,17
4,2.5,2927,6000,2,0,0,3,7,2927,0,47.3737,-122.16,2533,6000,8927,8533,2927,8,8
1,1,650,15364,1,0,0,4,5,650,0,47.3721,-122.159,1630,7952,16014,9582,650,52,52
3,1.5,2290,9600,1,0,0,4,7,2290,0,47.3643,-122.111,1310,9600,11890,10910,2290,52,52
4,2.5,2490,5812,2,0,0,3,8,2490,0,47.3875,-122.155,2690,6012,8302,8702,2490,19,19
3,1,1300,10139,1,0,0,3,7,1300,0,47.3427,-122.087,1260,10139,11439,11399,1300,57,8
4,2.5,2900,4762,2,0,0,3,8,2900,0,47.3663,-122.129,2900,5173,7662,8073,2900,14,14
4,2.5,2430,5499,2,0,0,3,8,2430,0,47.3779,-122.125,2890,5190,7929,8080,2430,17,17
4,2.5,2320,6270,2,0,0,3,8,2320,0,47.3501,-122.14,2150,6270,8590,8420,2320,15,15
2,1.5,1230,1561,2,0,0,3,7,1230,0,47.3768,-122.149,1660,2243,2791,3903,1230,36,36
4,2.75,2700,37011,2,0,0,3,9,2700,0,47.3496,-122.088,2700,37457,39711,40157,2700,35,35
3,2.5,2050,15035,2,0,0,3,9,2050,0,47.3619,-122.122,1300,15836,17085,17136,2050,13,13
3,1.75,1260,6223,1,0,0,3,7,820,440,47.3574,-122.158,1260,6553,7483,7813,1260,36,36
3,2.5,2480,53250,2,0,0,3,9,2480,0,47.3323,-122.079,2510,36549,55730,39059,2480,29,29
3,1.75,1290,8688,1,0,0,4,7,1290,0,47.3655,-122.08,1750,9090,9978,10840,1290,39,39
3,2.5,2590,18980,1,0,0,4,10,2590,0,47.3839,-122.153,3110,14652,21570,17762,2590,43,43
4,2.5,2530,10155,2,0,0,3,8,2530,0,47.351,-122.146,2330,7205,12685,9535,2530,21,21
3,1.5,1190,10116,1,0,0,3,7,1190,0,47.385,-122.085,1190,9905,11306,11095,1190,51,51
4,2.5,2210,13721,2,0,0,3,8,2210,0,47.3122,-122.039,1850,12951,15931,14801,2210,10,10
3,2.5,1870,4046,2,0,0,3,7,1870,0,47.342,-122.059,2130,4800,5916,6930,1870,12,12
4,2.25,2380,7400,1,0,0,4,8,1760,620,47.3555,-122.149,1940,7400,9780,9340,2380,40,40
3,2.5,1870,5000,2,0,0,3,7,1870,0,47.3339,-122.055,2170,5399,6870,7569,1870,10,10
3,1,920,4875,1,0,0,4,7,920,0,47.3623,-122.09,1160,4875,5795,6035,920,41,41
3,2.25,1610,7423,2,0,0,4,7,1610,0,47.3713,-122.091,1530,8102,9033,9632,1610,29,29
4,3,1900,7194,2,0,0,4,7,1900,0,47.3768,-122.117,1690,7194,9094,8884,1900,31,31
3,1.75,1120,15210,1,0,0,5,7,1120,0,47.3659,-122.113,1710,8470,16330,10180,1120,43,43
3,2,1670,6824,1,0,0,3,7,1300,370,47.3666,-122.084,1660,7586,8494,9246,1670,29,29
0,2.5,2290,8319,2,0,0,3,8,2290,0,47.3473,-122.151,2500,8751,10609,11251,2290,34,34
2,1,840,5265,1,0,0,5,6,840,0,47.3644,-122.082,920,5100,6105,6020,840,50,50
3,2.5,1740,6992,2,0,0,3,7,1740,0,47.3574,-122.158,1260,6825,8732,8085,1740,29,29
3,1,1120,8342,1,0,0,4,7,1120,0,47.3732,-122.116,1190,6660,9462,7850,1120,43,43
3,2.5,2026,7611,2,0,0,3,8,2026,0,47.3733,-122.162,2270,7611,9637,9881,2026,9,9
3,2,1090,7350,1,0,0,4,7,1090,0,47.3687,-122.085,1490,7741,8440,9231,1090,29,29
4,2.5,2420,8404,2,0,0,3,8,2420,0,47.372,-122.13,2440,4822,10824,7262,2420,6,6
4,1.75,1870,22072,1,0,0,3,7,1070,800,47.3775,-122.165,2100,10185,23942,12285,1870,60,60
3,2.5,2588,5702,2,0,0,3,8,2588,0,47.3453,-122.151,2403,5703,8290,8106,2588,11,11
4,2.25,3680,26266,2,0,0,4,9,3680,0,47.3219,-122.085,2340,19939,29946,22279,3680,38,38
3,1,1250,7592,1,0,0,5,7,1250,0,47.3604,-122.111,1250,7592,8842,8842,1250,58,58
4,2.25,2040,14383,1,0,0,4,8,1270,770,47.3849,-122.163,2030,11500,16423,13530,2040,42,42
3,2.5,1970,6291,2,0,0,4,7,1970,0,47.3627,-122.073,1980,8852,8261,10832,1970,21,21
3,1,1190,7500,1,0,0,5,7,1190,0,47.3248,-122.142,1200,9750,8690,10950,1190,51,51
4,2.25,2630,39000,2,0,0,3,9,2630,0,47.4089,-122.149,2270,66647,41630,68917,2630,40,40
3,2,1320,8568,1,0,0,3,7,1320,0,47.3904,-122.164,1600,8463,9888,10063,1320,26,26
3,1,1060,5200,1,0,0,5,6,1060,0,47.3636,-122.093,1380,5200,6260,6580,1060,49,49
3,1.75,1100,10968,1,0,0,5,7,1100,0,47.363,-122.08,1400,7799,12068,9199,1100,35,35
3,2.5,1950,4197,2,0,0,3,7,1950,0,47.3613,-122.081,2300,4178,6147,6478,1950,6,6
4,2.5,2650,9451,2,0,0,4,8,2650,0,47.3693,-122.129,2510,8850,12101,11360,2650,26,26
3,1.75,1540,8223,1,0,0,4,7,1070,470,47.3666,-122.089,1240,8113,9763,9353,1540,32,32
4,2.75,2400,19923,1,0,0,5,7,1320,1080,47.3616,-122.144,2470,10736,22323,13206,2400,66,66
3,2,1930,11947,1,0,0,4,8,1930,0,47.3672,-122.151,2200,12825,13877,15025,1930,53,53
2,1.75,1500,8645,1,0,0,4,7,1500,0,47.3643,-122.115,1220,8645,10145,9865,1500,56,56
5,3.5,2390,6600,2,0,0,5,7,2390,0,47.3737,-122.115,1140,6600,8990,7740,2390,42,42
3,1.75,1480,8165,1,0,0,4,7,1480,0,47.3624,-122.079,1450,7939,9645,9389,1480,34,34
3,1.75,1170,8239,1,0,0,3,7,1170,0,47.3679,-122.088,1180,7866,9409,9046,1170,38,38
4,2.5,2180,9281,2,0,0,3,8,2180,0,47.3673,-122.072,2520,9520,11461,12040,2180,15,15
3,2,1410,6600,1,0,0,4,7,1410,0,47.3596,-122.089,1750,7150,8010,8900,1410,29,29
4,2.5,1610,4052,2,0,0,3,7,1610,0,47.3603,-122.081,2110,4034,5662,6144,1610,6,6
4,2.5,2060,13500,1,0,0,3,7,1260,800,47.4229,-122.153,1610,10714,15560,12324,2060,51,51
3,1.5,1620,9310,1,0,0,4,7,1620,0,47.3665,-122.107,1610,10640,10930,12250,1620,52,52
4,2.5,1810,6509,2,0,0,3,7,1810,0,47.3531,-122.143,1760,7417,8319,9177,1810,25,25
3,2,1310,6738,1,0,0,4,7,1310,0,47.3694,-122.083,1290,8067,8048,9357,1310,29,29
3,2.5,1740,4497,2,0,0,3,7,1740,0,47.3697,-122.117,1950,4486,6237,6436,1740,7,7
4,2.5,2280,42077,2,0,0,3,8,2280,0,47.3424,-122.077,2280,36236,44357,38516,2280,25,25
4,2,1620,5200,1,0,0,4,7,1620,0,47.3629,-122.091,1500,5200,6820,6700,1620,41,41
3,2.5,2000,30605,2,0,0,4,8,2000,0,47.3442,-122.062,1930,35350,32605,37280,2000,30,30
3,1.5,1050,5525,1,0,0,5,6,1050,0,47.3608,-122.083,1100,5200,6575,6300,1050,50,50
3,2.75,2290,34548,2,0,3,4,7,2290,0,47.3691,-122.163,399,275299,36838,275698,2290,35,35
3,2.5,2040,13590,2,0,0,3,8,2040,0,47.3122,-122.04,1850,12485,15630,14335,2040,10,10
3,2,1590,8670,1,0,0,3,7,1590,0,47.3725,-122.073,1590,9253,10260,10843,1590,25,25
3,1.75,2840,9800,1,0,0,4,7,1420,1420,47.3516,-122.119,1650,9590,12640,11240,2840,42,42
3,1,1240,5200,1,0,0,3,6,1240,0,47.3701,-122.079,870,5200,6440,6070,1240,50,50
3,1.75,1320,12528,1,0,0,4,7,1320,0,47.3234,-122.142,1340,11039,13848,12379,1320,49,49
4,2.25,1960,12243,2,0,0,3,8,1960,0,47.3405,-122.058,1910,12230,14203,14140,1960,30,30
3,1.5,1420,22100,1,0,0,5,7,1420,0,47.4193,-122.149,1540,21780,23520,23320,1420,62,62
3,2.5,2230,5050,2,0,0,3,7,2230,0,47.3359,-122.055,2260,5050,7280,7310,2230,13,13
3,1.5,1470,14821,1,0,0,4,7,1470,0,47.3658,-122.148,1760,15370,16291,17130,1470,61,61
3,2.5,2420,4750,2,0,0,3,8,2420,0,47.3663,-122.122,2690,4750,7170,7440,2420,16,16
3,2,1100,5200,1,0,0,3,6,1100,0,47.3606,-122.083,1050,5330,6300,6380,1100,50,0
3,2,1230,7789,1,0,0,3,7,1230,0,47.3718,-122.073,1470,8670,9019,10140,1230,25,25
3,2,1610,13309,1,0,0,4,7,1610,0,47.3398,-122.133,1610,15725,14919,17335,1610,52,52
3,1.75,1980,273556,1,0,0,3,6,1040,940,47.4012,-122.11,2180,217799,275536,219979,1980,63,16
3,2.5,1870,3439,2,0,0,3,7,1870,0,47.3992,-122.163,2190,4029,5309,6219,1870,14,14
3,1,1640,9750,1,0,0,3,7,1640,0,47.3256,-122.141,1200,9750,11390,10950,1640,51,51
4,2.75,3090,7650,2,0,2,3,8,2340,750,47.3622,-122.157,2760,10370,10740,13130,3090,60,25
4,2.5,3490,5000,2,0,0,3,8,3490,0,47.3772,-122.127,2910,5025,8490,7935,3490,16,16
3,2.25,2100,14027,2,0,0,3,8,2100,0,47.3833,-122.1,2730,5999,16127,8729,2100,40,40
3,2.5,1800,3980,2,0,0,3,7,1800,0,47.4006,-122.162,2580,4307,5780,6887,1800,13,13
4,2.5,1880,9426,2,0,0,4,7,1880,0,47.3584,-122.089,1760,7040,11306,8800,1880,29,29
3,2,1320,8959,1,0,0,3,7,1320,0,47.3536,-122.144,1740,7316,10279,9056,1320,26,26
4,2.25,2200,7150,2,0,0,4,7,2200,0,47.3595,-122.089,1740,7150,9350,8890,2200,29,29
4,2.5,2300,4482,2,0,0,3,7,2300,0,47.3599,-122.082,2300,3825,6782,6125,2300,6,6
4,3.5,4130,77832,2,0,2,3,10,4130,0,47.3229,-122.045,4130,87476,81962,91606,4130,8,8
3,2.5,2650,144183,1,0,0,3,8,2650,0,47.4212,-122.144,1940,41210,146833,43150,2650,52,52
4,2.5,2110,3825,2,0,0,3,7,2110,0,47.3602,-122.082,2110,3825,5935,5935,2110,7,7
4,2.5,1996,4547,2,0,0,3,7,1996,0,47.3365,-122.051,2180,5127,6543,7307,1996,10,10
5,3,3223,6371,2,0,0,3,9,3223,0,47.3588,-122.163,1979,19030,9594,21009,3223,5,5
3,2.5,2460,5027,2,0,0,3,8,2460,0,47.372,-122.102,2740,5000,7487,7740,2460,17,17
5,2.25,2880,11965,2,0,0,4,8,2880,0,47.3734,-122.124,2370,10715,14845,13085,2880,29,29
3,1,870,5200,1,0,0,5,6,870,0,47.3695,-122.081,870,5200,6070,6070,870,50,50
3,2.5,2110,4118,2,0,0,3,8,2110,0,47.3878,-122.153,2110,4044,6228,6154,2110,30,30
3,2.5,1670,8364,1,0,0,4,7,1300,370,47.369,-122.084,1490,8143,10034,9633,1670,29,29
3,1.75,2160,98445,2,0,0,3,8,2160,0,47.35,-122.162,2004,44431,100605,46435,2160,41,41
3,1,1010,9920,1,0,0,3,6,1010,0,47.3238,-122.14,1270,9680,10930,10950,1010,42,42
3,2.5,3240,108366,2,0,0,4,10,3240,0,47.327,-122.094,2090,108366,111606,110456,3240,28,28
4,2.5,2660,4082,2,0,0,3,7,2660,0,47.3414,-122.055,2390,4876,6742,7266,2660,9,9
3,1,840,6540,1,0,0,3,6,840,0,47.3743,-122.116,1010,6600,7380,7610,840,49,1
3,1.75,1240,10956,1,0,0,3,6,1240,0,47.3705,-122.15,1240,8137,12196,9377,1240,32,32
4,2.5,1580,6633,2,0,0,4,7,1580,0,47.3768,-122.118,1590,6633,8213,8223,1580,35,35
4,2.5,2340,11784,2,0,0,3,9,2340,0,47.384,-122.149,2250,10760,14124,13010,2340,22,22
5,2.75,2166,6342,2,0,0,3,8,2166,0,47.3461,-122.152,2474,5948,8508,8422,2166,6,6
4,1.5,1450,5530,1,0,0,4,6,1450,0,47.3613,-122.087,1060,5200,6980,6260,1450,50,50
3,1,840,5200,1,0,0,3,6,840,0,47.3685,-122.077,870,5200,6040,6070,840,50,1
3,2.5,2540,4260,2,0,0,3,7,2540,0,47.3989,-122.164,2190,4260,6800,6450,2540,14,14
3,2.5,1870,5874,2,0,0,3,7,1870,0,47.3992,-122.163,2090,4060,7744,6150,1870,14,14
4,3,3060,5000,2,0,0,3,8,3060,0,47.3786,-122.126,3060,5668,8060,8728,3060,18,18
4,2.5,2190,7000,2,0,0,3,8,2190,0,47.3718,-122.109,2040,7700,9190,9740,2190,22,22
3,2.5,2090,4590,2,0,0,3,7,2090,0,47.3992,-122.163,2190,4060,6680,6250,2090,14,14
3,2.5,1490,3840,2,0,0,3,7,1490,0,47.374,-122.133,2060,4384,5330,6444,1490,17,17
4,2.5,2105,6093,2,0,0,3,8,2105,0,47.3531,-122.147,1930,8022,8198,9952,2105,16,16
4,2.5,1850,5674,2,0,0,3,7,1850,0,47.3536,-122.142,1750,6875,7524,8625,1850,26,26
3,2,3120,42247,1,0,0,4,7,2150,970,47.3925,-122.137,2100,43416,45367,45516,3120,39,39
3,1,1340,15600,1,0,0,4,6,1340,0,47.3224,-122.143,1320,9800,16940,11120,1340,41,41
3,1.5,1740,5200,1,0,0,4,7,1060,680,47.3657,-122.094,1540,5200,6940,6740,1740,42,42
3,1.5,1610,5304,1,0,0,4,6,1610,0,47.3632,-122.087,1060,5304,6914,6364,1610,51,51
3,2.5,2390,34041,1,0,0,3,8,1840,550,47.3546,-122.081,2460,35686,36431,38146,2390,35,35
3,1.5,1090,10454,1,0,0,3,6,1090,0,47.3425,-122.082,1230,12196,11544,13426,1090,56,56
3,1.5,1110,10296,1,0,0,5,7,1110,0,47.422,-122.153,1330,10296,11406,11626,1110,55,55
3,1,860,5185,1,0,0,4,6,860,0,47.3634,-122.086,1120,5494,6045,6614,860,51,51
4,2.5,2010,12085,2,0,0,3,8,2010,0,47.3406,-122.057,1910,12133,14095,14043,2010,33,33
4,2.5,2490,9346,2,0,2,3,9,2490,0,47.3831,-122.147,2650,9454,11836,12104,2490,23,23
5,3,3223,6371,2,0,0,3,9,3223,0,47.3584,-122.163,1979,9008,9594,10987,3223,5,5
3,2.5,1880,5000,2,0,0,3,7,1880,0,47.3359,-122.054,2260,5000,6880,7260,1880,9,9
3,2.25,1670,6600,2,0,0,4,7,1670,0,47.3604,-122.089,1670,6801,8270,8471,1670,29,29
4,2.5,3010,5701,2,0,0,3,8,3010,0,47.3492,-122.152,3010,5772,8711,8782,3010,16,16
4,2.5,3110,5868,2,0,0,3,8,3110,0,47.3781,-122.126,2950,5924,8978,8874,3110,18,18
4,2.5,2300,15188,2,0,0,4,7,2300,0,47.3683,-122.164,1820,10125,17488,11945,2300,53,53
3,1,840,6500,1,0,0,5,6,840,0,47.3704,-122.08,870,5200,7340,6070,840,50,50
3,2.5,2424,5931,2,0,0,3,9,2424,0,47.3515,-122.134,2424,6036,8355,8460,2424,5,5
4,2.5,2310,7800,2,0,0,3,8,2310,0,47.3737,-122.164,2310,7140,10110,9450,2310,8,8
4,2.5,2260,13755,1,0,0,4,9,2260,0,47.3767,-122.161,2650,13650,16015,16300,2260,44,44
3,2.25,1400,3825,2,0,0,3,7,1400,0,47.3596,-122.082,2110,3825,5225,5935,1400,7,7
3,2.5,2130,12245,2,0,0,3,8,2130,0,47.3406,-122.057,1910,12216,14375,14126,2130,30,30
4,2.5,2690,5505,2,0,0,3,8,2690,0,47.3666,-122.119,2690,5505,8195,8195,2690,15,15
4,1.5,1120,5427,1,0,0,3,6,1120,0,47.3628,-122.087,1150,5304,6547,6454,1120,50,0
4,2.75,2700,49428,1,0,0,4,9,2700,0,47.3168,-122.079,2728,85905,52128,88633,2700,31,31
4,2.5,2500,4750,2,0,0,3,8,2500,0,47.3666,-122.122,2690,4750,7250,7440,2500,16,16
2,1,950,15996,1,0,0,4,7,950,0,47.4987,-121.787,950,25510,16946,26460,950,73,19
3,1.5,1200,15606,1,0,0,3,7,1200,0,47.4752,-121.755,1210,15606,16806,16816,1200,34,34
3,2.5,3240,60840,2,0,0,3,7,3240,0,47.5192,-121.764,2570,204732,64080,207302,3240,22,22
4,3.25,7420,167869,2,0,3,3,12,7420,0,47.4548,-121.764,5610,169549,175289,175159,7420,17,17
5,3.5,3440,6037,2,0,0,3,9,3440,0,47.4765,-121.734,3270,6037,9477,9307,3440,5,5
3,1.75,1510,44000,1,0,0,3,7,1240,270,47.4851,-121.716,2290,36242,45510,38532,1510,30,30
3,2.75,2100,10362,2,0,0,3,9,1510,590,47.4347,-121.417,2240,11842,12462,14082,2100,21,21
4,1.75,1580,8856,2,0,0,3,7,1580,0,47.4694,-121.745,1390,9490,10436,10880,1580,40,40
3,1.75,1570,16817,2,0,0,3,7,1570,0,47.4716,-121.756,1600,16817,18387,18417,1570,37,37
4,2.5,2980,210395,2,0,0,3,9,2980,0,47.4575,-121.707,2530,45596,213375,48126,2980,18,18
3,2,2740,101930,1,0,2,3,9,2740,0,47.5056,-121.77,2140,83635,104670,85775,2740,20,20
4,2.5,2500,50595,2,0,0,3,9,2500,0,47.4736,-121.731,2765,33720,53095,36485,2500,22,22
4,2.75,2790,5000,2,0,0,3,8,2790,0,47.4831,-121.773,2620,5527,7790,8147,2790,5,5
3,2.25,1510,36224,2,0,0,3,8,1510,0,47.4616,-121.711,1730,36224,37734,37954,1510,28,28
4,2.5,3030,9687,2,0,0,3,8,2020,1010,47.485,-121.799,2050,10193,12717,12243,3030,21,21
4,2.75,4600,322188,1,0,4,3,10,2400,2200,47.4626,-121.739,3740,114562,326788,118302,4600,30,30
3,2,1140,11620,1,0,0,3,7,1140,0,47.4991,-121.783,1140,8400,12760,9540,1140,25,25
3,1.75,1710,10950,1,0,0,3,7,1060,650,47.4678,-121.745,1180,10950,12660,12130,1710,52,52
3,1,1230,9440,1,0,0,3,7,1230,0,47.4657,-121.747,1230,10296,10670,11526,1230,41,41
3,1,1190,9600,1,0,0,3,7,1190,0,47.4805,-121.762,1360,10140,10790,11500,1190,38,38
3,2.5,1920,15124,2,0,0,3,8,1920,0,47.5015,-121.773,1920,16477,17044,18397,1920,24,24
3,1,1250,10094,1,0,0,4,6,1250,0,47.4987,-121.781,1300,10094,11344,11394,1250,92,92
4,2.5,2990,6037,2,0,0,3,9,2990,0,47.4766,-121.735,2990,5992,9027,8982,2990,6,6
3,3,4020,435600,1,0,2,3,10,4020,0,47.4418,-121.731,2590,283140,439620,285730,4020,20,20
3,2.5,1750,22357,2,0,0,3,8,1750,0,47.4807,-121.779,2430,22357,24107,24787,1750,25,25
3,2,1660,11135,1,0,0,3,8,1660,0,47.4897,-121.787,1660,11560,12795,13220,1660,48,48
2,1,960,20954,1,0,0,3,7,960,0,47.4485,-121.774,1240,9752,21914,10992,960,42,42
5,2,1860,9000,2,0,0,3,7,1860,0,47.4484,-121.772,1390,9752,10860,11142,1860,39,39
4,2.5,1890,12236,1,0,0,3,7,1230,660,47.4491,-121.78,1390,11360,14126,12750,1890,41,41
3,2.5,2340,5171,2,0,0,3,8,2340,0,47.4832,-121.772,2790,5684,7511,8474,2340,6,6
3,2,1410,10015,1,0,3,3,6,1410,0,47.4948,-121.776,1570,10485,11425,12055,1410,26,26
4,2.75,3980,285318,2,0,2,3,9,3980,0,47.4803,-121.795,2100,105415,289298,107515,3980,13,13
3,1,1170,62290,2,0,0,3,5,1170,0,47.5104,-121.787,1810,42173,63460,43983,1170,33,33
3,2.5,1980,9725,2,0,0,3,8,1980,0,47.4856,-121.802,2070,9834,11705,11904,1980,25,25
3,1,1010,10800,1,0,0,4,7,1010,0,47.4483,-121.773,1370,9500,11810,10870,1010,47,47
2,1,1000,31838,1,0,0,3,7,1000,0,47.4789,-121.779,1490,39747,32838,41237,1000,57,57
2,1,1010,3000,1,0,0,4,7,1010,0,47.4965,-121.785,1150,7000,4010,8150,1010,94,94
3,2,930,11475,1,0,0,3,7,930,0,47.4644,-121.745,1280,11250,12405,12530,930,41,41
2,1.75,1620,113862,1,0,0,3,7,1620,0,47.4821,-121.719,1560,54806,115482,56366,1620,24,24
3,2.5,2330,33750,2,0,0,3,9,2330,0,47.4787,-121.723,2270,35000,36080,37270,2330,36,14
2,1,900,57063,1,0,0,4,6,900,0,47.4735,-121.786,1440,268765,57963,270205,900,81,81
4,4.5,4920,270236,2,0,3,3,10,3820,1100,47.4695,-121.775,4920,260924,275156,265844,4920,13,13
3,1,1330,20562,1,0,0,3,5,1330,0,47.4807,-121.775,1350,20562,21892,21912,1330,60,60
3,1.75,1630,11800,1,0,0,4,7,1630,0,47.4863,-121.73,2090,57428,13430,59518,1630,48,48
3,1.75,1890,11875,1,0,0,3,7,1230,660,47.4472,-121.774,1580,10920,13765,12500,1890,40,40
3,2,1600,13200,1,0,0,3,7,1600,0,47.4656,-121.756,1360,11520,14800,12880,1600,29,29
3,2,1540,10931,1,0,3,3,7,1540,0,47.495,-121.776,1570,10485,12471,12055,1540,30,30
3,3,2640,5978,2,0,0,3,9,2640,0,47.4759,-121.735,2680,6060,8618,8740,2640,7,7
3,3.5,3820,145054,2,0,3,3,9,2870,950,47.4419,-121.736,2500,95950,148874,98450,3820,20,20
3,1.5,1390,13860,2,0,0,3,7,1390,0,47.4704,-121.747,1390,11860,15250,13250,1390,40,40
3,2.5,1870,9825,1,0,0,4,7,1250,620,47.4639,-121.744,1380,11475,11695,12855,1870,25,25
1,0,600,24501,1,0,0,2,3,600,0,47.5316,-121.749,990,22549,25101,23539,600,69,69
4,2.75,2790,8853,2,0,0,3,8,2790,0,47.4842,-121.772,2790,8092,11643,10882,2790,6,6
4,2.5,2660,35010,2,0,2,3,9,2660,0,47.4816,-121.714,2330,35448,37670,37778,2660,26,26
3,1,1200,15843,1,0,2,3,7,1200,0,47.4991,-121.779,1410,15843,17043,17253,1200,64,64
4,2.5,2520,9684,2,0,0,3,8,2520,0,47.4848,-121.801,2090,10133,12204,12223,2520,25,25
4,2.75,1790,47250,1,0,0,3,7,1220,570,47.5302,-121.746,1250,43791,49040,45041,1790,32,32
3,1.5,1500,11975,1,0,0,4,7,1500,0,47.4658,-121.758,1510,13875,13475,15385,1500,49,49
3,2.25,2450,49658,1,0,0,3,7,1770,680,47.486,-121.726,1340,121097,52108,122437,2450,41,41
3,1.75,1510,15744,1,0,0,3,7,1510,0,47.476,-121.755,1470,15744,17254,17214,1510,34,34
3,2,1680,11250,1,0,0,4,8,1680,0,47.4861,-121.786,1760,12160,12930,13920,1680,52,52
3,2.5,1670,22703,1,0,0,3,7,1310,360,47.4708,-121.756,1510,16817,24373,18327,1670,31,31
3,1,1260,9600,1,0,0,3,7,1260,0,47.4444,-121.762,1530,9790,10860,11320,1260,49,20
3,2.5,2320,36847,2,0,2,3,9,2320,0,47.4838,-121.714,2550,35065,39167,37615,2320,27,27
3,2,1460,11481,1,0,0,2,7,1170,290,47.4493,-121.777,1540,9680,12941,11220,1460,24,24
4,2.75,2790,5527,2,0,0,3,8,2790,0,47.4827,-121.773,2620,5509,8317,8129,2790,5,5
3,2.5,2400,81892,2,0,0,3,8,2400,0,47.5028,-121.769,1370,37270,84292,38640,2400,34,34
4,1,1520,80150,1,0,0,2,5,1520,0,47.4742,-121.769,1740,84506,81670,86246,1520,71,71
3,2.5,1260,11877,1,0,0,3,7,1260,0,47.4442,-121.762,1430,9790,13137,11220,1260,44,44
3,1.5,1370,11400,2,0,0,3,7,1370,0,47.4477,-121.77,1390,9600,12770,10990,1370,39,39
4,2.5,2180,9861,2,0,2,3,8,2180,0,47.4817,-121.802,2390,9761,12041,12151,2180,22,22
3,2.5,1920,9625,2,0,0,3,8,1920,0,47.4876,-121.8,1920,10343,11545,12263,1920,26,26
3,1,1370,11050,1,0,0,3,7,1370,0,47.4485,-121.776,1520,10000,12420,11520,1370,38,38
4,2.75,2910,6334,2,0,0,3,8,2910,0,47.4826,-121.771,2790,6352,9244,9142,2910,6,6
3,1,1380,10875,1,0,0,3,7,1380,0,47.4653,-121.745,1040,10875,12255,11915,1380,42,42
5,3,2240,94960,1,0,0,3,6,2240,0,47.481,-121.788,1780,43400,97200,45180,2240,34,34
4,2.5,2680,5539,2,0,0,3,8,2680,0,47.4759,-121.734,2680,5992,8219,8672,2680,6,6
3,1.5,1140,20383,1,0,0,3,7,840,300,47.4755,-121.758,1200,15625,21523,16825,1140,34,34
4,2.5,2300,19250,1,0,0,4,7,2300,0,47.4793,-121.776,1460,19250,21550,20710,2300,64,64
3,2.5,1270,9675,2,0,0,3,8,1270,0,47.4639,-121.744,1270,11700,10945,12970,1270,26,26
5,1.75,1830,47916,1,0,0,3,6,1830,0,47.4881,-121.777,2010,13135,49746,15145,1830,71,71
3,1.75,1120,10450,1,0,0,3,7,1120,0,47.4418,-121.772,1250,10414,11570,11664,1120,46,46
4,2.5,2320,11717,2,0,0,3,8,2320,0,47.484,-121.78,2320,9714,14037,12034,2320,22,22
3,1.5,2520,37616,1,0,0,3,8,2520,0,47.4777,-121.763,1470,33750,40136,35220,2520,64,64
3,1.5,1570,12196,1,0,0,4,7,1570,0,47.4866,-121.786,1740,12196,13766,13936,1570,47,47
3,2.5,2320,15024,2,0,0,3,8,2320,0,47.4829,-121.766,2300,15145,17344,17445,2320,29,29
3,3,2340,5002,2,0,0,3,8,2340,0,47.4831,-121.773,2790,5375,7342,8165,2340,6,6
3,1.5,1140,15890,1,0,0,3,7,840,300,47.4752,-121.757,1200,15247,17030,16447,1140,34,34
3,1.5,1360,9760,1,0,0,5,7,1360,0,47.4648,-121.757,1310,11456,11120,12766,1360,35,35
3,1.75,1430,9857,1,0,2,4,7,1140,290,47.4964,-121.771,1310,9880,11287,11190,1430,39,39
3,1.75,1140,22267,1,0,0,3,7,1140,0,47.4761,-121.758,1150,15625,23407,16775,1140,33,33
4,3.5,4030,1024068,2,0,0,3,10,4030,0,47.4619,-121.744,1830,11700,1028098,13530,4030,13,13
4,2.75,2790,8092,2,0,0,3,8,2790,0,47.4834,-121.773,2790,6154,10882,8944,2790,6,6
3,1.75,1180,14292,1,0,0,3,7,1180,0,47.4818,-121.733,1480,14400,15472,15880,1180,38,38
3,2.5,2210,8010,2,0,0,3,8,2210,0,47.4845,-121.775,2430,9600,10220,12030,2210,21,21
3,2.25,2680,41804,1,0,0,3,9,2680,0,47.4828,-121.73,2680,40866,44484,43546,2680,30,30
3,2,1110,10500,1,0,0,5,7,1110,0,47.4456,-121.773,1230,10395,11610,11625,1110,41,41
4,2.5,2680,5539,2,0,0,3,8,2680,0,47.4759,-121.734,2680,5992,8219,8672,2680,6,6
3,2.5,2780,32880,1,0,0,3,9,2780,0,47.4798,-121.727,2780,40091,35660,42871,2780,26,26
5,2.5,3280,6553,2,0,0,3,9,3280,0,47.475,-121.737,3360,7242,9833,10602,3280,7,7
4,2.5,2400,8320,2,0,0,3,8,2400,0,47.4808,-121.781,2430,9258,10720,11688,2400,20,20
3,1,1600,12566,1,0,0,4,7,1600,0,47.4431,-121.765,1600,10650,14166,12250,1600,48,48
4,3,3400,292723,2,0,0,3,10,3400,0,47.4883,-121.725,1760,69696,296123,71456,3400,21,21
3,1.75,4060,136290,1,0,0,3,8,2810,1250,47.4843,-121.719,1300,51836,140350,53136,4060,24,24
3,2.5,2780,275033,1,0,0,3,10,2780,0,47.4496,-121.766,1680,16340,277813,18020,2780,13,13
3,2.25,1690,14615,2,0,0,4,7,1690,0,47.4492,-121.78,1390,11360,16305,12750,1690,40,40
3,1.75,2370,9750,1,0,0,4,7,1280,1090,47.4459,-121.773,1230,9775,12120,11005,2370,40,40
3,1,1250,9775,1,0,0,3,7,1250,0,47.4474,-121.771,1390,9650,11025,11040,1250,48,48
4,2.25,1790,42000,1,0,0,3,7,1170,620,47.4819,-121.744,2060,50094,43790,52154,1790,36,36
3,2.5,2380,214315,1,0,0,3,9,2380,0,47.4525,-121.748,2400,68824,216695,71224,2380,19,19
4,2.25,1600,15312,1,0,0,4,7,1080,520,47.4629,-121.743,1620,12375,16912,13995,1600,40,40
3,1.75,1300,12378,1,0,0,4,6,1300,0,47.4996,-121.778,1300,11596,13678,12896,1300,76,76
3,2.25,1780,191228,2,0,2,3,8,1780,0,47.4575,-121.748,2440,87120,193008,89560,1780,31,31
3,1.75,1660,10440,1,0,0,3,7,1040,620,47.4448,-121.77,1240,10380,12100,11620,1660,41,41
4,2.5,2330,9928,2,0,0,3,8,2330,0,47.4836,-121.783,2430,8175,12258,10605,2330,21,21
3,2.5,2040,9622,2,0,0,3,8,2040,0,47.4833,-121.8,2390,9868,11662,12258,2040,24,24
3,1.5,1180,10277,1,0,0,3,6,1180,0,47.488,-121.787,1680,11104,11457,12784,1180,36,36
3,1.75,1390,9000,1,0,0,4,7,1390,0,47.4469,-121.772,1400,9697,10390,11097,1390,41,41
4,2.75,2790,6969,2,0,0,3,8,2790,0,47.4836,-121.769,2620,6307,9759,8927,2790,7,7
3,1.5,1140,10300,1,0,0,4,6,1140,0,47.4452,-121.77,1250,9975,11440,11225,1140,52,52
3,1.75,1220,7250,1,0,0,3,7,1220,0,47.4887,-121.784,1700,15251,8470,16951,1220,57,57
4,2,980,10640,1,0,0,5,7,980,0,47.4462,-121.773,1230,9750,11620,10980,980,41,41
2,1,1020,9200,1,0,0,3,7,1020,0,47.4461,-121.769,1520,9600,10220,11120,1020,41,41
3,2.5,2210,9226,2,0,0,3,8,2210,0,47.4849,-121.782,2430,8902,11436,11332,2210,21,21
4,2.5,1900,15123,2,0,0,3,8,1900,0,47.5015,-121.772,1900,16477,17023,18377,1900,24,24
4,2.75,2620,7001,2,0,0,3,8,2620,0,47.4838,-121.769,2620,6543,9621,9163,2620,7,7
4,3.75,4030,503989,2,0,0,3,10,4030,0,47.4807,-121.795,2110,71874,508019,73984,4030,11,11
3,2,1930,12443,1,0,0,3,7,1930,0,47.4906,-121.775,1400,12183,14373,13583,1930,50,50
3,1.75,1510,8400,1,0,0,2,7,980,530,47.4476,-121.771,1500,10125,9910,11625,1510,40,40
3,2.25,1680,57063,2,0,0,4,8,1680,0,47.4669,-121.765,1910,57063,58743,58973,1680,30,30
3,1.75,1230,10725,1,0,0,3,7,1230,0,47.4431,-121.772,1250,10170,11955,11420,1230,39,39
3,2.25,1360,9600,2,0,0,3,7,1360,0,47.4687,-121.749,1200,10400,10960,11600,1360,27,27
3,2,1840,40438,2,0,0,3,7,1840,0,47.4853,-121.709,1380,44049,42278,45429,1840,25,25
3,1.75,1390,13200,2,0,0,3,7,1390,0,47.4429,-121.771,1430,10725,14590,12155,1390,40,40
4,2,2020,48693,1,0,0,3,7,2020,0,47.4646,-121.759,1610,34900,50713,36510,2020,70,70
3,2,1210,14499,1,0,0,3,7,1210,0,47.4705,-121.754,1570,15360,15709,16930,1210,35,35
3,2.5,2430,88426,1,0,0,4,7,1570,860,47.4828,-121.718,1560,56827,90856,58387,2430,34,34
3,1,1020,8625,1,0,0,3,7,1020,0,47.4465,-121.77,1290,9440,9645,10730,1020,41,41
4,2.5,3130,40918,2,0,0,3,9,3130,0,47.4761,-121.723,2760,35440,44048,38200,3130,25,25
4,1.75,1670,13125,1,0,0,5,8,1670,0,47.6315,-122.101,2360,12500,14795,14860,1670,46,46
6,2.5,3190,12196,2,0,0,4,8,3190,0,47.6309,-122.103,2790,13068,15386,15858,3190,40,40
2,2,1350,2560,1,0,0,3,8,1350,0,47.6344,-122.107,1790,2560,3910,4350,1350,43,43
4,2.75,3100,7501,2,0,0,3,10,3100,0,47.6859,-122.109,3140,8672,10601,11812,3100,21,21
4,1.75,1570,7650,1,0,0,3,7,1100,470,47.6801,-122.106,1580,7650,9220,9230,1570,44,44
4,2.75,2990,4298,2,0,0,3,9,2990,0,47.7101,-122.108,2990,4837,7288,7827,2990,5,5
3,2,1620,8400,1,0,0,3,7,1180,440,47.6574,-122.128,2120,8424,10020,10544,1620,51,51
5,4,4180,7232,2,0,0,3,9,4180,0,47.7049,-122.125,3570,6054,11412,9624,4180,5,5
4,2.5,2540,4241,2,0,0,3,8,2540,0,47.7073,-122.112,3010,4929,6781,7939,2540,10,10
4,2.75,2990,6626,2,0,0,3,9,2990,0,47.7107,-122.11,2910,5533,9616,8443,2990,5,5
3,1.75,1270,7700,1,0,0,4,7,1270,0,47.6711,-122.148,1510,7700,8970,9210,1270,51,51
5,2.5,3670,8960,1,0,0,3,8,3670,0,47.6654,-122.142,2340,9425,12630,11765,3670,46,46
4,2.5,3360,15091,2,0,0,3,9,3360,0,47.6649,-122.135,1930,9936,18451,11866,3360,22,22
4,2.5,3310,5101,2,0,0,3,9,3310,0,47.6649,-122.08,3010,5176,8411,8186,3310,14,14
3,1,1410,8925,1,0,0,3,7,1410,0,47.6782,-122.162,1330,8925,10335,10255,1410,61,61
3,1,1110,7128,1,0,0,3,7,1110,0,47.6968,-122.124,1510,7107,8238,8617,1110,39,39
3,2,1430,9250,1,0,0,4,8,990,440,47.6952,-122.096,1830,8003,10680,9833,1430,36,36
3,1,1440,7107,1,0,0,4,7,1000,440,47.6968,-122.124,1540,7140,8547,8680,1440,39,39
4,2.5,2700,8810,2,0,0,3,9,2700,0,47.7041,-122.116,2730,5100,11510,7830,2700,15,15
3,2.5,1710,2300,2,0,0,3,8,1570,140,47.6743,-122.142,2120,2856,4010,4976,1710,14,14
4,2.5,2370,10000,1,0,0,5,8,1660,710,47.6383,-122.099,2480,9875,12370,12355,2370,45,45
3,2.5,2390,9157,2,0,0,3,9,2390,0,47.6617,-122.15,2360,8250,11547,10610,2390,35,35
3,2,1490,7431,1,0,0,4,7,1490,0,47.6697,-122.162,1700,7725,8921,9425,1490,53,53
4,1.75,2300,11700,1,0,0,4,9,1960,340,47.6331,-122.094,2840,12000,14000,14840,2300,42,42
4,4.5,4040,8400,2,0,0,3,9,3220,820,47.7067,-122.131,3940,8400,12440,12340,4040,13,13
3,2.25,2330,11424,2,0,0,4,8,2330,0,47.6386,-122.11,2050,11448,13754,13498,2330,35,35
4,2.75,2020,10720,1,0,0,4,8,1420,600,47.6373,-122.104,2190,10164,12740,12354,2020,43,43
4,1.75,2020,7029,1,0,0,4,7,1430,590,47.6983,-122.127,1780,7200,9049,8980,2020,40,40
2,1.5,1310,12196,1,0,0,3,6,1310,0,47.6487,-122.122,2970,12196,13506,15166,1310,49,49
3,2.5,2670,12187,2,0,0,3,8,2670,0,47.6677,-122.15,2400,8999,14857,11399,2670,33,33
3,1.75,1750,12325,1,0,0,4,7,1470,280,47.6832,-122.118,1820,9750,14075,11570,1750,51,51
3,2.25,1830,7897,1,0,0,4,8,1290,540,47.6914,-122.103,1990,8306,9727,10296,1830,33,33
3,2,2290,11200,2,0,0,3,9,2290,0,47.6517,-122.124,2250,10000,13490,12250,2290,40,40
4,2.25,2470,7350,1,0,0,3,7,1600,870,47.6936,-122.128,1970,7700,9820,9670,2470,41,41
4,2.5,3480,6315,2,0,0,3,9,2360,1120,47.6841,-122.161,3620,5233,9795,8853,3480,19,19
3,2.5,2210,7620,2,0,0,3,8,2210,0,47.6938,-122.13,1920,7440,9830,9360,2210,25,25
3,2.25,1660,10140,1,0,0,4,8,1370,290,47.6889,-122.128,2100,10125,11800,12225,1660,39,39
4,2.5,1850,7850,2,0,0,3,8,1850,0,47.6914,-122.103,1830,8140,9700,9970,1850,34,34
3,2.5,1650,3711,2,0,0,3,8,1650,0,47.6863,-122.093,1760,3762,5361,5522,1650,23,23
3,1.75,1300,8480,1,0,0,3,7,1300,0,47.6991,-122.13,1740,7280,9780,9020,1300,50,50
3,1.75,1470,7350,1,0,0,3,8,1470,0,47.6687,-122.154,1470,7350,8820,8820,1470,56,56
5,2.25,3040,8111,2,0,0,3,8,3040,0,47.7157,-122.103,2020,8304,11151,10324,3040,35,35
4,2,1700,21780,1,0,0,4,6,1080,620,47.6289,-122.108,2070,12054,23480,14124,1700,79,79
4,2,2420,10735,1,0,0,3,7,2420,0,47.6899,-122.122,1570,9540,13155,11110,2420,52,52
3,3.25,3060,9055,2,0,0,3,10,2460,600,47.6971,-122.101,2990,9598,12115,12588,3060,25,25
4,1.75,1840,9600,1,0,0,3,7,1220,620,47.6579,-122.125,1770,9720,11440,11490,1840,52,52
4,2.5,2230,8624,1,0,0,4,8,1430,800,47.6623,-122.152,1970,8402,10854,10372,2230,50,50
4,2.5,3400,9692,2,0,0,3,9,3400,0,47.708,-122.109,3070,7375,13092,10445,3400,12,12
3,1,1270,8800,1,0,0,3,7,1270,0,47.6703,-122.15,1560,8250,10070,9810,1270,51,51
3,2.5,1770,3205,2,0,0,3,9,1770,0,47.6658,-122.084,2120,4134,4975,6254,1770,14,14
3,2.25,2220,12056,2,0,0,3,8,2220,0,47.7148,-122.101,2320,12025,14276,14345,2220,34,34
5,2.5,2620,8050,1,0,0,3,8,1520,1100,47.6919,-122.115,2030,7676,10670,9706,2620,44,44
3,3,2960,42159,2,0,0,3,10,2960,0,47.7183,-122.1,2640,25209,45119,27849,2960,24,24
4,3.5,3560,7178,2,0,3,3,10,2590,970,47.7054,-122.107,3290,6978,10738,10268,3560,13,13
5,2.5,3110,15783,1,0,0,3,8,1720,1390,47.6301,-122.103,2550,12220,18893,14770,3110,45,45
4,2.5,3150,5979,2,0,0,3,9,3150,0,47.7082,-122.101,3150,6595,9129,9745,3150,14,14
4,2.5,2620,19864,2,0,0,4,8,2620,0,47.7014,-122.122,2500,13285,22484,15785,2620,35,35
5,2,3180,10800,1,0,0,3,8,1910,1270,47.6354,-122.103,2440,9750,13980,12190,3180,51,51
4,2.5,2150,9070,2,0,0,4,8,2150,0,47.7279,-122.107,2230,8995,11220,11225,2150,34,34
3,2,2480,13310,1,0,0,2,7,2480,0,47.6759,-122.114,2400,11340,15790,13740,2480,64,64
3,1.75,960,8106,1,0,0,3,7,960,0,47.6737,-122.156,1650,8035,9066,9685,960,57,57
4,3.5,3030,5494,3,0,0,3,9,3030,0,47.7103,-122.109,2910,5314,8524,8224,3030,5,5
4,1.75,2260,9703,1,0,0,2,8,1660,600,47.6622,-122.145,2390,8455,11963,10845,2260,41,41
3,2.5,2610,7567,2,0,0,3,9,2610,0,47.6654,-122.137,2610,8458,10177,11068,2610,22,22
3,2.5,3050,33920,1,0,0,3,8,3050,0,47.7034,-122.072,1970,60984,36970,62954,3050,15,15
4,2.5,2260,5172,2,0,0,3,9,2260,0,47.7047,-122.128,2680,5172,7432,7852,2260,15,15
4,3,2170,8240,1,0,0,4,8,1370,800,47.6291,-122.093,2020,7944,10410,9964,2170,51,51
4,2,2800,8540,1,0,0,4,8,1730,1070,47.6869,-122.126,2470,9400,11340,11870,2800,42,42
3,2.5,1520,3425,2,0,0,3,7,1520,0,47.6801,-122.161,1640,3425,4945,5065,1520,33,33
4,2.75,1680,11180,1,0,0,4,7,1680,0,47.6557,-122.127,2400,9627,12860,12027,1680,53,53
4,2.5,3930,21894,2,0,0,3,11,3930,0,47.7209,-122.128,3930,20000,25824,23930,3930,32,32
3,2.25,3020,13031,2,0,0,3,9,3020,0,47.6897,-122.098,2480,10204,16051,12684,3020,30,30
5,3.5,3740,11340,2,0,0,3,10,3740,0,47.6628,-122.143,2040,8715,15080,10755,3740,6,6
3,1.75,2300,11400,1,0,0,4,8,1520,780,47.6884,-122.128,2300,10140,13700,12440,2300,42,42
4,3,2570,8022,1,0,0,4,8,1370,1200,47.6956,-122.099,2090,8022,10592,10112,2570,35,35
6,3.5,2580,13572,1,0,0,3,8,1290,1290,47.6796,-122.113,2020,11656,16152,13676,2580,32,32
3,2.5,3180,10492,2,0,2,3,10,3180,0,47.655,-122.124,3000,9812,13672,12812,3180,28,28
3,2.5,1360,3188,2,0,0,3,7,1360,0,47.6831,-122.096,1090,3188,4548,4278,1360,33,33
3,2.25,2610,9002,2,0,0,3,9,2610,0,47.6909,-122.104,2320,8306,11612,10626,2610,31,31
3,1.75,2060,12558,1,0,0,4,7,1350,710,47.6659,-122.144,1850,8722,14618,10572,2060,35,35
4,2.5,2330,7064,1,0,0,4,8,1780,550,47.6955,-122.097,1740,8075,9394,9815,2330,35,35
4,3.5,3780,7769,2,0,0,3,9,3110,670,47.691,-122.129,3310,7945,11549,11255,3780,18,18
3,2.5,3560,11448,2,0,0,3,11,3560,0,47.7126,-122.104,3290,11506,15008,14796,3560,22,22
4,2.5,1740,7500,1,0,0,4,7,1220,520,47.6927,-122.124,1790,7350,9240,9140,1740,43,43
4,2.5,2170,9600,1,0,0,3,7,1460,710,47.6789,-122.116,1940,8400,11770,10340,2170,39,39
3,2.5,2460,12028,2,0,0,3,9,2460,0,47.691,-122.095,2540,12229,14488,14769,2460,23,23
3,1,1310,3963,1,0,0,5,7,1310,0,47.6826,-122.096,1010,3363,5273,4373,1310,33,33
4,2,2030,9300,1,0,0,4,8,2030,0,47.6658,-122.149,1800,9018,11330,10818,2030,43,43
3,2,1460,10311,1,0,0,4,7,1460,0,47.6771,-122.156,1690,9679,11771,11369,1460,44,44
5,2.5,2040,9597,1,0,0,4,7,1240,800,47.6544,-122.134,1800,8553,11637,10353,2040,56,56
3,1.75,2080,12714,2,0,0,4,8,1540,540,47.7056,-122.162,2080,12107,14794,14187,2080,35,35
4,2.5,2150,12028,2,0,0,4,8,2150,0,47.7224,-122.101,1800,11777,14178,13577,2150,37,37
3,1.75,2380,10450,1,0,0,3,8,1400,980,47.6409,-122.111,2150,9600,12830,11750,2380,42,42
4,2.5,2500,8434,2,0,0,4,8,2500,0,47.6915,-122.101,1900,8131,10934,10031,2500,31,31
3,2.5,1340,10018,1,0,0,4,7,1340,0,47.6366,-122.094,2520,13068,11358,15588,1340,43,43
3,2,2080,12094,2,0,0,4,8,2080,0,47.7035,-122.164,2230,12204,14174,14434,2080,37,37
4,2.5,2930,9158,2,0,0,3,9,2930,0,47.7065,-122.13,3590,8065,12088,11655,2930,14,14
5,3,2670,11761,1,0,0,3,7,1370,1300,47.6895,-122.129,2580,10703,14431,13283,2670,38,38
3,1.75,1520,9605,1,0,0,3,7,1520,0,47.667,-122.142,2040,9900,11125,11940,1520,44,44
3,2.25,1800,6875,1,0,0,4,8,1230,570,47.6773,-122.11,1800,8749,8675,10549,1800,45,45
4,2.5,2540,28563,1,0,0,3,10,2540,0,47.7185,-122.114,2790,20301,31103,23091,2540,35,35
3,1,2298,10140,1,0,0,3,7,2298,0,47.6909,-122.083,2580,24724,12438,27304,2298,50,50
4,2.5,3560,5265,3,0,0,3,8,3560,0,47.7047,-122.113,3220,4892,8825,8112,3560,5,5
5,2.5,3450,35880,2,0,0,3,11,3450,0,47.7173,-122.099,3450,26820,39330,30270,3450,27,27
4,3.5,2770,3330,2,0,0,3,8,1970,800,47.6327,-122.109,2180,3380,6100,5560,2770,18,18
3,1.75,1610,11950,1,0,2,3,7,1210,400,47.6705,-122.138,1610,9363,13560,10973,1610,35,35
4,1.75,1720,6975,1,0,0,3,8,1420,300,47.6506,-122.121,2210,7875,8695,10085,1720,44,44
3,2.5,1750,3900,2,0,0,3,8,1750,0,47.6638,-122.129,1750,5700,5650,7450,1750,42,42
3,2.5,2480,5137,2,0,0,3,9,2480,0,47.684,-122.164,2480,6023,7617,8503,2480,19,19
4,2.25,1970,7532,1,0,0,3,8,1390,580,47.7219,-122.109,1970,8248,9502,10218,1970,36,36
4,2.5,2460,4425,2,0,0,3,8,2460,0,47.7048,-122.109,2990,5659,6885,8649,2460,13,13
2,2,1610,6160,2,0,0,4,8,1610,0,47.6644,-122.13,1750,6305,7770,8055,1610,42,42
3,4,4380,42769,2,0,0,5,11,4380,0,47.7167,-122.109,3630,35425,47149,39055,4380,36,36
4,2.5,1940,7607,2,0,0,3,8,1940,0,47.685,-122.158,2250,7600,9547,9850,1940,24,24
3,1,1300,5880,1,0,0,3,7,1300,0,47.6937,-122.113,1300,7700,7180,9000,1300,51,51
4,1.75,1650,8560,1,0,0,3,8,1650,0,47.6652,-122.146,1700,8560,10210,10260,1650,49,49
4,2.75,3100,10245,2,0,0,3,10,3100,0,47.6858,-122.107,3140,9028,13345,12168,3100,20,20
5,3.5,4200,5400,2,0,0,3,9,3140,1060,47.7077,-122.12,3300,5564,9600,8864,4200,7,7
3,1.75,1850,7056,2,0,0,4,8,1850,0,47.6602,-122.13,1970,7056,8906,9026,1850,40,40
3,3,2630,4896,2,0,0,3,9,2630,0,47.6932,-122.133,2880,4972,7526,7852,2630,13,13
4,3,3070,7150,2,0,0,3,9,3070,0,47.7079,-122.107,3200,6984,10220,10184,3070,12,12
5,3.5,3490,21780,2,0,0,3,8,3490,0,47.6707,-122.144,3070,7829,25270,10899,3490,23,23
3,1.75,1070,8030,1,0,0,3,7,1070,0,47.67,-122.155,1540,7875,9100,9415,1070,53,0
4,3.25,3340,10890,1,0,0,3,9,2240,1100,47.6677,-122.136,2880,9794,14230,12674,3340,56,14
5,2.75,3150,7119,2,0,0,3,9,3150,0,47.6759,-122.151,1560,8384,10269,9944,3150,6,6
4,2.5,3570,6218,2,0,0,3,9,3570,0,47.7046,-122.123,3230,5972,9788,9202,3570,5,5
3,1.75,1370,8467,1,0,0,4,7,970,400,47.6644,-122.145,1650,8472,9837,10122,1370,47,47
3,1.75,1310,9282,1,0,0,4,7,1310,0,47.6844,-122.111,1310,8748,10592,10058,1310,43,43
3,2.5,2680,5497,2,0,0,3,9,2680,0,47.7043,-122.128,2780,5497,8177,8277,2680,18,18
2,2,1350,2560,1,0,0,4,8,1350,0,47.6338,-122.106,1800,2560,3910,4360,1350,45,45
4,2.5,2580,15031,2,0,0,3,9,2580,0,47.6895,-122.094,3030,10361,17611,13391,2580,20,20
3,1.75,1450,6829,1,0,0,3,8,1450,0,47.7222,-122.108,1950,7622,8279,9572,1450,36,36
3,1.75,1790,9860,1,0,0,4,7,1410,380,47.6989,-122.12,1820,9555,11650,11375,1790,41,41
3,1.75,1200,7360,1,0,0,4,7,1200,0,47.6979,-122.13,1200,7500,8560,8700,1200,41,41
4,2.5,2650,13684,2,0,0,3,9,2650,0,47.6278,-122.108,2650,12032,16334,14682,2650,25,25
4,2.25,2370,9360,2,0,0,4,8,2370,0,47.6518,-122.123,2370,9720,11730,12090,2370,40,40
3,2.25,1790,11393,1,0,0,3,8,1790,0,47.6297,-122.099,2290,11894,13183,14184,1790,41,41
4,2.75,2510,12500,1,0,0,5,8,2050,460,47.6278,-122.11,2200,12088,15010,14288,2510,43,43
5,2,2190,9072,1,0,0,5,7,1110,1080,47.6696,-122.149,1660,8327,11262,9987,2190,54,54
3,2.5,2020,11935,1,0,0,4,9,2020,0,47.632,-122.092,2410,12350,13955,14760,2020,43,43
4,1.75,1770,9375,1,0,0,4,7,1170,600,47.6935,-122.112,1540,9375,11145,10915,1770,51,51
5,1.75,3290,11900,1,0,0,3,8,3290,0,47.6626,-122.141,2210,8549,15190,10759,3290,46,46
3,1.5,1310,9471,1,0,0,4,8,1310,0,47.6644,-122.148,2100,9449,10781,11549,1310,49,49
3,2.5,2120,3600,2,0,0,3,9,2120,0,47.6649,-122.082,2540,4592,5720,7132,2120,14,14
4,1.75,2430,14000,1,0,0,4,7,1580,850,47.6554,-122.134,1910,8285,16430,10195,2430,56,56
4,1,1700,7689,1,0,0,3,7,1080,620,47.6955,-122.116,1700,7333,9389,9033,1700,42,42
3,1.75,1070,9000,1,0,0,4,7,1070,0,47.6984,-122.132,1700,8400,10070,10100,1070,41,41
4,2.5,2920,7901,2,0,0,3,9,2920,0,47.7036,-122.125,3020,7900,10821,10920,2920,15,15
4,2.5,3760,29224,2,0,0,3,11,3760,0,47.7203,-122.128,3930,19916,32984,23846,3760,32,32
6,2.75,3360,84506,1,0,0,5,7,2040,1320,47.715,-122.121,2190,43124,87866,45314,3360,57,57
3,2.5,1940,8196,2,0,0,3,8,1940,0,47.6786,-122.151,2070,8514,10136,10584,1940,28,28
4,3.5,2510,3763,2,0,0,3,8,1990,520,47.7002,-122.103,2560,3820,6273,6380,2510,6,6
4,2.5,2910,15016,2,0,0,3,10,2910,0,47.69,-122.097,2870,13992,17926,16862,2910,29,29
4,2.5,3550,8618,2,0,0,3,10,3550,0,47.6776,-122.161,1310,9746,12168,11056,3550,12,12
4,2.5,2590,4498,2,0,0,3,9,2590,0,47.7047,-122.128,2660,5238,7088,7898,2590,15,15
3,2.25,1920,9600,1,0,0,4,8,1560,360,47.6341,-122.103,2040,9600,11520,11640,1920,51,51
4,2.25,2560,12100,1,0,0,4,8,1760,800,47.631,-122.108,2240,12100,14660,14340,2560,43,43
3,2.25,1640,8625,1,0,0,3,8,1320,320,47.6772,-122.153,1770,9476,10265,11246,1640,32,32
4,2.5,3430,7508,2,0,0,3,10,3430,0,47.6866,-122.11,3110,8741,10938,11851,3430,21,21
4,4.25,4980,13000,2,0,3,3,9,3080,1900,47.6406,-122.101,2840,11308,17980,14148,4980,37,37
3,1.75,1970,8000,1,0,0,4,8,1970,0,47.6324,-122.1,1910,8000,9970,9910,1970,51,51
3,2.75,2180,7519,1,0,0,4,7,1310,870,47.6959,-122.125,1510,7107,9699,8617,2180,38,38
3,2.5,3420,79279,2,0,0,3,11,3420,0,47.7225,-122.126,4240,40500,82699,44740,3420,29,29
5,2.25,3220,9603,2,0,0,3,8,3220,0,47.6474,-122.11,2260,10093,12823,12353,3220,47,47
3,2.5,3290,6830,2,0,0,3,10,3290,0,47.6702,-122.142,3200,6227,10120,9427,3290,19,19
3,3.5,3190,10223,2,0,0,3,10,2560,630,47.6968,-122.102,3120,9735,13413,12855,3190,25,25
4,2.5,2660,10452,2,0,0,3,9,2660,0,47.6972,-122.104,2890,9025,13112,11915,2660,26,26
4,3.25,3530,20012,2,0,0,3,11,3530,0,47.7193,-122.127,3850,20707,23542,24557,3530,33,33
4,2.5,2880,9202,1,0,0,3,8,1780,1100,47.6658,-122.139,2500,10265,12082,12765,2880,42,42
4,3.25,4750,62365,2,0,0,3,11,4750,0,47.7149,-122.099,3300,31866,67115,35166,4750,31,31
3,2.75,2640,11957,1,0,0,3,9,2260,380,47.6491,-122.12,2640,12641,14597,15281,2640,41,41
4,3.5,3830,7150,2,0,0,3,9,3830,0,47.7049,-122.126,3640,6055,10980,9695,3830,5,5
3,2.25,2150,9900,1,0,0,3,8,1450,700,47.6647,-122.149,2170,9500,12050,11670,2150,42,42
3,2.25,2910,10204,2,0,0,3,9,2910,0,47.6897,-122.098,2700,13992,13114,16692,2910,29,29
4,2.5,2330,31705,2,0,0,4,8,2330,0,47.6471,-122.03,2460,36600,34035,39060,2330,39,39
3,2,1340,9764,1,0,0,3,7,1340,0,47.6786,-122.161,1310,9764,11104,11074,1340,75,75
4,3.75,3210,7054,2,0,0,4,8,3210,0,47.7268,-122.103,2350,8020,10264,10370,3210,34,34
3,2.25,2030,7350,1,0,0,4,7,1190,840,47.6939,-122.126,1950,7350,9380,9300,2030,42,42
3,2.5,2250,4134,2,0,0,3,9,2250,0,47.6651,-122.084,2390,4134,6384,6524,2250,15,15
3,1.5,1300,19163,1,0,0,3,7,1300,0,47.6686,-122.153,1590,9744,20463,11334,1300,55,55
5,2.75,3010,12611,2,0,0,3,10,3010,0,47.696,-122.102,2890,9456,15621,12346,3010,25,25
4,2.5,2850,11000,2,0,0,3,8,2850,0,47.6759,-122.161,1720,11000,13850,12720,2850,21,21
4,2.5,2070,7312,1,0,0,4,7,1230,840,47.6958,-122.12,1770,7668,9382,9438,2070,42,42
4,2.5,3090,7112,2,0,0,3,9,3090,0,47.705,-122.118,3050,6000,10202,9050,3090,18,18
3,2.25,2130,12286,2,0,0,3,8,2130,0,47.6471,-122.114,2130,10158,14416,12288,2130,42,42
3,2,2080,12094,2,0,0,4,8,2080,0,47.7035,-122.164,2230,12204,14174,14434,2080,37,37
3,1.75,2390,9000,1,0,0,3,8,1500,890,47.6809,-122.113,2040,9000,11390,11040,2390,44,44
5,3,3290,14134,1,0,0,3,7,1870,1420,47.6708,-122.14,1970,11470,17424,13440,3290,15,15
3,2.75,2810,12813,2,0,0,3,8,2040,770,47.6796,-122.114,1890,10336,15623,12226,2810,31,31
3,2.25,2190,8188,2,0,0,3,8,1810,380,47.6883,-122.113,2190,8374,10378,10564,2190,41,41
3,2.5,2090,6294,2,0,0,3,9,2090,0,47.686,-122.095,2520,5735,8384,8255,2090,15,15
3,1.75,1530,14633,1,0,0,3,7,1100,430,47.6949,-122.119,1780,8100,16163,9880,1530,42,42
5,2.5,2500,7200,1,0,0,4,7,1490,1010,47.6964,-122.12,1960,8325,9700,10285,2500,42,42
4,2.5,2270,7665,2,0,0,3,9,2270,0,47.6612,-122.148,2450,8706,9935,11156,2270,33,33
4,2.75,3020,13530,1,0,0,4,8,1540,1480,47.6299,-122.099,2230,11896,16550,14126,3020,42,42
4,3.25,1690,1321,2,0,0,3,8,1320,370,47.678,-122.117,3080,4558,3011,7638,1690,5,5
4,2.5,2450,27081,2,0,0,3,8,2450,0,47.7177,-122.104,2630,12025,29531,14655,2450,34,34
3,1.5,2170,16600,1,1,2,3,10,1130,1040,47.6307,-122.088,3130,13875,18770,17005,2170,40,40
3,1,940,9198,1,0,0,3,7,940,0,47.6889,-122.117,1430,8370,10138,9800,940,51,51
2,2.5,1700,6635,2,0,0,4,8,1700,0,47.6655,-122.13,1700,6635,8335,8335,1700,43,43
4,2.75,3430,6500,2,0,0,3,9,3050,380,47.7079,-122.106,3070,6802,9930,9872,3430,13,13
4,2.5,1890,8505,1,0,0,3,8,1290,600,47.6796,-122.115,1720,9600,10395,11320,1890,39,39
3,3.25,2030,11070,2,0,0,4,8,2030,0,47.6478,-122.117,2450,11070,13100,13520,2030,39,39
3,1.75,1840,8086,1,0,0,4,8,1840,0,47.67,-122.155,1840,8060,9926,9900,1840,55,55
5,4.25,4640,22703,2,1,4,5,8,2860,1780,47.6393,-122.097,3140,14200,27343,17340,4640,67,67
4,2.75,3130,13412,2,0,0,3,9,2140,990,47.6993,-122.102,2260,9984,16542,12244,3130,26,26
5,2.75,3000,9473,1,0,0,3,8,1500,1500,47.6567,-122.13,2050,8820,12473,10870,3000,53,53
5,2.75,2880,4425,2,0,0,3,8,2880,0,47.7048,-122.109,2940,6581,7305,9521,2880,14,14
5,3.5,3600,9312,2,0,3,3,10,2680,920,47.6582,-122.122,3420,9860,12912,13280,3600,14,14
5,3.5,3290,5600,2,0,0,3,9,2670,620,47.7056,-122.119,3130,5600,8890,8730,3290,15,15
6,4.5,3300,7480,2,0,0,3,8,3300,0,47.6796,-122.104,2470,7561,10780,10031,3300,39,39
3,2.5,2030,10958,2,0,0,3,8,2030,0,47.7251,-122.11,1960,10282,12988,12242,2030,36,36
4,2.5,3020,13122,2,0,0,3,9,2540,480,47.6989,-122.111,3020,10873,16142,13893,3020,22,22
4,2.5,3000,5639,2,0,0,3,8,3000,0,47.7066,-122.115,3000,4587,8639,7587,3000,11,11
3,1.75,1430,11761,1,0,0,4,8,1430,0,47.6686,-122.157,2040,10035,13191,12075,1430,55,55
4,2.5,2970,4400,2,0,0,3,8,2970,0,47.705,-122.114,3010,4892,7370,7902,2970,5,5
3,2.5,1360,3718,2,0,0,3,7,1360,0,47.6827,-122.097,1090,3718,5078,4808,1360,32,32
4,2.25,2060,8767,2,0,0,3,8,2060,0,47.7228,-122.103,1610,8062,10827,9672,2060,36,36
4,4.75,4150,6303,3,0,0,3,9,4150,0,47.7047,-122.123,3570,6285,10453,9855,4150,5,5
5,2.75,2830,5310,2,0,0,3,9,2830,0,47.7074,-122.101,3150,6581,8140,9731,2830,13,13
3,2.5,2440,4587,2,0,0,3,8,2440,0,47.7073,-122.114,2750,4587,7027,7337,2440,9,9
4,2.5,3650,7784,2,0,0,3,9,3650,0,47.7066,-122.101,3150,6442,11434,9592,3650,13,13
4,2.5,2490,5170,2,0,0,4,9,2490,0,47.6836,-122.162,2490,5170,7660,7660,2490,19,19
5,1.75,2030,12342,2,0,0,4,7,2030,0,47.6417,-122.109,2500,9433,14372,11933,2030,77,77
3,2.25,1780,8050,1,0,0,4,7,1230,550,47.6977,-122.126,1780,7200,9830,8980,1780,40,40
3,1,1060,9525,1,0,0,3,7,1060,0,47.6855,-122.111,1630,9525,10585,11155,1060,53,53
3,2.25,1380,3015,2,0,0,3,7,1380,0,47.6783,-122.157,1930,3612,4395,5542,1380,10,10
4,2.5,2480,4602,2,0,0,3,9,2480,0,47.6835,-122.161,3480,5739,7082,9219,2480,19,19
3,1,1150,10196,1,0,0,4,7,1150,0,47.6788,-122.162,1410,8925,11346,10335,1150,62,62
4,2.5,1950,7350,1,0,0,3,7,1150,800,47.656,-122.134,2050,9068,9300,11118,1950,56,56
3,3,2900,11769,2,0,0,3,10,2900,0,47.6993,-122.118,2900,9611,14669,12511,2900,22,22
4,2.75,3590,5625,2,0,0,3,10,3590,0,47.6959,-122.133,3590,5625,9215,9215,3590,7,7
3,1.75,1530,8000,2,0,0,3,7,1530,0,47.6971,-122.13,1530,7500,9530,9030,1530,41,41
4,2.5,2970,5050,2,0,0,3,8,2970,0,47.7043,-122.122,2810,4998,8020,7808,2970,5,5
4,2.75,3110,6050,2,0,0,3,9,3110,0,47.705,-122.126,3590,6054,9160,9644,3110,5,5
3,2.5,2440,4244,2,0,0,3,8,2440,0,47.7057,-122.112,2690,4556,6684,7246,2440,8,8
4,2.75,3550,6558,2,0,0,3,9,3550,0,47.7076,-122.115,3140,5617,10108,8757,3550,6,6
4,1.75,2430,7559,1,0,0,4,8,1580,850,47.7206,-122.11,1980,8750,9989,10730,2430,38,38
6,4.5,3300,7561,2,0,0,3,8,3300,0,47.6795,-122.104,2470,7561,10861,10031,3300,39,39
3,2.5,1720,11656,2,0,0,3,8,1720,0,47.6791,-122.113,1890,10336,13376,12226,1720,32,15
3,1.75,1570,10939,1,0,0,3,8,1200,370,47.6389,-122.102,1760,10200,12509,11960,1570,45,45
3,2.5,1910,3427,2,0,0,3,8,1910,0,47.6324,-122.11,2240,3720,5337,5960,1910,18,18
4,2.5,2520,13156,1,0,0,3,8,1520,1000,47.6558,-122.135,2050,10940,15676,12990,2520,40,40
3,2.5,1970,2752,2,0,0,3,8,1970,0,47.6345,-122.108,1850,2778,4722,4628,1970,41,41
4,2.25,2420,7725,1,0,0,4,8,1890,530,47.6287,-122.093,1740,7944,10145,9684,2420,47,47
3,2.5,2140,2868,2,0,0,3,8,1770,370,47.6668,-122.132,2140,2527,5008,4667,2140,12,12
3,2.75,2740,5735,2,0,0,3,9,2740,0,47.6862,-122.093,2210,5026,8475,7236,2740,15,15
4,2.5,2050,8094,1,0,0,3,8,1050,1000,47.6614,-122.138,1990,9020,10144,11010,2050,43,43
5,3.5,2720,11454,2,0,0,3,9,1830,890,47.6466,-122.119,2920,11310,14174,14230,2720,31,31
3,2.5,3140,9808,2,0,0,3,9,2500,640,47.6383,-122.097,2370,10014,12948,12384,3140,18,18
4,2.5,2360,13500,1,0,0,4,8,1780,580,47.6315,-122.103,2780,12400,15860,15180,2360,46,46
4,2.5,2440,4850,2,0,0,3,8,2440,0,47.7043,-122.114,2970,5450,7290,8420,2440,6,6
4,2.5,3060,6826,2,0,0,3,9,3060,0,47.7006,-122.112,3110,6932,9886,10042,3060,15,15
5,2.25,3000,13899,2,0,0,4,8,3000,0,47.6373,-122.105,2270,10763,16899,13033,3000,44,44
5,1.75,2780,7786,1,0,0,3,8,1390,1390,47.6694,-122.157,2130,7918,10566,10048,2780,53,53
4,2.5,2060,7475,1,0,0,3,8,1440,620,47.7272,-122.105,2280,8396,9535,10676,2060,34,34
3,2.5,3940,10360,2,0,0,3,9,3110,830,47.6468,-122.116,2720,11941,14300,14661,3940,27,27
3,1.5,1610,9964,1,0,0,3,7,1080,530,47.6681,-122.143,1610,9964,11574,11574,1610,42,42
4,2.5,2820,15000,2,0,0,4,9,2820,0,47.7255,-122.101,2440,15000,17820,17440,2820,34,34
3,1.75,1510,10450,1,0,0,4,7,1510,0,47.684,-122.113,1310,9450,11960,10760,1510,55,55
3,1.75,1720,6960,1,0,0,3,7,1140,580,47.6972,-122.129,1720,7280,8680,9000,1720,41,41
3,1.75,1570,15500,1,0,0,4,7,1570,0,47.6916,-122.122,1610,7500,17070,9110,1570,51,51
3,2.25,2190,45738,1,0,0,3,8,2190,0,47.7108,-122.12,2970,4496,47928,7466,2190,29,29
4,1.75,1570,16697,1,0,2,3,7,1030,540,47.671,-122.135,1560,9698,18267,11258,1570,38,38
3,2.5,1710,8998,2,0,0,3,8,1710,0,47.7236,-122.11,1710,9859,10708,11569,1710,37,37
5,3.5,3230,7560,2,0,0,3,10,3230,0,47.6467,-122.118,3230,8580,10790,11810,3230,12,12
3,1.75,1320,6030,1,0,0,4,7,1320,0,47.6993,-122.13,1840,6565,7350,8405,1320,50,50
3,2.5,2330,4160,2,0,0,4,8,2330,0,47.6367,-122.109,2940,4500,6490,7440,2330,27,27
5,2.75,2940,5225,2,0,0,3,8,2760,180,47.6879,-122.107,3090,6261,8165,9351,2940,9,9
4,2.75,3340,5677,2,0,0,3,9,3340,0,47.709,-122.118,3240,5643,9017,8883,3340,8,8
3,1.75,2500,36947,1,0,0,3,9,2500,0,47.6917,-122.084,2590,28837,39447,31427,2500,35,35
4,2.5,3640,6389,2,0,0,3,9,3640,0,47.7049,-122.123,3570,6303,10029,9873,3640,5,5
4,2.5,3080,8451,1,0,0,3,7,1540,1540,47.674,-122.154,1550,8125,11531,9675,3080,50,50
4,2.5,2110,11680,1,0,0,4,7,1420,690,47.6964,-122.118,1890,9600,13790,11490,2110,42,42
3,2,1760,9055,2,0,0,4,7,1760,0,47.6534,-122.128,2010,9383,10815,11393,1760,34,34
3,2.5,2180,11100,1,0,0,3,8,1230,950,47.717,-122.101,1930,12000,13280,13930,2180,36,36
4,2.5,2110,6069,2,0,0,3,9,2110,0,47.6374,-122.111,2180,9000,8179,11180,2110,20,20
2,1.5,1260,2625,2,0,0,4,7,1260,0,47.6747,-122.151,1260,2625,3885,3885,1260,36,36
3,2.5,2300,7800,2,0,2,3,9,2300,0,47.6842,-122.155,2300,8187,10100,10487,2300,22,22
4,2.75,3010,10450,2,0,0,3,9,3010,0,47.6979,-122.112,3010,10530,13460,13540,3010,23,23
3,2.5,2930,5641,2,0,0,3,8,2930,0,47.71,-122.113,3300,5641,8571,8941,2930,6,6
4,3.25,1980,9988,1,0,0,3,8,1340,640,47.6883,-122.111,1980,8972,11968,10952,1980,39,39
3,2.5,2550,5376,2,0,0,3,9,2550,0,47.6647,-122.083,2250,4050,7926,6300,2550,15,15
5,1.75,2510,9750,1,0,0,3,8,2510,0,47.6635,-122.149,1900,9750,12260,11650,2510,50,50
3,1.75,1610,12555,1,0,0,3,7,1080,530,47.6618,-122.136,1780,10374,14165,12154,1610,42,42
3,1,1090,9900,1,0,0,4,7,1090,0,47.6755,-122.16,1720,10419,10990,12139,1090,64,64
3,2.5,1720,5940,1,0,0,4,8,1000,720,47.6631,-122.129,1720,6136,7660,7856,1720,42,42
3,2.25,1840,13020,1,0,0,3,8,1390,450,47.6923,-122.095,2210,13020,14860,15230,1840,39,39
3,2.25,2040,18360,2,0,0,4,8,2040,0,47.6976,-122.137,2590,21315,20400,23905,2040,36,36
3,2.5,2810,5400,2,0,0,3,9,2810,0,47.7065,-122.118,2870,5400,8210,8270,2810,14,14
3,2.25,2220,10530,1,0,0,4,8,1700,520,47.6383,-122.098,2500,10014,12750,12514,2220,45,45
5,4,3870,5929,2,0,0,3,10,3870,0,47.6965,-122.134,3600,5625,9799,9225,3870,5,5
3,2.5,2140,2770,2,0,0,3,8,1770,370,47.6664,-122.131,2510,2708,4910,5218,2140,12,12
3,1.75,1600,16510,1,0,0,3,8,1600,0,47.6601,-122.135,1510,10407,18110,11917,1600,35,35
4,2.5,2100,8220,1,0,0,4,8,1300,800,47.6733,-122.145,2160,8348,10320,10508,2100,44,44
3,1.75,1330,14560,1,0,0,3,7,1330,0,47.6599,-122.135,1510,9890,15890,11400,1330,36,36
3,1.75,1070,8000,1,0,0,3,7,1070,0,47.6978,-122.13,1200,7990,9070,9190,1070,42,42
2,1,790,6969,1,0,0,3,6,790,0,47.6978,-122.164,1380,12196,7759,13576,790,64,30
3,2.5,1700,7210,2,0,0,5,7,1700,0,47.6688,-122.161,1700,7566,8910,9266,1700,53,53
3,2.5,2530,9932,2,0,0,3,8,2530,0,47.6853,-122.16,2140,7950,12462,10090,2530,24,24
3,1.75,1270,9170,1,0,0,3,7,1270,0,47.6706,-122.151,1700,8500,10440,10200,1270,50,50
4,2.5,3110,6142,2,0,0,3,9,3110,0,47.701,-122.111,3200,6826,9252,10026,3110,15,15
4,2.5,2370,10513,2,0,0,4,8,2370,0,47.6915,-122.099,2110,9540,12883,11650,2370,32,32
4,2.25,1770,8505,2,0,0,3,8,1770,0,47.6904,-122.102,1880,8939,10275,10819,1770,33,33
3,1.75,1540,7558,1,0,0,3,8,1540,0,47.6707,-122.156,1540,7863,9098,9403,1540,55,55
6,4.5,3300,7200,2,0,0,3,8,3300,0,47.6798,-122.104,2470,7561,10500,10031,3300,39,39
4,1.5,1960,12688,1,0,0,4,7,1960,0,47.6304,-122.097,2050,9375,14648,11425,1960,57,57
3,2.25,1790,2240,2,0,0,4,8,1790,0,47.6343,-122.106,1780,2560,4030,4340,1790,44,44
4,2.5,3600,6055,2,0,0,3,9,3600,0,47.7053,-122.126,3590,6050,9655,9640,3600,5,5
6,4.5,3900,9100,2,0,0,3,8,2870,1030,47.6612,-122.137,2080,9216,13000,11296,3900,40,40
3,2.5,2410,9916,2,0,0,4,10,2410,0,47.6911,-122.103,2310,8212,12326,10522,2410,30,30
4,2.75,2840,4227,3,0,0,3,9,2840,0,47.7097,-122.107,2880,4227,7067,7107,2840,5,5
2,2.5,2510,17986,2,0,0,3,9,2510,0,47.6832,-122.164,2440,8039,20496,10479,2510,76,0
3,1.75,1440,7070,1,0,0,3,7,1440,0,47.6947,-122.125,1440,7210,8510,8650,1440,39,39
5,3.5,3290,5880,2,0,0,3,9,2670,620,47.7067,-122.119,3090,5680,9170,8770,3290,14,14
3,2.5,2580,13096,2,0,0,3,9,2580,0,47.6616,-122.144,2580,7988,15676,10568,2580,33,33
3,2,1650,6408,2,0,0,4,8,1650,0,47.6638,-122.128,1750,6402,8058,8152,1650,42,42
2,2.25,1390,1222,3,0,0,3,7,1340,50,47.6754,-122.121,1480,1369,2612,2849,1390,10,10
4,1.75,1980,8400,1,0,0,3,7,1330,650,47.6721,-122.152,1920,8400,10380,10320,1980,51,51
3,3,2980,28000,1,0,0,3,10,1820,1160,47.7318,-122.139,2570,28500,30980,31070,2980,38,38
3,1.75,2910,37461,1,0,0,4,7,1530,1380,47.7015,-122.164,2520,18295,40371,20815,2910,52,52
4,2.5,3310,42998,2,0,0,3,9,3310,0,47.7232,-122.131,3350,42847,46308,46197,3310,18,18
3,1.75,1730,8400,1,0,0,4,7,1400,330,47.6792,-122.115,1830,8636,10130,10466,1730,39,39
4,2.5,2120,15000,2,0,0,4,8,2120,0,47.7159,-122.1,2170,15000,17120,17170,2120,36,36
2,1.75,1510,4500,1,0,0,3,8,1510,0,47.6644,-122.13,1740,6000,6010,7740,1510,41,41
3,2,1640,3440,2,0,0,3,7,1640,0,47.6829,-122.097,1070,3549,5080,4619,1640,32,32
3,2.5,2040,4627,2,0,0,3,8,2040,0,47.6365,-122.108,2230,4500,6667,6730,2040,27,27
2,1.75,1510,5319,2,0,0,4,8,1510,0,47.6647,-122.13,1740,6160,6829,7900,1510,41,41
5,2.25,2340,9225,2,0,0,3,8,2340,0,47.6369,-122.098,2140,9348,11565,11488,2340,46,46
4,3,2630,5772,2,0,0,3,9,2630,0,47.6952,-122.133,3460,6158,8402,9618,2630,13,13
3,1.75,1940,7306,1,0,0,3,8,1470,470,47.6632,-122.153,2360,8865,9246,11225,1940,37,37
4,1.75,2090,8164,1,0,0,4,8,1070,1020,47.6715,-122.155,1310,7975,10254,9285,2090,56,56
2,2.5,1340,1240,2,0,0,3,8,1150,190,47.6858,-122.102,1280,1312,2580,2592,1340,11,11
4,2.75,2090,8400,1,0,0,4,8,1240,850,47.6872,-122.123,2340,9000,10490,11340,2090,43,43
4,2.5,2370,15200,1,0,0,3,8,1660,710,47.6295,-122.089,2360,13879,17570,16239,2370,44,44
3,2.25,2010,6000,1,0,0,3,8,1330,680,47.6912,-122.115,2080,8260,8010,10340,2010,44,44
4,2.75,2810,17674,1,0,0,4,8,1640,1170,47.6745,-122.144,2400,11240,20484,13640,2810,41,41
5,2.5,2300,7000,1,0,0,3,8,1290,1010,47.6875,-122.122,2080,7280,9300,9360,2300,44,44
3,1.75,1990,9885,1,0,0,4,7,1030,960,47.6722,-122.162,1560,10000,11875,11560,1990,41,41
4,2.5,3190,10034,2,0,0,3,9,3190,0,47.6379,-122.111,2110,9300,13224,11410,3190,12,12
4,2.75,3500,7200,2,0,0,3,9,3500,0,47.6818,-122.025,3920,7666,10700,11586,3500,14,14
4,2.5,3040,9606,2,0,0,3,7,3040,0,47.6884,-122.044,1690,3849,12646,5539,3040,16,16
4,2.5,3280,209088,2,0,0,3,10,3280,0,47.6553,-122.023,2460,39498,212368,41958,3280,25,25
3,2.5,2120,5277,2,0,0,3,7,2120,0,47.6811,-122.034,2370,5257,7397,7627,2120,14,14
3,2,1680,8946,1,0,0,3,6,940,740,47.6379,-121.966,1550,11625,10626,13175,1680,23,23
4,3.25,3900,40962,2,0,0,3,10,3900,0,47.683,-122.063,1730,11775,44862,13505,3900,28,28
3,2.25,2440,47916,2,0,0,3,8,2090,350,47.6347,-121.958,2150,24000,50356,26150,2440,28,28
4,2.75,2780,6207,2,0,0,3,8,2780,0,47.6867,-122.038,2660,5592,8987,8252,2780,18,18
2,2,1670,4996,1,0,0,3,8,1670,0,47.7141,-122.031,1670,4996,6666,6666,1670,15,15
3,1.5,1830,217800,1,0,0,3,7,1010,820,47.6277,-121.972,2450,165963,219630,168413,1830,38,38
3,2.5,2630,5827,2,0,0,3,8,2630,0,47.688,-122.038,2330,4715,8457,7045,2630,18,18
4,3.5,5990,111078,2,0,0,3,11,5990,0,47.667,-121.994,4690,118918,117068,123608,5990,15,15
2,2.5,2280,6230,1,0,0,3,8,2280,0,47.7065,-122.013,1640,5931,8510,7571,2280,14,14
2,2.5,2395,6143,1,0,0,3,8,2395,0,47.7114,-122.029,2170,6162,8538,8332,2395,16,16
7,8,13540,307752,3,0,4,3,12,9410,4130,47.6675,-121.986,4850,217800,321292,222650,13540,20,20
2,1.75,1930,4601,1,0,0,3,8,1930,0,47.7196,-122.022,1670,4500,6531,6170,1930,13,13
3,2.5,1650,5683,2,0,0,3,7,1650,0,47.683,-122.035,1650,4193,7333,5843,1650,16,16
2,2.5,3360,6750,2,0,0,3,9,3360,0,47.7112,-122.033,2510,6750,10110,9260,3360,15,15
2,2,1440,9985,1,0,0,3,8,1440,0,47.7217,-122.03,1510,4560,11425,6070,1440,13,13
3,2,1460,4350,2,0,0,3,7,1460,0,47.696,-122.026,1740,4622,5810,6362,1460,11,11
3,2.25,1580,39189,1,0,0,3,7,1180,400,47.6365,-121.972,1580,29649,40769,31229,1580,27,27
3,1.75,1890,100623,1,0,3,3,8,1890,0,47.6454,-121.978,2110,50529,102513,52639,1890,41,41
2,2,1560,4675,1,0,0,3,8,1560,0,47.7086,-122.019,1870,6361,6235,8231,1560,13,13
3,1.75,1820,22320,1,0,0,3,7,1250,570,47.6441,-121.96,2030,22320,24140,24350,1820,42,42
3,2.25,2980,86636,1,0,0,3,9,2230,750,47.6627,-122.003,2980,107157,89616,110137,2980,30,30
4,3,2720,183823,2,0,0,3,8,2720,0,47.6749,-122.002,2140,173804,186543,175944,2720,44,7
3,2.75,2200,14925,1,0,0,3,6,1100,1100,47.6606,-122.059,1520,14212,17125,15732,2200,37,37
3,2.25,1850,37264,2,0,0,3,8,1850,0,47.6486,-122.035,2390,36036,39114,38426,1850,38,38
3,2,1440,4421,1,0,0,3,8,1440,0,47.7188,-122.024,1440,4157,5861,5597,1440,12,12
2,2.5,1900,3690,2,0,0,3,8,1900,0,47.7082,-122.019,1900,5153,5590,7053,1900,13,13
4,2.5,3190,38119,2,0,0,3,9,3190,0,47.6698,-122.044,2560,36280,41309,38840,3190,31,31
3,2.5,1560,3987,2,0,0,3,7,1560,0,47.687,-122.043,1600,3152,5547,4752,1560,17,17
3,2.25,2320,38186,2,0,0,3,8,2320,0,47.6645,-122.068,2875,37523,40506,40398,2320,39,39
3,2.5,2120,4780,2,0,0,3,7,2120,0,47.681,-122.032,1690,2650,6900,4340,2120,15,15
4,2.75,3880,15025,2,0,0,3,7,3880,0,47.6777,-122.035,2620,5300,18905,7920,3880,15,15
3,2.5,2600,4438,2,0,0,3,7,2600,0,47.6799,-122.034,2600,4904,7038,7504,2600,15,15
5,3.5,4410,57063,2,0,0,4,9,4410,0,47.6554,-122.018,2900,50529,61473,53429,4410,29,29
3,2.5,1650,3076,2,0,0,3,7,1650,0,47.682,-122.035,1560,3064,4726,4624,1650,16,16
3,2.5,1680,4075,2,0,0,3,7,1680,0,47.6964,-122.024,1710,4075,5755,5785,1680,11,11
2,1.75,1670,6460,1,0,0,3,8,1670,0,47.7123,-122.027,2170,6254,8130,8424,1670,15,15
3,2,1510,3657,1,0,0,3,8,1510,0,47.7225,-122.029,1510,3657,5167,5167,1510,12,12
3,2.25,2570,47480,1,0,0,3,9,2570,0,47.6854,-122.079,2570,106722,50050,109292,2570,40,40
2,2,1870,5580,1,0,0,3,8,1870,0,47.7101,-122.031,1670,4500,7450,6170,1870,15,15
2,1.75,1510,6852,1,0,0,3,8,1510,0,47.7073,-122.012,1510,5912,8362,7422,1510,14,14
3,2,1810,10860,1,0,0,3,7,1810,0,47.6393,-121.967,1420,11982,12670,13402,1810,52,52
2,2.5,1900,4871,2,0,0,3,8,1900,0,47.7132,-122.034,1640,4780,6771,6420,1900,14,14
4,2.75,3660,5637,2,0,0,3,9,3660,0,47.6845,-122.017,3625,5639,9297,9264,3660,5,5
3,2.75,2210,4000,2,0,0,3,8,2210,0,47.6954,-122.017,2230,4674,6210,6904,2210,11,11
2,2,1870,5143,1,0,0,3,8,1870,0,47.7142,-122.033,1810,5143,7013,6953,1870,14,14
4,2.5,2390,53941,2,0,0,3,8,2390,0,47.7066,-122.08,2610,104108,56331,106718,2390,30,30
2,2.5,2680,7392,1,0,0,3,9,2680,0,47.717,-122.026,2315,7045,10072,9360,2680,15,15
3,2.5,2510,5544,2,0,0,3,7,2510,0,47.6903,-122.042,2660,5614,8054,8274,2510,18,18
2,2,1440,4666,1,0,0,3,8,1440,0,47.709,-122.019,1510,4595,6106,6105,1440,9,9
2,1.75,1560,4500,1,0,0,3,8,1560,0,47.7128,-122.032,1860,4500,6060,6360,1560,15,15
2,2,1870,4751,1,0,0,3,8,1870,0,47.7082,-122.015,2170,5580,6621,7750,1870,13,13
4,2.75,3410,5838,2,0,0,3,9,3410,0,47.6931,-122.022,3420,7048,9248,10468,3410,7,7
2,1.75,1440,4660,1,0,2,3,8,1440,0,47.7092,-122.015,1680,4989,6100,6669,1440,11,11
3,2.5,2020,5613,2,0,0,3,7,2020,0,47.6835,-122.035,2020,4609,7633,6629,2020,16,16
5,2.5,2640,7096,2,0,0,3,7,2640,0,47.6827,-122.038,2640,4850,9736,7490,2640,16,16
4,2.5,2690,4736,2,0,0,3,7,2690,0,47.6869,-122.036,2690,4791,7426,7481,2690,18,18
2,2,1870,6275,1,0,0,3,8,1870,0,47.7108,-122.031,1670,5200,8145,6870,1870,16,16
5,2.75,3595,5639,2,0,0,3,9,3595,0,47.6848,-122.016,3625,5639,9234,9264,3595,5,5
3,2.5,2510,5186,2,0,0,3,7,2510,0,47.6895,-122.041,2530,5186,7696,7716,2510,18,18
4,2.5,3420,183387,2,0,0,3,10,3420,0,47.633,-121.972,2260,34613,186807,36873,3420,19,19
4,2.5,3720,105850,2,0,0,4,10,3720,0,47.655,-122.029,2830,88256,109570,91086,3720,35,35
4,2.75,3555,6565,2,0,0,3,9,3555,0,47.6847,-122.017,3625,5637,10120,9262,3555,5,5
4,2.75,2500,4950,2,0,0,3,8,2500,0,47.6964,-122.017,2500,4950,7450,7450,2500,9,9
2,2,1340,4447,1,0,0,3,8,1340,0,47.7175,-122.033,1350,4458,5787,5808,1340,15,15
4,2.75,3160,42733,2,0,0,3,9,3160,0,47.6367,-121.958,1890,24000,45893,25890,3160,24,24
3,1,1250,21303,1,0,0,3,6,1250,0,47.6625,-122.059,1250,17920,22553,19170,1250,49,49
2,1.75,1350,4003,1,0,0,3,8,1350,0,47.7176,-122.033,1350,4479,5353,5829,1350,15,15
5,3.25,4240,226097,2,0,0,3,8,3410,830,47.6472,-122.017,2980,217800,230337,220780,4240,39,39
4,3.5,3260,110579,2,0,0,3,10,3260,0,47.6436,-121.997,3470,97895,113839,101365,3260,22,22
3,2.5,2300,6009,1,0,0,3,8,2300,0,47.7067,-122.013,1640,5931,8309,7571,2300,14,14
4,3.25,5180,49936,2,0,0,4,10,5180,0,47.6676,-122.069,4240,35363,55116,39603,5180,28,28
3,2.5,2850,21780,2,0,0,3,10,2850,0,47.6455,-122.04,3020,21798,24630,24818,2850,25,25
2,2,1560,4823,1,0,0,3,8,1560,0,47.7111,-122.032,1855,4989,6383,6844,1560,15,15
4,2.5,3200,36276,2,0,0,3,9,3200,0,47.6304,-121.994,2930,33171,39476,36101,3200,26,26
2,2,1340,4122,1,0,0,3,8,1340,0,47.7182,-122.022,1350,4273,5462,5623,1340,12,12
4,2.5,2570,27972,2,0,0,3,8,2570,0,47.6343,-121.969,2500,29761,30542,32261,2570,22,22
4,2.5,3030,29163,2,0,0,3,10,3030,0,47.6569,-122.02,2780,40669,32193,43449,3030,21,21
4,1.75,2420,37800,1,0,0,4,8,1880,540,47.6688,-122.024,2780,35532,40220,38312,2420,38,38
4,2.5,3720,30649,2,0,0,3,10,3720,0,47.6651,-122.056,3220,29434,34369,32654,3720,31,31
2,2.5,2390,7489,1,0,0,3,8,2390,0,47.7243,-122.032,2170,7489,9879,9659,2390,12,12
4,2.5,3440,56192,2,0,0,3,9,3440,0,47.6969,-122.046,3150,44431,59632,47581,3440,25,25
3,2.5,1690,4851,2,0,0,3,7,1690,0,47.6795,-122.034,2330,4851,6541,7181,1690,15,15
2,2.5,2150,5760,1,0,0,3,8,2150,0,47.7094,-122.018,1640,4680,7910,6320,2150,9,9
3,3,3270,38088,2,0,0,3,10,3270,0,47.6692,-122.028,1870,37457,41358,39327,3270,27,27
4,2.5,2770,5612,2,0,0,3,7,2770,0,47.686,-122.036,2770,5177,8382,7947,2770,18,18
3,2.25,2780,31510,2,0,0,3,8,2780,0,47.67,-122.024,2890,36400,34290,39290,2780,40,40
3,2.5,2770,39529,2,0,0,3,9,2770,0,47.6495,-122.042,3010,35435,42299,38445,2770,32,32
4,3,3280,4904,2,0,0,3,7,3280,0,47.6802,-122.033,2600,5004,8184,7604,3280,14,14
3,2.5,1850,3400,2,0,0,3,7,1850,0,47.6871,-122.014,1850,3400,5250,5250,1850,9,9
4,3.5,3760,57063,2,0,0,3,9,2950,810,47.6328,-121.964,2870,28945,60823,31815,3760,21,21
4,3.25,3090,67518,2,0,0,3,10,3090,0,47.6674,-122.046,3200,65775,70608,68975,3090,31,31
4,3.25,3750,74052,2,0,0,3,10,3750,0,47.658,-122.006,4920,74052,77802,78972,3750,6,6
2,2.5,2300,6400,1,0,0,3,8,2300,0,47.7196,-122.02,2300,6400,8700,8700,2300,12,12
3,2.5,1690,3026,2,0,0,3,7,1690,0,47.6885,-122.043,1650,3161,4716,4811,1690,17,17
2,2,1350,3926,1,0,0,3,8,1350,0,47.7192,-122.024,1440,3926,5276,5366,1350,12,12
3,1.75,1720,37363,1,0,0,4,8,1350,370,47.6608,-122.035,2740,40635,39083,43375,1720,45,45
3,2.5,1740,4145,2,0,0,3,7,1740,0,47.6875,-122.015,1740,4045,5885,5785,1740,9,9
4,2.75,4430,74358,2,0,0,3,10,4430,0,47.6392,-121.988,3820,80875,78788,84695,4430,29,29
3,1,1500,10730,1,0,0,3,7,1000,500,47.6385,-121.966,1570,12210,12230,13780,1500,42,42
4,2.5,3270,45537,2,0,0,3,9,3270,0,47.6303,-121.984,2670,38827,48807,41497,3270,26,26
3,2.5,2580,214315,1,0,0,3,8,2580,0,47.6465,-122.024,2580,70131,216895,72711,2580,73,28
4,2.5,2630,28298,2,0,0,3,8,2630,0,47.6314,-121.968,2840,26071,30928,28911,2630,23,23
3,1,1040,9600,1,0,0,3,7,1040,0,47.6738,-122.063,1370,10889,10640,12259,1040,41,41
3,2.5,2550,45254,2,0,0,3,9,2550,0,47.6498,-121.964,2190,49222,47804,51412,2550,18,18
4,2.5,2650,6884,2,0,0,3,8,2650,0,47.6901,-122.015,2520,5866,9534,8386,2650,7,7
4,2.25,2090,45738,2,0,0,3,8,2090,0,47.6876,-122.049,3420,45738,47828,49158,2090,32,32
5,2.25,3100,97661,2,0,0,3,9,3100,0,47.6624,-122.062,2370,53993,100761,56363,3100,33,33
2,2,1690,4500,1,0,0,3,8,1690,0,47.7133,-122.031,1640,4500,6190,6140,1690,15,15
4,2.25,4470,86225,2,0,0,3,10,4470,0,47.6377,-121.985,3850,97049,90695,100899,4470,28,28
3,2.75,2690,10443,1,0,0,3,9,2690,0,47.7185,-122.024,1440,4185,13133,5625,2690,12,12
2,2.5,2680,11214,1,0,0,3,9,2680,0,47.7078,-122.019,2305,6908,13894,9213,2680,13,13
4,3.5,4380,74052,1,0,0,3,11,4380,0,47.6587,-122.009,5170,62291,78432,67461,4380,18,18
3,2.5,1440,3060,2,0,0,3,7,1440,0,47.6821,-122.035,1650,3060,4500,4710,1440,16,16
3,1,1150,12877,1,0,0,4,6,1150,0,47.6614,-122.056,1490,12150,14027,13640,1150,49,49
2,2,1350,3900,1,0,0,3,8,1350,0,47.7094,-122.03,1440,3900,5250,5340,1350,16,16
4,2.5,2790,74495,2,0,0,3,9,2790,0,47.6628,-122.056,2790,24643,77285,27433,2790,22,22
3,2.5,3820,35016,2,0,0,4,9,3820,0,47.6496,-122.041,3010,35190,38836,38200,3820,32,32
3,2.5,1720,3600,2,0,0,3,7,1720,0,47.6856,-122.013,1720,3600,5320,5320,1720,9,9
5,2.5,2300,28480,2,0,0,3,6,2300,0,47.6403,-121.964,1880,26720,30780,28600,2300,25,25
4,2.5,3170,32430,2,0,0,3,10,3170,0,47.6903,-122.056,3360,35610,35600,38970,3170,30,30
3,2.5,1600,3172,2,0,0,3,7,1600,0,47.6868,-122.042,1690,3698,4772,5388,1600,17,17
3,2.5,1440,5434,2,0,0,3,7,1440,0,47.6818,-122.034,1560,3770,6874,5330,1440,16,16
4,2.5,2520,35636,2,0,0,3,8,2520,0,47.652,-122.031,2230,35673,38156,37903,2520,39,39
4,2.25,2460,40635,1,0,0,5,8,2460,0,47.6627,-122.032,2250,40635,43095,42885,2460,51,51
4,4,4460,103382,2,0,0,3,11,4460,0,47.634,-121.997,3470,88519,107842,91989,4460,18,18
4,2.5,3500,9198,2,0,0,3,9,3500,0,47.6785,-122.025,3990,8598,12698,12588,3500,15,15
4,2.5,3320,38043,2,0,0,3,9,3320,0,47.6504,-122.004,3170,42621,41363,45791,3320,22,22
3,2.5,1710,3795,2,0,0,3,7,1710,0,47.6968,-122.024,1600,3821,5505,5421,1710,10,10
5,2.5,4310,28008,2,0,0,3,10,4310,0,47.6662,-122.056,3170,28559,32318,31729,4310,31,31
5,3.5,3700,5400,2,0,0,3,9,2890,810,47.7085,-122.117,3620,5460,9100,9080,3700,8,8
4,3.5,4150,49503,2,0,0,3,11,4150,0,47.6746,-122.018,3330,60137,53653,63467,4150,16,16
2,2.5,2170,6361,1,0,2,3,8,2170,0,47.7109,-122.017,2310,7419,8531,9729,2170,10,10
2,2,1510,4908,1,0,0,3,8,1510,0,47.7196,-122.024,1440,3921,6418,5361,1510,13,13
3,3.75,5400,24740,2,0,0,3,11,5400,0,47.6426,-121.955,1690,20000,30140,21690,5400,22,22
3,2.5,2480,6600,2,0,0,3,8,2480,0,47.6313,-122.008,2310,6656,9080,8966,2480,17,17
4,2.5,3280,27441,2,0,0,3,9,3280,0,47.6711,-122.012,3200,26960,30721,30160,3280,23,23
2,1,1200,24792,2,0,0,2,7,1200,0,47.6337,-121.961,2150,24792,25992,26942,1200,43,43
4,2.75,3660,150282,2,0,0,3,10,3660,0,47.6813,-122.048,3090,53578,153942,56668,3660,29,29
2,2.5,2320,9311,1,0,0,3,8,2320,0,47.7226,-122.03,1680,4765,11631,6445,2320,12,12
4,3,2580,209523,2,0,0,3,8,2580,0,47.6932,-122.006,3440,213444,212103,216884,2580,35,35
3,2.5,1690,2890,2,0,0,3,7,1690,0,47.6802,-122.031,1690,2730,4580,4420,1690,15,15
2,2.75,2700,9854,1,0,0,3,9,2700,0,47.7187,-122.024,1440,4168,12554,5608,2700,7,7
3,2.5,1690,3129,2,0,0,3,7,1690,0,47.6875,-122.043,1690,3129,4819,4819,1690,17,17
0,0,4810,28008,2,0,0,3,12,4810,0,47.6642,-122.069,4740,35061,32818,39801,4810,29,29
4,2.5,2440,22594,2,0,0,3,8,2440,0,47.6333,-121.97,2560,33341,25034,35901,2440,23,23
3,1.75,1300,62290,1,0,0,3,7,1300,0,47.6529,-121.979,1850,52272,63590,54122,1300,36,36
3,2,1870,5300,1,0,0,3,8,1870,0,47.7106,-122.02,1870,5050,7170,6920,1870,10,10
4,3.25,3520,5250,2,0,0,3,9,3520,0,47.6869,-122.019,3220,5781,8770,9001,3520,7,7
4,2.5,2150,27540,2,0,0,3,8,2150,0,47.637,-121.969,2150,27540,29690,29690,2150,22,22
4,2.5,2650,4644,2,0,0,3,8,2650,0,47.6945,-122.018,2640,5099,7294,7739,2650,6,6
2,2.5,2170,6750,1,0,0,3,8,2170,0,47.7115,-122.014,2150,6074,8920,8224,2170,7,7
2,2.5,2380,9374,1,0,2,3,8,2380,0,47.7095,-122.019,1610,5000,11754,6610,2380,8,8
2,2,1510,6516,1,0,0,3,8,1510,0,47.7076,-122.013,1640,6009,8026,7649,1510,14,14
4,2.75,3350,5416,2,0,0,3,9,3350,0,47.6849,-122.016,3625,5637,8766,9262,3350,5,5
2,2,1930,5520,1,0,0,3,8,1930,0,47.7191,-122.022,1640,4533,7450,6173,1930,13,13
3,1,1230,9660,1,0,0,3,7,1230,0,47.6829,-122.06,1380,10125,10890,11505,1230,51,51
4,3.75,5150,453895,2,0,3,3,11,4360,790,47.6795,-121.991,2500,215186,459045,217686,5150,22,22
3,1,1280,11625,1,0,0,4,7,1280,0,47.6827,-122.059,1320,10875,12905,12195,1280,42,42
3,2.25,1630,3070,2,0,0,3,7,1630,0,47.6785,-122.03,1690,3200,4700,4890,1630,15,15
4,3.25,3720,6765,2,0,0,3,9,3720,0,47.688,-122.018,3100,6790,10485,9890,3720,7,7
2,2,1930,5479,1,0,0,3,8,1930,0,47.7054,-122.011,1900,5479,7409,7379,1930,14,14
3,2.5,1690,6642,2,0,0,3,7,1690,0,47.6793,-122.033,2120,5080,8332,7200,1690,15,15
3,1.75,1690,48096,1,0,0,3,7,1690,0,47.6745,-122.061,2070,35160,49786,37230,1690,46,46
3,2.5,1840,5680,2,0,0,3,7,1840,0,47.6969,-122.026,1600,4697,7520,6297,1840,11,11
4,3.5,3915,6364,2,0,0,3,9,3915,0,47.6844,-122.016,3830,6507,10279,10337,3915,5,5
3,2.5,1960,6058,2,0,0,3,8,1960,0,47.6319,-122.007,2480,6656,8018,9136,1960,17,17
4,2.5,4600,67369,2,0,0,3,10,4600,0,47.6417,-121.992,4600,67369,71969,71969,4600,29,29
4,2.5,2510,5436,2,0,0,3,8,2510,0,47.6894,-122.016,2520,5436,7946,7956,2510,8,8
2,2,1300,6515,1,0,0,3,8,1300,0,47.7078,-122.013,1640,6009,7815,7649,1300,14,14
4,2.5,3500,7048,2,0,0,3,9,3500,0,47.6811,-122.025,3920,7864,10548,11784,3500,14,14
4,2.5,3800,22029,2,0,0,3,9,3800,0,47.6734,-122.026,3170,24979,25829,28149,3800,26,26
3,2.5,2560,5238,2,0,0,3,8,2560,0,47.6887,-122.04,2560,5185,7798,7745,2560,18,18
3,2.5,1690,3322,2,0,0,3,7,1690,0,47.6824,-122.036,1650,3446,5012,5096,1690,16,16
4,3.5,5440,38900,2,0,0,3,12,5440,0,47.6605,-122.069,4830,41313,44340,46143,5440,29,29
3,2,2120,4080,2,0,0,3,7,2120,0,47.682,-122.037,2280,4080,6200,6360,2120,16,16
4,2.5,3510,28052,2,0,0,3,10,3510,0,47.6671,-122.057,2890,28295,31562,31185,3510,31,31
2,2,1870,4950,1,0,0,3,8,1870,0,47.7195,-122.022,1670,4800,6820,6470,1870,13,13
4,2.5,3510,24604,2,0,0,3,10,3510,0,47.6772,-122.056,3530,26673,28114,30203,3510,22,22
4,2.5,2900,23488,2,0,0,3,9,2900,0,47.6726,-122.03,2900,34589,26388,37489,2900,27,27
3,2,1240,14404,1,0,0,3,7,1240,0,47.6614,-122.06,1350,9990,15644,11340,1240,31,31
4,2.5,3350,35298,2,0,0,4,9,3350,0,47.6506,-122.036,2620,35604,38648,38224,3350,34,34
4,2.25,2570,36465,2,0,0,4,8,2570,0,47.6555,-122.042,2390,41454,39035,43844,2570,39,39
3,2.5,1930,5344,2,0,0,3,7,1930,0,47.6783,-122.032,2410,5080,7274,7490,1930,15,15
2,1.75,1810,4220,2,0,0,3,8,1810,0,47.7177,-122.034,1350,4479,6030,5829,1810,15,15
3,2.5,3030,46538,2,0,0,3,10,3030,0,47.664,-122.041,3370,51450,49568,54820,3030,22,22
2,2,1660,4500,1,0,0,3,8,1660,0,47.7094,-122.031,1670,5580,6160,7250,1660,16,16
3,1.75,2340,57499,1,0,0,3,8,2340,0,47.6989,-122.044,3260,137649,59839,140909,2340,31,31
3,2.5,3560,107290,2,0,0,3,10,3560,0,47.6652,-122.049,3660,89298,110850,92958,3560,32,32
2,2.5,2170,8678,1,0,0,3,8,2170,0,47.7161,-122.014,2170,5890,10848,8060,2170,11,11
5,3.75,3500,101494,1,0,0,3,8,3500,0,47.6745,-122.054,3250,38636,104994,41886,3500,52,25
3,4,4160,31796,2,0,0,3,11,4160,0,47.6635,-122.017,4300,36192,35956,40492,4160,30,30
3,2.5,1690,4088,2,0,0,3,7,1690,0,47.6779,-122.034,1950,4088,5778,6038,1690,15,15
4,3,3990,7838,2,0,0,3,9,3990,0,47.6857,-122.046,3370,6814,11828,10184,3990,16,16
3,3.25,5290,224442,2,0,0,4,11,4540,750,47.6671,-122.051,3750,84936,229732,88686,5290,31,31
1,0,690,23244,1,0,0,4,7,690,0,47.6429,-121.955,1690,19290,23934,20980,690,71,71
4,3.5,4740,172497,2,0,0,3,11,4740,0,47.6779,-122.075,2120,49658,177237,51778,4740,16,16
4,2.5,3480,6262,2,0,0,3,9,3480,0,47.6857,-122.045,3490,6629,9742,10119,3480,16,16
3,2.5,1440,4473,2,0,0,3,7,1440,0,47.6825,-122.036,1650,3322,5913,4972,1440,16,16
4,1.5,2120,46173,2,0,0,3,7,2120,0,47.6503,-121.968,2000,46173,48293,48173,2120,45,45
5,3.25,4115,7910,2,0,0,3,9,4115,0,47.6847,-122.016,3950,6765,12025,10715,4115,5,5
3,2.5,1640,29970,2,0,0,3,7,1640,0,47.6359,-121.974,1580,28399,31610,29979,1640,27,27
2,2.75,2700,8572,1,0,0,3,9,2700,0,47.7236,-122.033,2680,8569,11272,11249,2700,12,12
4,3.25,3990,9786,2,0,0,3,9,3990,0,47.6784,-122.026,3920,8200,13776,12120,3990,15,15
4,2.75,3990,6637,2,0,0,3,9,3990,0,47.6835,-122.045,3500,7074,10627,10574,3990,16,16
4,3.5,4340,217800,2,0,0,3,11,4340,0,47.6471,-122.013,3430,219106,222140,222536,4340,16,16
2,1,1640,17335,1,0,0,3,7,840,800,47.6397,-121.953,2440,17850,18975,20290,1640,41,41
4,1.75,2110,265716,1,0,0,4,8,2110,0,47.657,-122.026,2110,110597,267826,112707,2110,40,40
4,1.75,3280,35160,1,0,0,3,7,2080,1200,47.6728,-122.061,2510,31331,38440,33841,3280,43,43
3,2.5,1720,3581,2,0,0,3,7,1720,0,47.6861,-122.013,1720,3600,5301,5320,1720,8,8
4,2.5,2540,32647,2,0,0,3,9,2540,0,47.6324,-121.988,2740,32647,35187,35387,2540,23,23
4,2.75,3500,6226,2,0,0,3,9,3500,0,47.6846,-122.045,3480,7222,9726,10702,3500,15,15
3,2.5,2120,4310,2,0,0,3,7,2120,0,47.687,-122.037,2280,4380,6430,6660,2120,18,18
3,1.75,1690,53578,1,0,0,3,8,1690,0,47.6546,-122.049,2290,52707,55268,54997,1690,35,35
2,2,1540,54450,2,0,0,3,7,1540,0,47.638,-121.953,2280,29918,55990,32198,1540,36,36
5,3.5,3870,65556,2,0,0,3,10,3870,0,47.6403,-121.992,4290,67019,69426,71309,3870,25,25
5,3.25,3830,6507,2,0,0,3,9,3830,0,47.6843,-122.016,3950,6723,10337,10673,3830,5,5
2,1.75,1350,4003,1,0,0,3,8,1350,0,47.7176,-122.033,1350,4479,5353,5829,1350,15,15
3,2,1130,9879,2,0,0,3,6,1130,0,47.635,-121.964,1900,14907,11009,16807,1130,23,23
4,2.5,2970,29163,2,0,0,3,9,2970,0,47.6717,-122.025,3100,31105,32133,34205,2970,26,26
4,2.25,2350,46173,2,0,0,4,8,2350,0,47.6657,-122.067,2390,36567,48523,38957,2350,39,39
2,2,1680,4950,1,0,0,3,8,1680,0,47.7194,-122.022,1570,4800,6630,6370,1680,13,13
2,1,1290,3383,2,0,0,3,7,1290,0,47.6968,-122.025,1290,2828,4673,4118,1290,11,11
2,2.5,1900,2983,2,0,0,3,8,1900,0,47.7029,-122.015,1510,3876,4883,5386,1900,13,13
4,3.5,3920,9555,2,0,0,3,9,3920,0,47.6797,-122.025,3920,8598,13475,12518,3920,15,15
3,3.25,5290,224442,2,0,0,4,11,4540,750,47.6671,-122.051,3750,84936,229732,88686,5290,31,31
2,1.75,1340,4664,1,0,0,3,8,1340,0,47.7182,-122.034,1350,4236,6004,5586,1340,15,15
4,2.5,2540,38677,2,0,0,3,9,2540,0,47.6694,-122.044,2560,36280,41217,38840,2540,32,32
4,3.25,3500,5960,2,0,0,3,9,3500,0,47.6944,-122.022,3390,6856,9460,10246,3500,9,9
4,2.5,3220,38448,2,0,0,3,10,3220,0,47.6854,-122.053,3090,38448,41668,41538,3220,26,26
2,1,1290,2828,2,0,0,3,7,1290,0,47.6968,-122.025,1290,2628,4118,3918,1290,11,11
4,3.5,3790,90169,2,0,0,3,11,3790,0,47.6587,-122.022,3410,46951,93959,50361,3790,21,21
3,1.75,1760,235224,1,0,0,3,7,1760,0,47.6735,-122.041,2320,87120,236984,89440,1760,46,46
2,1.75,1510,4555,1,0,0,3,8,1510,0,47.7136,-122.031,1640,4500,6065,6140,1510,14,14
3,1.5,2710,47419,1,0,0,3,7,2170,540,47.6522,-121.966,2130,48144,50129,50274,2710,39,39
4,3.75,5070,60123,2,0,0,3,11,5070,0,47.6567,-122.004,4920,101930,65193,106850,5070,19,19
3,2.5,2490,23891,2,0,0,3,9,2490,0,47.6716,-122.029,2900,34705,26381,37605,2490,26,26
2,2.5,1900,5065,2,0,0,3,8,1900,0,47.7175,-122.034,1350,4664,6965,6014,1900,14,14
5,3.25,4240,9588,2,0,0,3,9,4240,0,47.6901,-122.018,4080,8425,13828,12505,4240,5,5
4,2.5,2755,4831,2,0,0,3,7,2755,0,47.685,-122.039,2510,4831,7586,7341,2755,16,16
2,2.5,2630,7957,2,0,0,3,8,2630,0,47.7106,-122.023,2305,7220,10587,9525,2630,16,16
3,1,910,10240,1,0,0,4,6,910,0,47.6729,-122.064,1140,10720,11150,11860,910,50,50
2,2,2280,6815,1,0,0,3,8,2280,0,47.7103,-122.027,2280,6750,9095,9030,2280,17,17
4,2.5,2440,34290,2,0,0,3,9,2440,0,47.6685,-122.044,2860,38119,36730,40979,2440,32,32
2,1.75,1680,4500,1,0,0,3,8,1680,0,47.7132,-122.032,1670,4500,6180,6170,1680,15,15
2,1.75,1510,4980,1,0,0,3,8,1510,0,47.7191,-122.023,1350,4157,6490,5507,1510,13,13
3,2,1460,3696,2,0,0,3,7,1460,0,47.6861,-122.013,1720,3631,5156,5351,1460,9,9
4,2.5,4270,43386,1,0,0,3,10,2680,1590,47.6915,-122.053,3630,36180,47656,39810,4270,28,28
2,2.5,2160,5581,1,0,0,3,8,2160,0,47.7017,-122.023,2315,5652,7741,7967,2160,17,17
2,1.75,1440,4225,1,0,0,3,8,1440,0,47.7143,-122.032,1680,6200,5665,7880,1440,14,14
3,1.75,1150,13278,1,0,0,5,7,1150,0,47.6384,-121.969,1560,12400,14428,13960,1150,53,53
2,2,1300,2983,1,0,0,3,8,1300,0,47.703,-122.015,1510,3876,4283,5386,1300,13,13
3,2.25,1470,7857,1,0,0,4,7,1180,290,47.4547,-122.209,1900,7600,9327,9500,1470,46,46
4,2.5,1970,5106,2,0,0,3,8,1970,0,47.449,-122.205,2230,5109,7076,7339,1970,20,20
3,1.5,1400,10853,1,0,0,4,7,1400,0,47.4433,-122.194,1620,10849,12253,12469,1400,55,55
2,1,860,3874,1,0,0,4,6,860,0,47.4836,-122.204,1400,5106,4734,6506,860,88,88
2,1.75,1050,6500,1,0,2,4,6,1050,0,47.4727,-122.2,1320,10075,7550,11395,1050,94,94
4,1,1710,117176,1,0,0,4,6,1710,0,47.4497,-122.212,1940,12223,118886,14163,1710,77,77
3,1.75,1480,7500,1,0,0,4,7,1480,0,47.4629,-122.187,1480,7500,8980,8980,1480,51,51
1,1,610,4400,1,0,0,3,5,610,0,47.4865,-122.197,1090,4930,5010,6020,610,97,97
3,3,2680,12285,1,0,0,4,8,2680,0,47.4633,-122.196,2610,9558,14965,12168,2680,49,49
3,1.5,1370,7439,1,0,0,4,6,1370,0,47.4499,-122.189,2350,3370,8809,5720,1370,56,56
2,1,1420,81892,1,0,0,3,7,1180,240,47.4342,-122.195,1490,1863,83312,3353,1420,63,63
3,1.75,2630,6500,1,0,0,3,7,1330,1300,47.4878,-122.221,2520,6500,9130,9020,2630,61,61
3,1.5,1670,11610,1,0,0,4,7,1670,0,47.4404,-122.191,1930,10200,13280,12130,1670,56,56
2,1,820,8423,1,0,2,3,6,820,0,47.4741,-122.2,1960,9140,9243,11100,820,62,62
3,1,1270,7153,1,0,0,5,6,1270,0,47.4815,-122.226,1650,7153,8423,8803,1270,70,70
2,1,1000,4500,1,0,0,3,6,1000,0,47.4896,-122.204,980,4837,5500,5817,1000,103,103
4,1.75,2280,7840,1,0,0,3,7,1280,1000,47.4809,-122.224,2120,7260,10120,9380,2280,62,62
5,2.25,2240,9652,2,0,0,3,7,2240,0,47.4249,-122.211,2180,11644,11892,13824,2240,29,29
3,2.25,1620,10850,1,0,0,3,7,1620,0,47.4437,-122.194,1910,10568,12470,12478,1620,53,53
3,1.5,1220,6000,1,0,0,3,7,1220,0,47.4904,-122.222,1660,6000,7220,7660,1220,51,51
3,1,1440,11250,1,0,0,3,7,1440,0,47.4627,-122.213,2200,11250,12690,13450,1440,52,52
3,2.5,1820,8085,2,0,0,3,7,1820,0,47.4575,-122.204,1860,8625,9905,10485,1820,36,36
3,2,1530,8700,1,0,0,4,7,1530,0,47.4529,-122.207,1960,7600,10230,9560,1530,49,49
2,1,840,12750,1,0,0,3,6,840,0,47.484,-122.211,1480,6969,13590,8449,840,94,94
3,1.5,1300,7313,1,0,0,4,7,1300,0,47.4568,-122.21,1770,8075,8613,9845,1300,51,51
3,1.75,1930,6533,1,0,0,3,7,1230,700,47.4883,-122.221,2030,5954,8463,7984,1930,59,59
2,2,1590,9375,1,0,0,3,7,910,680,47.4585,-122.205,1560,8524,10965,10084,1590,36,36
4,2.5,1954,4805,2,0,0,3,8,1954,0,47.4297,-122.19,1714,3259,6759,4973,1954,14,14
3,1,1460,10200,1,0,0,4,7,1460,0,47.4238,-122.197,1460,8500,11660,9960,1460,62,62
3,1,1140,9779,1,0,0,3,7,1140,0,47.424,-122.201,1520,9814,10919,11334,1140,56,56
3,2.25,1500,7308,1,0,0,4,7,1210,290,47.4621,-122.187,1480,7400,8808,8880,1500,51,51
4,2.5,1800,7620,2,0,0,3,8,1800,0,47.4346,-122.201,1800,6879,9420,8679,1800,24,24
3,1.75,1390,8700,1,0,3,4,7,840,550,47.4725,-122.202,1390,10875,10090,12265,1390,107,107
3,1,1320,6534,1,0,0,3,7,1320,0,47.4806,-122.223,2140,7405,7854,9545,1320,67,67
3,2.5,2430,7857,2,0,0,5,8,1730,700,47.4546,-122.211,2160,8740,10287,10900,2430,39,39
3,1.5,1580,10100,1,0,0,4,7,1580,0,47.4423,-122.193,1650,10032,11680,11682,1580,58,58
5,1.75,2810,9360,1,0,0,4,7,1520,1290,47.4361,-122.193,1770,9360,12170,11130,2810,54,54
2,1,1500,4120,1,0,0,3,5,880,620,47.4857,-122.2,1300,4120,5620,5420,1500,91,91
2,1,810,4838,1,0,0,3,5,810,0,47.4909,-122.203,890,4838,5648,5728,810,81,81
3,1.75,1550,1905,2,0,0,3,7,1550,0,47.4331,-122.195,1550,1866,3455,3416,1550,14,14
3,2,1680,5036,1,0,1,4,7,1680,0,47.4734,-122.186,1680,4921,6716,6601,1680,32,32
2,1,800,5000,1,0,0,3,6,800,0,47.4914,-122.204,1220,5000,5800,6220,800,81,81
3,1.75,1840,7200,1,0,0,4,7,1220,620,47.456,-122.209,1770,8075,9040,9845,1840,51,51
6,3.5,2120,5840,2,0,0,5,7,2120,0,47.4788,-122.227,1860,8000,7960,9860,2120,40,40
4,2.5,2260,7500,1,0,0,3,8,1460,800,47.4645,-122.196,2260,7500,9760,9760,2260,54,54
3,1,1170,7395,1,0,0,4,7,1170,0,47.4627,-122.19,1430,7920,8565,9350,1170,50,50
4,2.5,2540,6365,2,0,0,3,8,1870,670,47.4608,-122.215,2290,5942,8905,8232,2540,19,19
5,1.75,2190,8250,1,0,2,3,7,1190,1000,47.4887,-122.223,2570,8250,10440,10820,2190,56,56
3,2.5,1650,2807,2,0,0,3,7,1650,0,47.4328,-122.196,1460,1875,4457,3335,1650,15,15
6,1.5,1810,4838,1,0,0,4,5,1050,760,47.4874,-122.202,1300,4838,6648,6138,1810,114,114
4,3.5,2720,6781,2,0,0,3,8,2100,620,47.4612,-122.215,2280,5942,9501,8222,2720,20,20
2,1,1410,7000,1,0,0,3,7,1410,0,47.4908,-122.223,1540,6000,8410,7540,1410,51,51
4,3,2130,4838,1,0,0,4,7,2130,0,47.4871,-122.203,1070,4838,6968,5908,2130,89,89
3,1,880,5375,1,0,0,4,5,880,0,47.4858,-122.202,980,4838,6255,5818,880,95,95
4,2.5,2398,5988,2,0,0,3,8,2398,0,47.452,-122.204,2370,5988,8386,8358,2398,11,11
4,2.5,3140,9225,1,0,2,5,9,1770,1370,47.4904,-122.226,2460,9600,12365,12060,3140,53,53
4,2,2750,9001,1,0,0,3,8,2750,0,47.457,-122.189,1340,11050,11751,12390,2750,11,11
4,2.5,1714,3080,2,0,0,3,8,1714,0,47.429,-122.188,1714,3250,4794,4964,1714,10,10
1,1,730,6890,1,0,0,4,4,730,0,47.467,-122.215,1790,7969,7620,9759,730,93,93
6,2.5,2590,11250,1,0,0,4,8,1390,1200,47.4608,-122.196,2270,8360,13840,10630,2590,41,41
5,2.25,2240,9652,2,0,0,3,7,2240,0,47.4249,-122.211,2180,11644,11892,13824,2240,29,29
2,1,1140,15120,1,0,0,4,6,990,150,47.4521,-122.196,2320,11250,16260,13570,1140,87,87
4,1.5,1540,7168,1,0,0,3,7,1160,380,47.455,-122.198,1540,7176,8708,8716,1540,55,55
2,1,900,4397,1,0,0,3,6,900,0,47.4851,-122.205,1430,4500,5297,5930,900,101,101
3,2.25,1530,6600,1,0,0,4,7,1240,290,47.462,-122.188,1500,7700,8130,9200,1530,51,51
4,2.25,2130,8078,1,0,0,4,7,1380,750,47.4482,-122.209,2300,8112,10208,10412,2130,42,42
3,2.25,2010,4400,1,0,0,3,7,2010,0,47.4735,-122.189,1720,4187,6410,5907,2010,33,33
4,1,1500,5750,1,0,0,3,6,1500,0,47.4768,-122.206,1330,5750,7250,7080,1500,94,94
4,2,1480,8625,1,0,0,4,7,1480,0,47.462,-122.193,2130,8502,10105,10632,1480,45,45
3,2.25,2200,8000,2,0,0,3,8,2200,0,47.4522,-122.208,2170,8000,10200,10170,2200,38,38
3,2,2260,11305,1,0,0,3,7,1130,1130,47.4544,-122.204,2080,10248,13565,12328,2260,33,33
3,1,1170,9730,1,0,0,3,7,1170,0,47.4562,-122.196,1680,10125,10900,11805,1170,51,28
3,1,1340,4800,1,0,0,4,5,1340,0,47.477,-122.209,1240,4800,6140,6040,1340,116,116
3,1.75,1480,6800,1,0,0,4,7,1480,0,47.4633,-122.188,1500,7900,8280,9400,1480,51,51
4,1,1100,5000,1,0,0,5,6,1100,0,47.4868,-122.204,1560,4838,6100,6398,1100,115,115
3,2.5,1190,8175,1,0,0,3,7,1190,0,47.4556,-122.203,2230,9520,9365,11750,1190,33,33
4,2.25,1780,10416,1,0,0,5,7,1060,720,47.4414,-122.189,1780,9975,12196,11755,1780,56,56
3,1.75,1680,6108,1,0,0,3,8,1680,0,47.4501,-122.208,2220,5664,7788,7884,1680,30,30
4,3.5,3540,4750,2,0,0,3,10,3540,0,47.473,-122.193,3310,5655,8290,8965,3540,16,16
4,2.25,1810,9240,2,0,0,3,7,1810,0,47.4362,-122.187,1660,9240,11050,10900,1810,58,58
1,1,460,4120,1,0,0,3,4,460,0,47.4868,-122.199,990,4120,4580,5110,460,82,82
3,1,1230,10350,1,0,0,4,7,1230,0,47.428,-122.199,1510,10427,11580,11937,1230,62,62
3,1.5,1380,11760,1,0,0,4,7,1380,0,47.4243,-122.202,1650,9855,13140,11505,1380,56,56
3,2.5,3080,7363,2,0,0,3,9,3080,0,47.4473,-122.205,2860,5273,10443,8133,3080,13,13
2,1,1150,30184,1,0,0,3,6,1150,0,47.4492,-122.2,1670,19684,31334,21354,1150,69,69
4,3.25,3569,8327,2,0,0,3,10,3569,0,47.4595,-122.208,2550,5251,11896,7801,3569,6,6
3,2.5,1700,7496,2,0,0,3,8,1700,0,47.432,-122.189,2280,7496,9196,9776,1700,25,25
4,3.5,3180,4869,2,0,0,3,8,2390,790,47.4482,-122.206,2850,4500,8049,7350,3180,12,12
3,3,1670,4120,1,0,0,3,7,1140,530,47.4881,-122.199,1010,4120,5790,5130,1670,90,3
2,2,1590,8000,1,0,0,3,7,910,680,47.459,-122.205,1590,8364,9590,9954,1590,35,35
4,2,1980,10585,1,0,0,2,6,1980,0,47.4836,-122.214,1360,7810,12565,9170,1980,95,95
3,2.25,1960,17126,1,0,0,3,8,1400,560,47.4436,-122.21,2060,11466,19086,13526,1960,53,53
3,2.5,1670,5791,2,0,0,3,7,1670,0,47.4424,-122.188,1610,6034,7461,7644,1670,24,24
3,2.5,1770,2677,2,0,0,3,7,1770,0,47.4339,-122.194,1550,1798,4447,3348,1770,14,14
3,2.5,1650,2802,2,0,0,3,7,1650,0,47.4328,-122.196,1490,2084,4452,3574,1650,15,15
2,1,850,5000,1,0,0,3,5,850,0,47.4874,-122.207,910,4815,5850,5725,850,112,112
2,2,1070,4500,1,0,0,4,6,910,160,47.4896,-122.204,1280,4500,5570,5780,1070,87,87
3,2.5,1860,44093,1,0,0,3,7,1860,0,47.4381,-122.188,1900,6130,45953,8030,1860,41,41
3,1.5,1200,9120,1,0,0,3,7,1000,200,47.4545,-122.187,1640,9200,10320,10840,1200,56,56
3,2.5,3050,158558,1,0,0,4,9,3050,0,47.4326,-122.208,2960,31050,161608,34010,3050,32,32
3,1,1240,5250,1,0,0,4,6,1240,0,47.4917,-122.206,1240,5250,6490,6490,1240,115,115
3,2.5,1880,7838,2,0,0,3,7,1880,0,47.4439,-122.19,1810,7915,9718,9725,1880,25,25
4,3.5,3217,4000,2,0,0,3,8,2587,630,47.4483,-122.203,2996,5418,7217,8414,3217,11,11
2,1,1400,4500,1,0,0,3,7,900,500,47.4866,-122.219,1400,5500,5900,6900,1400,97,97
4,2.5,2370,10580,2,0,0,3,8,2370,0,47.464,-122.192,1590,8584,12950,10174,2370,53,53
1,1.5,1048,4800,1,0,0,3,7,1048,0,47.4759,-122.212,950,4800,5848,5750,1048,77,77
4,2.5,2798,4473,2,0,0,3,9,2798,0,47.4295,-122.205,2358,4593,7271,6951,2798,7,7
3,2.25,2000,7560,1,0,0,3,7,1400,600,47.4798,-122.228,2040,6949,9560,8989,2000,40,40
4,3.25,2510,7686,2,0,0,3,9,2510,0,47.4785,-122.228,2510,6732,10196,9242,2510,16,16
2,1.5,1200,5773,2,0,0,3,7,1200,0,47.4723,-122.19,1530,4576,6973,6106,1200,34,34
2,2.5,1100,1737,2,0,0,3,8,1100,0,47.4499,-122.189,1610,2563,2837,4173,1100,13,13
3,1.75,1690,3449,1,0,0,3,7,1690,0,47.4719,-122.191,1530,4093,5139,5623,1690,32,32
3,2.5,1770,3451,2,0,0,3,7,1770,0,47.4325,-122.197,1490,2138,5221,3628,1770,15,15
3,1.5,1820,8585,1,0,0,4,7,1820,0,47.4479,-122.213,1740,10088,10405,11828,1820,57,57
2,1,780,6000,1,0,0,5,6,780,0,47.4759,-122.208,1080,6000,6780,7080,780,96,96
3,1.75,1520,7439,1,0,0,4,7,1520,0,47.457,-122.208,1650,7500,8959,9150,1520,50,50
3,2.5,1830,2517,2,0,0,3,8,1830,0,47.4496,-122.189,1610,2762,4347,4372,1830,14,14
4,2.5,1870,7471,2,0,0,3,8,1870,0,47.4314,-122.204,2020,8912,9341,10932,1870,29,29
2,1,1130,12500,1,0,0,4,7,1130,0,47.4514,-122.187,1270,10798,13630,12068,1130,66,66
3,1.75,1440,7198,1,0,0,3,7,990,450,47.4333,-122.194,1550,7156,8638,8706,1440,38,38
3,2.5,1580,6860,2,0,0,3,7,1580,0,47.4447,-122.188,1580,7050,8440,8630,1580,24,24
4,2.5,1914,3272,2,0,0,3,8,1914,0,47.4297,-122.189,1714,3250,5186,4964,1914,10,10
3,2.5,2870,5490,2,0,0,3,9,2870,0,47.4471,-122.207,3040,5442,8360,8482,2870,11,11
4,2,2160,4800,2,0,0,4,7,1290,870,47.4777,-122.212,1570,4800,6960,6370,2160,90,90
3,1,1400,7955,1,0,0,3,7,1400,0,47.4848,-122.221,1160,14959,9355,16119,1400,55,55
3,1.75,2110,19600,1,0,0,4,8,2110,0,47.4742,-122.198,880,10077,21710,10957,2110,60,60
4,1.75,1680,19405,1,0,0,4,7,1560,120,47.4552,-122.202,2000,12900,21085,14900,1680,60,60
5,3.5,2815,5619,2,0,0,3,9,2815,0,47.4299,-122.207,2583,5295,8434,7878,2815,7,7
3,2.5,2330,8627,1,0,0,4,7,1480,850,47.4543,-122.21,1940,9607,10957,11547,2330,39,39
3,1.5,1200,2002,2,0,0,3,8,1200,0,47.4659,-122.189,1270,1848,3202,3118,1200,53,53
5,1.75,2590,6720,1,0,0,4,7,1750,840,47.435,-122.192,1820,7521,9310,9341,2590,40,40
2,1,1120,7797,1,0,0,3,6,1120,0,47.4871,-122.22,2180,7200,8917,9380,1120,71,71
4,1.75,2290,8142,1,0,0,4,7,1490,800,47.4564,-122.211,1840,8142,10432,9982,2290,50,50
4,1.5,2750,128502,1,0,0,2,7,1500,1250,47.4345,-122.198,1470,11514,131252,12984,2750,61,61
4,2.25,2380,7700,2,0,0,4,8,2380,0,47.4391,-122.194,2100,7700,10080,9800,2380,42,42
3,2,1390,5127,1,0,0,3,8,1390,0,47.4504,-122.206,1960,5019,6517,6979,1390,29,29
3,2.5,1900,7361,2,0,0,3,8,1900,0,47.4324,-122.191,2100,7361,9261,9461,1900,25,25
3,0.75,1040,42180,1,0,0,2,6,1040,0,47.4518,-122.199,1270,24090,43220,25360,1040,72,72
2,1,700,6000,1,0,0,3,6,700,0,47.4671,-122.212,1320,6000,6700,7320,700,76,76
4,2.5,2100,19680,1,0,0,3,6,2100,0,47.4787,-122.23,1340,12300,21780,13640,2100,105,105
4,3.5,3273,5115,2,0,0,3,8,2671,602,47.4477,-122.204,2996,5100,8388,8096,3273,5,5
4,2.75,1800,5453,1,0,0,3,7,1050,750,47.4632,-122.209,1820,6900,7253,8720,1800,17,17
3,1.75,1990,6500,1,0,0,3,7,1090,900,47.488,-122.221,2150,6500,8490,8650,1990,58,58
5,2.75,2000,9276,2,0,0,4,7,2000,0,47.444,-122.19,1240,8270,11276,9510,2000,51,51
4,2.25,1800,14722,1,0,0,3,7,1440,360,47.4874,-122.223,2400,10000,16522,12400,1800,57,57
3,2.5,3080,5598,2,0,0,3,8,3080,0,47.4372,-122.206,3080,5303,8678,8383,3080,13,13
2,1.75,1710,4187,1,0,0,3,7,1710,0,47.4732,-122.188,1760,4084,5897,5844,1710,32,32
3,1.75,1950,8712,1,0,0,3,7,1950,0,47.4391,-122.189,1820,11520,10662,13340,1950,59,59
4,2.5,3002,6042,2,0,0,3,8,3002,0,47.4231,-122.186,2566,6390,9044,8956,3002,15,15
5,2.5,3270,6129,2,0,0,3,9,3270,0,47.4461,-122.208,2980,5928,9399,8908,3270,15,15
2,1,1060,7700,1,0,0,3,7,820,240,47.4599,-122.205,1370,8833,8760,10203,1060,38,38
3,1.75,1890,9535,1,0,0,3,7,1210,680,47.4872,-122.223,2040,11108,11425,13148,1890,43,43
4,2.5,2090,5040,2,0,0,3,9,2090,0,47.4797,-122.23,1430,12000,7130,13430,2090,5,5
4,2.25,2100,8050,2,0,0,3,8,2100,0,47.4391,-122.193,2190,7700,10150,9890,2100,41,41
3,2.25,1910,3481,2,0,0,3,8,1910,0,47.4293,-122.188,1714,3177,5391,4891,1910,10,10
3,2.5,1490,2138,2,0,0,3,7,1490,0,47.4324,-122.197,1490,2094,3628,3584,1490,14,14
2,1,750,8125,1,0,0,4,6,750,0,47.4727,-122.198,1340,8750,8875,10090,750,76,76
4,2.5,1914,3150,2,0,0,3,8,1914,0,47.43,-122.188,1714,3164,5064,4878,1914,10,10
3,1.5,1460,8505,1,0,0,4,7,1460,0,47.4402,-122.195,1580,8505,9965,10085,1460,64,64
3,1.5,1300,7885,1,0,0,3,7,1300,0,47.4556,-122.209,1840,7600,9185,9440,1300,51,51
4,3.5,3420,4751,2,0,0,3,10,3420,0,47.4734,-122.193,3490,5700,8171,9190,3420,16,16
3,2.5,1630,5996,2,0,0,3,7,1630,0,47.4738,-122.19,1660,4504,7626,6164,1630,33,33
4,1,1350,11507,1,0,0,3,7,1350,0,47.4269,-122.197,1320,25675,12857,26995,1350,53,53
2,1,840,12750,1,0,0,3,6,840,0,47.484,-122.211,1480,6969,13590,8449,840,94,94
3,1,1550,12670,1,0,0,4,7,1550,0,47.5024,-122.169,1550,8880,14220,10430,1550,57,57
3,1,1090,10710,1,0,0,4,7,1090,0,47.5,-122.169,1090,10440,11800,11530,1090,57,57
3,1,1020,8610,1,0,0,5,7,1020,0,47.4974,-122.169,1070,5940,9630,7010,1020,60,60
3,1,1240,5700,1,0,0,5,6,1240,0,47.4927,-122.169,1140,5700,6940,6840,1240,66,66
3,2.5,2380,19860,2,0,0,4,8,2380,0,47.5255,-122.173,2450,10220,22240,12670,2380,24,24
3,2,2030,8649,1,0,0,3,7,2030,0,47.5082,-122.166,1760,7200,10679,8960,2030,21,21
3,3.5,4410,10756,2,1,4,3,11,3430,980,47.5283,-122.205,3550,5634,15166,9184,4410,5,5
3,1,1320,7200,1,0,0,4,7,1320,0,47.5048,-122.19,1720,7249,8520,8969,1320,60,60
3,1,890,8400,1,0,0,4,6,890,0,47.5168,-122.204,1850,5565,9290,7415,890,65,65
4,2.5,2520,6023,2,0,0,3,9,2520,0,47.5137,-122.167,2520,6023,8543,8543,2520,5,5
3,1.5,1610,6132,1,0,2,4,7,1090,520,47.5017,-122.174,1650,6132,7742,7782,1610,60,60
4,2.5,2400,9398,1,0,0,4,7,1310,1090,47.4952,-122.178,1330,8249,11798,9579,2400,61,61
3,2,1420,12655,1,0,0,5,7,1420,0,47.5309,-122.186,2020,9655,14075,11675,1420,51,51
4,2.5,1790,9787,1,0,2,4,8,1240,550,47.5344,-122.189,1790,9787,11577,11577,1790,36,36
3,2,1190,6445,1,0,0,3,7,1190,0,47.5057,-122.172,1920,8195,7635,10115,1190,23,23
5,2.75,2620,8861,1,0,0,5,8,1350,1270,47.5226,-122.183,1940,10800,11481,12740,2620,40,40
3,3.25,2770,6278,2,0,0,3,9,1980,790,47.5228,-122.199,1900,7349,9048,9249,2770,13,13
4,2,1610,9600,1,0,0,5,7,1610,0,47.5327,-122.186,1450,9600,11210,11050,1610,52,52
3,1,1030,8400,1,0,0,4,7,1030,0,47.5364,-122.173,1270,8400,9430,9670,1030,56,56
3,1,1220,5038,1,0,0,5,6,1220,0,47.496,-122.189,1140,5038,6258,6178,1220,77,77
2,1,870,5700,1,0,0,4,6,870,0,47.498,-122.17,1020,5700,6570,6720,870,62,62
3,1,1300,8160,1,0,0,4,7,1300,0,47.511,-122.172,1290,8970,9460,10260,1300,59,59
6,3.5,4430,11453,2,0,0,3,9,3000,1430,47.5156,-122.204,2730,5661,15883,8391,4430,18,18
5,3.75,4170,8142,2,0,2,3,10,4170,0,47.5354,-122.181,3030,7980,12312,11010,4170,13,13
3,2.5,2460,5400,1,0,0,4,8,1520,940,47.5231,-122.202,1745,5400,7860,7145,2460,18,18
3,1,1010,8711,1,0,0,5,6,1010,0,47.4914,-122.186,1250,8053,9721,9303,1010,75,75
2,1,720,4760,1,0,0,5,5,720,0,47.496,-122.186,840,4760,5480,5600,720,77,77
3,2.5,1680,4308,2,0,0,3,7,1680,0,47.4802,-122.179,2160,4182,5988,6342,1680,15,15
3,1,1380,7575,1,0,0,4,7,1380,0,47.5139,-122.187,1320,7600,8955,8920,1380,56,56
5,2.75,1940,4182,1,0,0,3,7,1240,700,47.4911,-122.17,1950,4182,6122,6132,1940,17,17
2,1,1020,8102,1,0,0,3,7,1020,0,47.5135,-122.193,1770,7291,9122,9061,1020,63,63
3,1,1660,11200,1,0,0,3,7,1660,0,47.5121,-122.168,1380,10875,12860,12255,1660,62,62
4,2.5,2440,7322,2,0,0,3,9,2440,0,47.5357,-122.179,2590,9927,9762,12517,2440,28,28
4,3.25,2510,5311,2,0,0,3,9,2510,0,47.5028,-122.17,1590,9583,7821,11173,2510,10,10
2,1,800,5600,1,0,0,5,6,800,0,47.4959,-122.172,1100,6000,6400,7100,800,64,64
3,1,1050,5000,1,0,0,4,6,1050,0,47.4923,-122.165,1050,5200,6050,6250,1050,52,52
3,1.5,1830,9848,1,0,0,5,7,1830,0,47.539,-122.18,1830,8168,11678,9998,1830,57,57
3,2.5,2700,6947,2,0,3,3,9,2700,0,47.5172,-122.208,2500,6947,9647,9447,2700,6,6
5,3.5,3790,8200,1,0,1,3,8,2120,1670,47.4891,-122.19,1740,8676,11990,10416,3790,18,18
4,2.5,2510,5258,2,0,0,3,7,2510,0,47.4818,-122.188,2570,5119,7768,7689,2510,18,18
3,2.5,2100,9040,1,0,0,3,8,1700,400,47.5329,-122.173,2430,8809,11140,11239,2100,30,30
2,1,1150,5695,1,0,0,4,6,1150,0,47.4989,-122.171,1150,5695,6845,6845,1150,61,61
4,1,1300,18836,1,0,0,4,7,1300,0,47.5029,-122.188,1540,8498,20136,10038,1300,78,78
3,1.5,1340,7725,1,0,0,4,8,1340,0,47.5389,-122.173,1990,7725,9065,9715,1340,52,52
5,3.5,3060,8862,2,0,0,3,8,3060,0,47.5322,-122.185,2680,8398,11922,11078,3060,30,30
2,1,970,8874,1,0,0,3,7,970,0,47.4943,-122.178,1340,8175,9844,9515,970,51,51
3,1.75,1200,5478,1,0,0,5,6,1200,0,47.4959,-122.174,1270,6855,6678,8125,1200,64,64
2,2.25,1610,1968,2,0,0,4,7,1610,0,47.5184,-122.196,1950,1968,3578,3918,1610,40,40
2,1,740,5200,1,0,0,4,5,740,0,47.4934,-122.173,750,5200,5940,5950,740,67,67
2,2.25,1610,1968,2,0,0,5,7,1610,0,47.5184,-122.196,1950,1968,3578,3918,1610,40,40
3,1,1130,12519,1,0,0,3,7,1130,0,47.4965,-122.176,1460,12507,13649,13967,1130,61,61
4,2.5,2590,6474,2,0,0,3,8,2590,0,47.5164,-122.19,1960,8679,9064,10639,2590,5,5
4,1.5,1820,17918,1,0,0,4,8,1190,630,47.521,-122.179,1890,15241,19738,17131,1820,57,57
5,3,3880,7180,2,0,0,3,7,3880,0,47.4797,-122.179,2160,4793,11060,6953,3880,15,15
4,1.75,1920,7700,2,0,0,4,7,1920,0,47.5381,-122.177,1310,7700,9620,9010,1920,49,49
4,2.5,2850,25993,2,0,0,4,9,2850,0,47.5318,-122.17,2480,12672,28843,15152,2850,30,30
5,4,4660,9900,2,0,2,4,9,2600,2060,47.5135,-122.2,3380,9900,14560,13280,4660,40,40
3,2.25,2430,7614,1,0,0,3,8,1900,530,47.5065,-122.191,1720,11250,10044,12970,2430,40,40
3,2.5,2470,4565,2,0,0,3,7,2470,0,47.514,-122.189,2470,5064,7035,7534,2470,14,14
5,2.5,3370,4850,2,0,0,3,9,3370,0,47.5078,-122.169,2900,5570,8220,8470,3370,12,12
4,2.5,2450,5079,2,0,0,3,9,2450,0,47.5214,-122.191,2690,6675,7529,9365,2450,18,18
3,2.75,2670,3738,1,0,0,3,10,1720,950,47.5299,-122.203,2610,3734,6408,6344,2670,6,6
3,1,1060,7246,1,0,0,4,6,1060,0,47.4936,-122.165,1090,6694,8306,7784,1060,38,38
2,1,930,4743,1,0,0,4,5,930,0,47.4966,-122.187,930,4779,5673,5709,930,77,77
3,1.75,1650,14633,1,0,0,4,7,1650,0,47.4984,-122.176,1370,12495,16283,13865,1650,61,61
5,2.75,3050,7520,2,0,0,3,8,3050,0,47.5245,-122.184,2180,10800,10570,12980,3050,5,5
4,3.5,3710,10400,2,0,0,3,8,2290,1420,47.5041,-122.186,1720,4276,14110,5996,3710,17,17
3,2.25,1870,3230,2,0,0,3,7,1870,0,47.4915,-122.167,1620,3363,5100,4983,1870,22,22
4,1.75,1840,5100,1,0,0,4,5,1840,0,47.5209,-122.205,2160,5400,6940,7560,1840,86,86
3,1.75,1400,8364,1,0,0,4,7,1400,0,47.4918,-122.178,1210,8160,9764,9370,1400,61,61
3,2.75,2290,14810,1,0,0,5,7,1400,890,47.5343,-122.185,2540,8640,17100,11180,2290,52,52
3,2,1300,22605,1,0,0,3,7,1300,0,47.5337,-122.187,2250,10215,23905,12465,1300,21,21
3,1,990,9950,1,0,0,5,7,990,0,47.5104,-122.171,1370,9260,10940,10630,990,58,58
4,2.25,2020,12500,2,0,0,2,8,2020,0,47.5403,-122.175,1800,13175,14520,14975,2020,53,53
3,1.5,1030,7184,1,0,0,4,7,1030,0,47.5069,-122.189,1330,7262,8214,8592,1030,51,51
5,1.5,2550,6300,1,0,0,4,7,1560,990,47.5014,-122.172,1380,6300,8850,7680,2550,60,60
4,2.5,2830,6163,2,0,0,3,9,2830,0,47.5227,-122.19,2730,6202,8993,8932,2830,19,19
3,2.5,1960,3480,2,0,0,3,7,1960,0,47.4802,-122.18,2560,3500,5440,6060,1960,15,15
4,1.75,1870,12500,1,0,1,5,6,1030,840,47.511,-122.197,2060,14141,14370,16201,1870,76,76
3,1,1460,5825,1,0,0,5,5,1260,200,47.4958,-122.191,1150,5926,7285,7076,1460,77,77
3,2.5,2250,11632,2,0,0,3,8,2250,0,47.5272,-122.169,2360,11632,13882,13992,2250,31,31
3,1.75,1500,8352,1,0,2,5,6,750,750,47.4883,-122.191,1500,8447,9852,9947,1500,76,76
3,1,1250,15603,1,0,0,4,7,1250,0,47.5093,-122.172,1720,10220,16853,11940,1250,60,60
3,2.75,3160,9072,2,0,0,3,9,3160,0,47.5147,-122.177,3160,9072,12232,12232,3160,14,14
2,1,700,7303,1,0,0,5,5,700,0,47.4934,-122.166,960,6060,8003,7020,700,66,66
3,1.75,1750,10870,1,0,0,5,7,1750,0,47.4989,-122.188,1230,10868,12620,12098,1750,51,51
3,1.75,1580,9719,1,0,0,5,7,1580,0,47.5396,-122.18,1760,8539,11299,10299,1580,57,57
4,1.75,2420,8400,1,0,0,5,7,1620,800,47.5017,-122.165,1660,8400,10820,10060,2420,55,55
4,2.25,1770,5236,2,0,0,3,7,1770,0,47.5137,-122.189,2470,5064,7006,7534,1770,12,12
4,1.75,3000,42200,1,0,3,3,7,1500,1500,47.5265,-122.202,2500,9821,45200,12321,3000,69,69
4,2.75,2980,13260,1,0,0,4,8,1800,1180,47.5152,-122.197,1920,10731,16240,12651,2980,40,40
4,2.5,2760,6850,2,0,0,3,9,2760,0,47.5346,-122.185,2640,9803,9610,12443,2760,20,20
3,1,960,5700,1,0,0,4,5,960,0,47.4983,-122.172,960,5700,6660,6660,960,63,63
4,2.5,2840,6284,2,0,0,3,9,2840,0,47.5135,-122.169,2790,7168,9124,9958,2840,6,6
3,2.25,1950,1968,2,0,0,4,7,1160,790,47.5179,-122.195,1950,1968,3918,3918,1950,40,40
3,1,1270,8792,1,0,0,5,7,1270,0,47.5351,-122.174,1780,8792,10062,10572,1270,50,50
4,3,3280,11060,2,0,0,3,8,2270,1010,47.5399,-122.181,2320,11004,14340,13324,3280,33,33
2,1,1010,7338,2,0,0,4,7,1010,0,47.5123,-122.19,1220,7719,8348,8939,1010,38,38
4,1.75,2580,19607,1,0,2,4,8,1290,1290,47.5067,-122.197,1970,9569,22187,11539,2580,61,61
3,1.75,1460,7203,1,0,0,3,7,1460,0,47.5049,-122.189,1570,7203,8663,8773,1460,29,29
2,2.25,2550,5663,1,0,0,3,10,1720,830,47.5304,-122.202,2560,3828,8213,6388,2550,8,8
4,3.5,2850,5577,2,0,0,3,8,1950,900,47.5252,-122.192,2850,5708,8427,8558,2850,5,5
4,2.5,3270,6055,2,0,0,3,9,3270,0,47.5374,-122.192,2740,7367,9325,10107,3270,12,12
3,1,1200,9087,1,0,0,5,7,1200,0,47.5234,-122.177,1250,11826,10287,13076,1200,50,50
4,2.5,2440,5001,2,0,0,3,8,2440,0,47.5108,-122.193,2260,5001,7441,7261,2440,14,14
4,2.5,2260,5164,2,0,0,3,8,2260,0,47.509,-122.166,2260,5866,7424,8126,2260,23,23
7,3,2800,9569,1,0,2,3,7,1400,1400,47.5102,-122.183,2150,7333,12369,9483,2800,56,56
3,2.5,1680,4584,2,0,0,3,7,1680,0,47.4794,-122.182,2160,4621,6264,6781,1680,16,16
5,1.5,2550,6300,1,0,0,4,7,1560,990,47.5014,-122.172,1380,6300,8850,7680,2550,60,60
4,2.5,2600,4506,2,0,0,3,9,2600,0,47.5146,-122.188,2470,6041,7106,8511,2600,14,14
3,1.5,2840,10182,1,0,0,3,8,1510,1330,47.524,-122.2,2210,9669,13022,11879,2840,68,68
4,2.25,2890,18226,3,1,4,3,10,2890,0,47.5169,-122.209,2870,11151,21116,14021,2890,35,35
3,1,1410,8174,1,0,0,3,8,1410,0,47.4969,-122.178,1500,8058,9584,9558,1410,61,61
4,2.5,3010,6181,2,0,0,3,9,3010,0,47.5212,-122.192,2960,6515,9191,9475,3010,19,19
4,2.5,2286,8269,2,0,0,3,8,2286,0,47.5174,-122.194,2110,4711,10555,6821,2286,17,17
3,2.25,1760,10013,2,0,0,4,8,1760,0,47.5336,-122.189,1810,9768,11773,11578,1760,36,36
3,1.75,1380,9134,1,0,0,5,7,880,500,47.5087,-122.193,1400,8190,10514,9590,1380,38,38
4,2.5,2240,4616,2,0,0,3,7,1840,400,47.5118,-122.194,2260,5200,6856,7460,2240,18,18
5,3.5,3960,25245,2,0,0,3,9,2500,1460,47.525,-122.172,2640,13675,29205,16315,3960,23,23
4,2.5,2160,4500,2,0,0,3,7,2160,0,47.4819,-122.182,2160,4496,6660,6656,2160,17,17
5,2,2400,9537,1,0,0,5,7,1210,1190,47.5112,-122.186,1760,9533,11937,11293,2400,60,60
4,3,3150,6599,2,0,0,3,9,3150,0,47.5279,-122.199,2680,9430,9749,12110,3150,11,11
5,2.75,2930,7663,2,0,0,3,9,2930,0,47.5308,-122.184,2750,10335,10593,13085,2930,6,6
3,2.5,1960,12476,2,0,0,4,8,1960,0,47.5315,-122.172,2450,12177,14436,14627,1960,30,30
4,2.5,2280,4096,2,0,0,3,7,2280,0,47.4834,-122.182,2280,3600,6376,5880,2280,16,16
3,2.5,1600,3573,2,0,0,3,7,1600,0,47.507,-122.181,1500,11089,5173,12589,1600,6,6
3,2.25,3270,168000,2,0,0,4,10,3270,0,47.5197,-122.191,3220,7963,171270,11183,3270,37,37
3,1,970,7854,1,0,0,4,7,970,0,47.4899,-122.185,1480,7800,8824,9280,970,39,39
3,1,1240,10800,1,0,0,5,7,1240,0,47.5233,-122.185,1810,10800,12040,12610,1240,60,60
3,1,1390,6000,1,0,0,3,5,1390,0,47.4977,-122.175,1170,6000,7390,7170,1390,65,65
2,1,1000,7615,1,0,0,4,6,1000,0,47.49,-122.191,1060,8000,8615,9060,1000,76,76
3,1.5,1900,7584,1,0,0,5,7,1900,0,47.5091,-122.19,1410,7584,9484,8994,1900,57,57
3,1,1960,9583,2,0,0,2,5,1960,0,47.505,-122.171,1850,8324,11543,10174,1960,111,111
3,1,1270,8925,1,0,0,5,7,1270,0,47.5124,-122.165,1270,8996,10195,10266,1270,64,64
3,2.5,2710,6174,2,0,0,3,9,2710,0,47.512,-122.174,2730,7266,8884,9996,2710,21,21
4,2.75,2150,9915,1,0,0,5,8,1240,910,47.5378,-122.17,1980,9325,12065,11305,2150,43,43
2,1,820,5100,1,0,0,4,6,820,0,47.5175,-122.205,2270,5100,5920,7370,820,65,65
3,1,1260,10900,1,0,0,4,6,1260,0,47.491,-122.188,1090,8137,12160,9227,1260,76,76
4,1.75,1890,10550,1,0,0,5,7,1010,880,47.5147,-122.193,1930,7291,12440,9221,1890,50,50
4,2.5,2440,11005,2,0,0,3,9,2440,0,47.5318,-122.176,2590,14754,13445,17344,2440,25,25
2,1,880,6900,1,0,0,3,6,880,0,47.4903,-122.191,1060,8000,7780,9060,880,76,76
4,2.5,2280,14810,1,0,0,5,8,1500,780,47.5392,-122.186,2690,12196,17090,14886,2280,42,42
5,2.75,3710,8674,2,0,0,3,9,3710,0,47.514,-122.176,3250,8678,12384,11928,3710,23,23
4,2.75,3370,7634,1,0,2,5,8,2110,1260,47.5259,-122.204,2460,7634,11004,10094,3370,42,42
3,1.75,1400,5648,1,0,0,5,6,1400,0,47.5133,-122.196,2320,9420,7048,11740,1400,102,102
4,2.5,2620,10016,2,0,0,3,8,2620,0,47.5295,-122.179,2620,10016,12636,12636,2620,23,23
3,2,1350,6696,1,0,0,5,6,680,670,47.4919,-122.187,1350,6700,8046,8050,1350,75,75
4,2.5,2500,8282,2,0,0,3,9,2500,0,47.5127,-122.169,2500,8046,10782,10546,2500,6,6
4,1.75,2180,7876,1,0,0,4,7,1290,890,47.5157,-122.191,1960,7225,10056,9185,2180,42,42
3,2.5,2400,6975,2,0,0,3,9,2400,0,47.534,-122.179,2640,11172,9375,13812,2400,26,26
5,3.5,2760,3865,2,0,0,3,8,2760,0,47.5049,-122.17,2590,4587,6625,7177,2760,6,6
4,3.25,2760,4104,2,0,0,3,8,1900,860,47.5286,-122.187,2760,5186,6864,7946,2760,5,5
3,1,1160,6132,1,0,0,4,7,1160,0,47.5015,-122.173,1280,6132,7292,7412,1160,61,61
4,2,3160,11193,1,0,0,5,6,2410,750,47.4937,-122.184,1020,5940,14353,6960,3160,77,77
4,2.5,2610,5562,2,0,0,3,9,2610,0,47.5137,-122.169,2720,7400,8172,10120,2610,6,6
3,2,1630,8702,1,0,0,3,9,1630,0,47.5168,-122.193,2250,9890,10332,12140,1630,32,32
4,2.5,2040,5875,2,0,0,3,8,2040,0,47.5051,-122.17,2230,5459,7915,7689,2040,15,15
3,1.75,2080,7700,1,0,0,5,7,1600,480,47.5375,-122.178,1680,7700,9780,9380,2080,51,51
3,1.5,1120,8250,1,0,0,4,7,1120,0,47.4905,-122.179,1320,8400,9370,9720,1120,62,62
3,2.5,2180,9722,2,0,0,3,8,2180,0,47.527,-122.173,2440,9722,11902,12162,2180,25,25
4,2.5,3220,18618,2,0,1,3,10,3220,0,47.5326,-122.181,2650,11896,21838,14546,3220,28,28
3,1.75,1590,11454,1,0,0,4,8,1590,0,47.5049,-122.186,1970,9960,13044,11930,1590,40,40
3,2.5,1590,4108,2,0,0,3,7,1590,0,47.4832,-122.181,2160,3912,5698,6072,1590,16,16
4,2.75,2980,9825,1,0,0,3,8,1910,1070,47.5073,-122.172,2580,12231,12805,14811,2980,12,12
4,2.75,3440,8150,2,0,0,3,10,3440,0,47.5168,-122.189,2560,8315,11590,10875,3440,5,5
4,1.75,1430,5490,1,0,0,5,6,1430,0,47.494,-122.184,1030,5900,6920,6930,1430,77,77
3,1.75,2000,36000,1,0,0,3,6,2000,0,47.5217,-122.182,2100,9681,38000,11781,2000,73,19
4,3.5,3630,5670,2,0,0,3,10,3630,0,47.5189,-122.206,1620,5400,9300,7020,3630,49,7
4,2.5,2580,6260,2,0,0,3,7,2580,0,47.4858,-122.185,2160,3600,8840,5760,2580,15,15
4,2,2630,9663,1,0,1,4,8,1330,1300,47.4841,-122.19,1900,8894,12293,10794,2630,63,63
3,1,960,5512,1,0,0,4,6,960,0,47.4944,-122.165,1090,5837,6472,6927,960,56,56
4,3.5,2370,3692,2,0,0,3,8,2370,0,47.5044,-122.17,2520,5425,6062,7945,2370,6,6
3,3.5,3390,10078,2,0,0,3,10,3040,350,47.537,-122.185,3290,12332,13468,15622,3390,7,7
3,1.5,1130,7223,1,0,0,4,7,1130,0,47.5089,-122.189,1320,7356,8353,8676,1130,58,58
3,2.5,1870,3480,2,0,0,3,7,1870,0,47.4831,-122.183,2160,3480,5350,5640,1870,17,17
3,2.25,1990,4331,2,0,0,3,7,1990,0,47.4917,-122.167,1690,3688,6321,5378,1990,22,22
5,3.25,3090,7069,2,0,0,3,9,3090,0,47.5114,-122.196,2480,8000,10159,10480,3090,7,7
5,3,2630,3149,2,0,0,3,8,1670,960,47.5065,-122.171,2240,4825,5779,7065,2630,6,6
2,1,1020,7679,1,0,0,5,6,1020,0,47.4915,-122.188,1280,6497,8699,7777,1020,77,77
2,2.25,1610,1968,2,0,0,4,7,1610,0,47.5184,-122.196,1950,1968,3578,3918,1610,40,40
3,2.5,1610,10292,1,0,0,4,7,1190,420,47.5349,-122.174,1940,8700,11902,10640,1610,50,50
4,2.5,2160,5455,2,0,0,3,7,2160,0,47.4799,-122.183,2160,5257,7615,7417,2160,16,16
4,2.5,2240,5500,2,0,0,3,8,2240,0,47.496,-122.169,700,5500,7740,6200,2240,6,6
3,2.25,1450,7562,2,0,0,3,7,1450,0,47.5038,-122.189,1650,7625,9012,9275,1450,25,25
3,2.5,2070,12708,2,0,0,3,8,2070,0,47.5295,-122.18,2620,9617,14778,12237,2070,23,23
3,1,950,8400,1,0,0,3,7,950,0,47.5104,-122.166,1250,8400,9350,9650,950,61,61
4,1.75,2260,7200,1,0,0,5,7,1360,900,47.5122,-122.186,1410,7465,9460,8875,2260,95,95
6,2,1750,17685,1,0,0,4,5,1750,0,47.5096,-122.178,1750,9209,19435,10959,1750,76,76
4,2.5,2420,7744,2,0,0,3,9,2420,0,47.534,-122.18,2820,11129,10164,13949,2420,25,25
2,1,720,4222,1,0,0,4,5,720,0,47.4965,-122.186,860,4785,4942,5645,720,77,77
5,2.75,2550,7725,1,0,0,5,8,1390,1160,47.5388,-122.171,2450,7725,10275,10175,2550,52,52
4,2.5,2590,7891,2,0,0,3,9,2590,0,47.5055,-122.194,1400,7891,10481,9291,2590,13,13
4,2.5,2150,7303,2,0,0,3,8,2150,0,47.5109,-122.183,1940,9569,9453,11509,2150,14,14
4,2.5,2630,6185,2,0,0,3,9,2630,0,47.5229,-122.192,2720,6185,8815,8905,2630,20,20
3,2.25,2180,11100,1,0,0,5,8,1700,480,47.5162,-122.176,2350,11397,13280,13747,2180,40,40
3,3,2300,7701,1,0,0,3,7,2300,0,47.5102,-122.18,1570,8116,10001,9686,2300,59,59
2,1,1250,12507,1,0,0,5,7,1250,0,47.4972,-122.176,1250,12498,13757,13748,1250,61,61
4,1.75,2160,7417,1,0,0,4,7,1360,800,47.5122,-122.181,1880,8022,9577,9902,2160,36,36
3,1.75,1970,10800,1,0,0,4,7,1300,670,47.5107,-122.172,1970,8768,12770,10738,1970,40,40
3,2,1430,12430,1,0,0,4,7,1430,0,47.4903,-122.178,1200,8250,13860,9450,1430,62,62
3,3.5,2070,11658,1,0,0,4,8,1370,700,47.537,-122.178,1930,8744,13728,10674,2070,42,42
3,1.5,1520,7123,1,0,0,4,7,1520,0,47.4991,-122.176,1450,8023,8643,9473,1520,60,60
2,1,690,5280,1,0,0,4,5,690,0,47.4953,-122.187,1140,4860,5970,6000,690,77,77
3,1.75,1560,7500,1,0,0,4,8,1560,0,47.489,-122.18,1600,7904,9060,9504,1560,53,53
4,1,1640,8467,1,0,2,4,6,1220,420,47.4894,-122.188,1060,7396,10107,8456,1640,76,76
3,1.75,1810,10800,1,0,0,5,8,1210,600,47.5236,-122.184,1800,10800,12610,12600,1810,51,51
3,1,1270,8920,1,0,0,5,7,1270,0,47.534,-122.172,1590,8589,10190,10179,1270,50,50
4,1,1610,8401,1,0,0,3,7,1610,0,47.5104,-122.165,1610,8401,10011,10011,1610,61,61
3,2,2270,148975,1,0,0,4,6,1270,1000,47.5092,-122.195,2210,17388,151245,19598,2270,119,34
4,2.5,2760,8558,2,0,0,3,7,2760,0,47.4802,-122.189,2760,7703,11318,10463,2760,18,18
2,1,700,5100,1,0,0,4,5,700,0,47.4957,-122.168,970,5811,5800,6781,700,66,66
4,1.75,2520,7200,1,0,2,5,7,1260,1260,47.4835,-122.192,2360,7300,9720,9660,2520,64,64
3,1,1430,12420,1,0,0,3,7,1430,0,47.5116,-122.191,1900,10350,13850,12250,1430,55,55
4,2.5,2070,6180,2,0,0,3,8,2070,0,47.4915,-122.183,1250,6018,8250,7268,2070,12,12
4,2.5,2600,6536,2,0,0,3,9,2600,0,47.5232,-122.191,2640,6185,9136,8825,2600,20,20
3,1,1020,8400,1,0,0,4,7,1020,0,47.4905,-122.18,1690,8030,9420,9720,1020,62,62
2,1,860,5800,1,0,0,5,5,860,0,47.4979,-122.183,900,6000,6660,6900,860,77,77
4,2.75,2740,7872,2,0,0,3,10,2740,0,47.4954,-122.172,1220,6300,10612,7520,2740,4,4
2,2.5,2730,7246,2,0,0,3,9,2730,0,47.512,-122.175,3220,7214,9976,10434,2730,21,21
4,2,1440,7641,1,0,0,4,5,1440,0,47.508,-122.183,1440,7750,9081,9190,1440,76,76
4,2.5,2550,7200,2,0,2,3,7,2550,0,47.4793,-122.18,2560,5715,9750,8275,2550,16,16
5,1.5,2040,11772,1,0,0,4,7,1030,1010,47.5015,-122.166,1560,9435,13812,10995,2040,56,56
3,3.25,2650,7819,1,0,2,4,8,1760,890,47.4821,-122.192,2400,7727,10469,10127,2650,63,63
4,2.75,3320,10574,2,0,0,5,8,2220,1100,47.5376,-122.18,2720,8330,13894,11050,3320,59,59
3,2.5,2380,5269,2,0,0,3,8,2380,0,47.5066,-122.192,2150,7600,7649,9750,2380,11,11
3,2.25,2530,27227,2,0,0,3,8,2530,0,47.527,-122.193,2160,30192,29757,32352,2530,32,32
3,2.5,2450,7051,1,0,0,3,8,1870,580,47.5308,-122.171,2450,8788,9501,11238,2450,29,29
3,2,1720,11875,1,0,0,5,6,1720,0,47.5068,-122.191,1860,7500,13595,9360,1720,114,114
5,2.5,3150,9134,1,0,0,4,8,1640,1510,47.4934,-122.189,1990,9133,12284,11123,3150,53,53
4,1.5,3050,82764,1,0,0,3,8,1650,1400,47.5266,-122.189,2930,10074,85814,13004,3050,53,53
3,2,3085,7280,1,0,0,4,7,1560,1525,47.4956,-122.181,1480,7900,10365,9380,3085,60,60
2,1,700,5000,1,0,0,5,6,700,0,47.4927,-122.172,1040,5200,5700,6240,700,67,67
3,1,1400,9450,1,0,0,4,7,1060,340,47.5051,-122.194,1400,8108,10850,9508,1400,64,64
3,1.5,1020,10152,1,0,0,5,6,1020,0,47.4971,-122.168,1320,8892,11172,10212,1020,60,60
3,2.5,1600,2244,2,0,0,3,7,1600,0,47.4899,-122.164,1600,1700,3844,3300,1600,14,14
4,2.5,2230,5650,2,0,0,3,7,2230,0,47.5073,-122.168,1590,7241,7880,8831,2230,8,8
3,1,1800,7650,1,0,0,5,7,1800,0,47.4922,-122.178,1230,7650,9450,8880,1800,62,62
3,1,1090,7315,1,0,0,5,6,1090,0,47.494,-122.165,1090,5800,8405,6890,1090,38,38
4,2.5,2390,6976,2,0,0,3,7,2390,0,47.4807,-122.182,2390,6346,9366,8736,2390,16,16
3,2.5,3040,7880,2,0,0,3,9,3040,0,47.5277,-122.184,3040,7880,10920,10920,3040,15,15
4,1.75,1340,8400,1,0,0,5,7,1340,0,47.5382,-122.173,1980,8400,9740,10380,1340,52,52
3,2.5,3180,7904,1,0,0,3,8,1810,1370,47.489,-122.181,1950,7800,11084,9750,3180,13,13
3,1.75,1390,7904,1,0,0,3,7,1390,0,47.4892,-122.181,1910,7904,9294,9814,1390,34,34
3,2.75,2120,7650,1,0,0,4,7,2120,0,47.4923,-122.178,1180,7650,9770,8830,2120,61,61
3,1.5,1540,8400,1,0,0,5,7,1540,0,47.5237,-122.199,1690,7689,9940,9379,1540,51,51
3,2.25,2190,7149,1,0,1,4,8,1240,950,47.5243,-122.204,3500,7149,9339,10649,2190,56,56
3,2.5,2480,8676,2,0,0,4,8,2480,0,47.53,-122.172,2540,9496,11156,12036,2480,30,30
4,2.5,1940,3784,2,0,0,3,8,1940,0,47.4513,-122.119,1940,4499,5724,6439,1940,16,16
3,2.25,1580,6561,1,0,0,3,8,1200,380,47.4394,-122.14,1710,7241,8141,8951,1580,38,38
4,2.25,2810,12607,2,0,0,3,10,2810,0,47.4585,-122.13,2810,17400,15417,20210,2810,34,34
2,1,790,7275,1,0,0,4,6,790,0,47.4771,-122.174,850,7399,8065,8249,790,75,75
3,2.5,3150,20189,2,0,0,3,10,3150,0,47.447,-122.088,2920,20612,23339,23532,3150,29,29
4,2.5,2710,6558,2,0,0,3,9,2710,0,47.434,-122.109,2710,7635,9268,10345,2710,22,22
3,1,1140,7560,1,0,0,4,6,1140,0,47.4624,-122.185,1300,7560,8700,8860,1140,61,61
3,1,1370,11658,1,0,0,4,6,1370,0,47.4576,-122.182,1080,9198,13028,10278,1370,61,61
4,2.5,2840,4750,2,0,0,3,9,2840,0,47.4511,-122.121,2460,4750,7590,7210,2840,17,17
4,2.5,2770,4432,2,0,0,3,9,2770,0,47.4541,-122.117,2770,5423,7202,8193,2770,15,15
3,1.75,1840,10723,1,0,0,4,7,1220,620,47.429,-122.154,1590,9820,12563,11410,1840,45,45
3,2.25,2760,10160,1,0,0,3,8,2760,0,47.4504,-122.15,2760,9600,12920,12360,2760,50,50
4,2.5,2430,6796,2,0,0,3,8,2430,0,47.4499,-122.127,2450,8400,9226,10850,2430,26,26
3,2.5,2640,6715,2,0,0,3,8,1680,960,47.441,-122.125,2260,7373,9355,9633,2640,28,28
4,2.5,2080,7000,1,0,0,4,8,1400,680,47.4252,-122.163,2090,7082,9080,9172,2080,30,30
4,2.25,1950,7700,1,0,0,3,8,1350,600,47.4441,-122.125,2150,7350,9650,9500,1950,40,40
3,1,1010,7690,1,0,0,4,6,1010,0,47.4501,-122.176,1010,7619,8700,8629,1010,61,61
4,1.75,1990,7194,1,0,0,4,8,1400,590,47.4417,-122.135,1820,7400,9184,9220,1990,41,41
3,1.75,1500,10230,1,0,0,2,7,1500,0,47.4349,-122.168,1770,8374,11730,10144,1500,51,51
5,3,2660,7700,1,0,0,4,7,1670,990,47.46,-122.174,1610,7700,10360,9310,2660,57,57
3,1,1180,13650,1,0,0,4,7,1180,0,47.4551,-122.154,1460,11730,14830,13190,1180,52,52
4,2.5,2070,2992,2,0,0,3,8,2070,0,47.4496,-122.12,1900,2957,5062,4857,2070,17,17
3,1.75,1210,7000,1,0,0,3,7,1210,0,47.4572,-122.169,1670,7000,8210,8670,1210,44,44
5,2.5,2250,10400,1,0,0,3,8,1280,970,47.4501,-122.139,2140,9592,12650,11732,2250,46,46
4,2.25,2330,11400,1,0,0,4,8,2330,0,47.4495,-122.148,2640,10200,13730,12840,2330,45,45
4,2.25,1860,7980,1,0,0,4,8,1860,0,47.4524,-122.15,1860,8814,9840,10674,1860,53,53
3,1,1150,7560,1,0,0,4,6,1150,0,47.4613,-122.184,1230,7560,8710,8790,1150,61,61
3,1.75,2050,9045,2,0,0,4,6,2050,0,47.4572,-122.18,1200,9045,11095,10245,2050,60,60
5,1.5,1930,7480,2,0,0,3,7,1930,0,47.4503,-122.157,1480,7705,9410,9185,1930,53,53
3,2.25,2090,10120,1,0,0,4,7,1290,800,47.4654,-122.174,1820,7983,12210,9803,2090,40,40
4,2.5,3150,5757,2,0,0,3,9,3150,0,47.4568,-122.117,3100,5757,8907,8857,3150,15,15
3,2.25,1590,9425,1,0,0,3,7,1170,420,47.4291,-122.16,1590,9394,11015,10984,1590,34,34
4,2.75,2110,13260,1,0,0,4,7,1290,820,47.4513,-122.16,1980,11016,15370,12996,2110,40,40
5,2.5,3810,15916,1,0,0,5,8,3810,0,47.4521,-122.14,2470,11662,19726,14132,3810,52,52
4,2.5,2130,10375,2,0,0,4,8,2130,0,47.4381,-122.16,2220,8508,12505,10728,2130,33,33
4,2.5,2050,9015,2,0,0,4,7,2050,0,47.4357,-122.168,1780,8820,11065,10600,2050,46,46
4,2.25,1930,8925,1,0,0,4,8,1930,0,47.4501,-122.128,1930,8400,10855,10330,1930,45,45
3,1.75,1800,10200,1,0,0,3,8,1800,0,47.4496,-122.146,2140,10128,12000,12268,1800,52,52
4,3,2570,262018,1,0,0,3,7,1420,1150,47.4417,-122.09,2260,19811,264588,22071,2570,31,31
3,1,1590,8470,1,0,0,4,7,1140,450,47.4473,-122.159,1570,9375,10060,10945,1590,52,52
4,1.5,1730,10396,1,0,0,3,7,1730,0,47.4497,-122.168,1510,10396,12126,11906,1730,55,55
3,1.75,2270,13000,1,0,0,5,8,2270,0,47.4474,-122.144,2440,10000,15270,12440,2270,51,51
4,2.25,2300,9100,1,0,0,3,7,1280,1020,47.4576,-122.16,1640,9100,11400,10740,2300,42,42
3,1,1240,14110,1,0,0,4,7,1240,0,47.4579,-122.09,2060,19350,15350,21410,1240,47,47
4,2.25,1790,13200,1,0,0,3,7,1220,570,47.4672,-122.185,1740,8950,14990,10690,1790,40,40
4,2.5,2280,9899,2,0,0,3,8,2280,0,47.461,-122.148,1970,9451,12179,11421,2280,32,32
3,1,1210,33919,1,0,0,3,7,1210,0,47.4375,-122.184,1640,14910,35129,16550,1210,65,65
4,1.75,1530,8750,1,0,0,4,7,1530,0,47.4556,-122.157,1390,8750,10280,10140,1530,51,51
4,2.5,3360,7685,2,0,0,3,9,3360,0,47.4369,-122.111,3060,6567,11045,9627,3360,18,18
4,2.75,2290,7000,2,0,0,3,8,2290,0,47.4442,-122.129,2000,7200,9290,9200,2290,42,42
3,2.25,2470,10290,2,0,0,3,8,2230,240,47.4459,-122.124,1970,10150,12760,12120,2470,35,35
2,1,1070,20450,1,0,0,2,6,1070,0,47.4338,-122.183,1360,15581,21520,16941,1070,71,71
3,1.75,2410,8944,1,0,0,4,8,1860,550,47.4494,-122.139,2750,9600,11354,12350,2410,52,52
5,3.25,4410,58157,2,0,0,4,9,2330,2080,47.4395,-122.111,2460,42565,62567,45025,4410,18,18
4,2.75,2540,7210,1,0,0,4,7,1600,940,47.4601,-122.165,1820,7766,9750,9586,2540,40,40
3,2.5,2760,35171,2,0,0,3,9,2760,0,47.465,-122.123,2720,35171,37931,37891,2760,29,29
4,2.75,2640,35070,1,0,0,3,8,2640,0,47.4242,-122.181,2520,34986,37710,37506,2640,56,56
3,1.5,1240,9125,1,0,0,4,7,1240,0,47.4469,-122.155,1670,9125,10365,10795,1240,52,52
4,2.5,2570,7753,2,0,0,3,8,2570,0,47.4237,-122.162,2140,7615,10323,9755,2570,32,32
4,2.5,2290,11173,2,0,0,4,8,2290,0,47.4314,-122.164,2290,10404,13463,12694,2290,31,31
4,2.5,1780,15000,2,0,0,2,7,1780,0,47.4239,-122.153,2005,9680,16780,11685,1780,26,26
4,1.75,1760,7268,1,0,0,4,7,1080,680,47.4267,-122.148,1830,8786,9028,10616,1760,40,40
5,2.5,2950,72309,2,0,0,3,8,2950,0,47.4186,-122.079,1480,56192,75259,57672,2950,13,13
4,2,1780,19843,1,0,0,3,7,1780,0,47.4414,-122.154,2210,13500,21623,15710,1780,56,56
3,1.5,1440,7875,1,0,0,4,8,1440,0,47.4561,-122.148,1800,8964,9315,10764,1440,51,51
3,1,1250,8314,1,0,0,3,6,1250,0,47.4522,-122.178,1188,7700,9564,8888,1250,61,61
3,2.5,2170,11745,1,0,0,4,7,1410,760,47.4342,-122.17,1860,8643,13915,10503,2170,52,52
3,1,960,27442,1,0,0,4,6,960,0,47.4676,-122.134,1100,29019,28402,30119,960,49,49
3,1.75,1435,8960,1,0,0,4,8,1435,0,47.4525,-122.149,2030,9450,10395,11480,1435,50,50
3,2,1860,12944,1,0,0,3,9,1860,0,47.4298,-122.102,2500,29279,14804,31779,1860,17,17
4,1.75,1660,8160,1,0,0,3,8,1660,0,47.4483,-122.129,1800,7684,9820,9484,1660,45,45
3,2.5,2020,4861,2,0,0,3,7,2020,0,47.4659,-122.144,2170,4600,6881,6770,2020,14,14
3,1,1010,7690,1,0,0,4,6,1010,0,47.4501,-122.176,1010,7619,8700,8629,1010,61,61
3,2,1400,7384,1,0,0,3,7,1150,250,47.4655,-122.174,1820,7992,8784,9812,1400,40,40
3,1,990,8012,1,0,0,4,7,990,0,47.4557,-122.181,1260,9060,9002,10320,990,53,53
4,1.75,2330,8364,1,0,0,4,8,2330,0,47.4568,-122.146,2180,9630,10694,11810,2330,51,51
3,2.5,1490,8005,1,0,0,3,7,1090,400,47.4359,-122.165,1880,7905,9495,9785,1490,43,43
4,2.5,1870,5692,2,0,0,3,7,1870,0,47.4334,-122.148,2390,5293,7562,7683,1870,15,15
2,1,1080,9435,1,0,0,3,6,1080,0,47.459,-122.181,1200,9210,10515,10410,1080,61,61
3,2.25,1850,7480,2,0,0,3,7,1850,0,47.452,-122.159,1870,7480,9330,9350,1850,41,41
3,2,1400,7384,1,0,0,3,7,1150,250,47.4655,-122.174,1820,7992,8784,9812,1400,40,40
5,2.75,3630,30570,2,0,0,3,11,3630,0,47.4243,-122.097,3620,41965,34200,45585,3630,19,19
3,1.5,1650,9380,1,0,0,5,7,1130,520,47.4525,-122.162,1720,8856,11030,10576,1650,41,41
4,2.5,2680,11590,2,0,0,4,9,2680,0,47.4395,-122.163,2580,8225,14270,10805,2680,31,31
3,1.75,1630,7480,1,0,0,3,7,1330,300,47.4514,-122.159,1940,7480,9110,9420,1630,40,40
3,3,2500,6000,2,0,0,3,8,2500,0,47.4408,-122.161,2130,6000,8500,8130,2500,7,7
3,2.5,2480,8342,2,0,0,3,8,2480,0,47.4381,-122.134,2300,8303,10822,10603,2480,33,33
3,1.75,1870,8400,1,0,0,3,7,990,880,47.454,-122.164,1750,8400,10270,10150,1870,42,42
3,2,1560,8853,1,0,0,3,7,1560,0,47.4312,-122.171,1610,8750,10413,10360,1560,52,52
5,3,2790,19439,1,0,3,5,7,1500,1290,47.4088,-122.089,1620,19439,22229,21059,2790,46,46
3,1.75,1810,21138,1,0,0,4,7,1240,570,47.4674,-122.178,1850,12200,22948,14050,1810,42,42
1,1,680,21727,1,0,0,3,5,680,0,47.446,-122.175,1470,19406,22407,20876,680,67,20
4,2.5,1940,3200,2,0,0,3,8,1940,0,47.4583,-122.118,1900,3200,5140,5100,1940,15,15
3,1.75,2340,7724,1,0,0,3,10,2340,0,47.4593,-122.134,3040,5787,10064,8827,2340,9,9
4,2.25,2320,7350,2,0,0,3,8,2320,0,47.4512,-122.131,2170,7350,9670,9520,2320,46,46
3,1.5,1500,10018,1,0,0,4,7,1500,0,47.468,-122.163,1500,10937,11518,12437,1500,62,62
3,1.75,1230,8250,1,0,0,3,7,1230,0,47.4526,-122.176,1250,8250,9480,9500,1230,53,53
4,1,1500,11050,1,0,0,5,7,1500,0,47.4509,-122.088,1970,20800,12550,22770,1500,55,55
4,2.5,2720,7697,1,0,0,4,8,2120,600,47.4391,-122.161,2340,7700,10417,10040,2720,32,32
3,1.75,1360,6603,1,0,0,4,7,1360,0,47.4619,-122.168,1770,7107,7963,8877,1360,38,38
2,1,1060,16988,1,0,0,3,6,1060,0,47.4305,-122.157,2320,10580,18048,12900,1060,65,65
3,1.75,1220,7004,1,0,0,5,7,1220,0,47.4492,-122.157,1640,7210,8224,8850,1220,53,53
4,1.75,1920,7665,1,0,0,4,8,1500,420,47.4476,-122.128,2100,7344,9585,9444,1920,44,44
5,2.75,3190,5857,2,0,0,3,9,3190,0,47.4575,-122.119,3100,5857,9047,8957,3190,15,15
3,1.75,1600,313672,1,0,0,4,7,1600,0,47.4129,-122.08,1780,90860,315272,92640,1600,59,59
3,1,1020,7615,1,0,0,3,7,1020,0,47.4292,-122.152,1470,9515,8635,10985,1020,38,38
5,3,2240,19090,1,0,0,4,8,1700,540,47.4416,-122.149,2280,20000,21330,22280,2240,51,51
5,1.5,1980,7958,1,0,0,3,7,1980,0,47.4571,-122.17,1510,8438,9938,9948,1980,57,57
4,2.5,2070,3808,2,0,0,3,8,2070,0,47.4498,-122.12,1900,2992,5878,4892,2070,16,16
4,2.5,2700,6515,2,0,0,3,9,2700,0,47.4356,-122.11,2900,6710,9215,9610,2700,21,21
3,1.75,1970,9512,1,0,0,3,8,1970,0,47.4545,-122.146,2250,10573,11482,12823,1970,51,51
4,2.5,3740,8700,1,0,0,3,10,2260,1480,47.4587,-122.117,2650,6333,12440,8983,3740,15,15
3,2,1790,8228,1,0,0,3,7,1390,400,47.4658,-122.172,1880,8228,10018,10108,1790,39,39
3,1.75,2320,7875,1,0,0,3,8,1620,700,47.4524,-122.146,1990,9720,10195,11710,2320,52,52
3,2.5,2450,28185,2,0,0,3,9,2450,0,47.4665,-122.122,2440,33541,30635,35981,2450,29,29
3,2,1500,7828,1,0,0,4,7,1500,0,47.4484,-122.158,1500,7700,9328,9200,1500,52,52
4,2.75,2400,20000,1,0,0,3,8,1170,1230,47.4556,-122.087,1690,20000,22400,21690,2400,58,0
4,2.5,1750,8476,1,0,0,4,7,1240,510,47.4447,-122.137,1660,7875,10226,9535,1750,36,36
3,2,1840,8580,1,0,0,3,8,1840,0,47.4626,-122.132,2190,8580,10420,10770,1840,29,29
3,1.75,1330,7848,1,0,0,3,8,1330,0,47.4463,-122.127,2110,8497,9178,10607,1330,41,41
5,2.5,2390,8775,1,0,0,4,7,1270,1120,47.4639,-122.17,1800,8000,11165,9800,2390,39,39
3,2.5,2150,8361,2,0,0,3,8,2150,0,47.4627,-122.129,2150,9368,10511,11518,2150,28,28
5,2.75,2540,27007,1,0,0,3,8,1520,1020,47.4326,-122.155,1800,26572,29547,28372,2540,39,0
3,2.25,1610,6655,2,0,0,4,7,1610,0,47.4296,-122.161,1780,7529,8265,9309,1610,34,34
3,1,1160,7560,1,0,0,4,6,1160,0,47.45,-122.179,1160,7560,8720,8720,1160,61,61
4,2.25,1740,9613,2,0,0,5,8,1740,0,47.463,-122.125,1680,9769,11353,11449,1740,30,30
4,2.25,1760,9602,2,0,0,3,7,1760,0,47.4248,-122.158,1860,9656,11362,11516,1760,32,32
3,2,2260,7163,1,0,0,3,9,2260,0,47.4593,-122.136,2340,6730,9423,9070,2260,7,7
4,3.25,3770,982998,2,0,0,3,10,3770,0,47.414,-122.087,2290,37141,986768,39431,3770,27,27
5,3.75,3090,4943,2,0,0,3,10,3090,0,47.4594,-122.133,3191,5561,8033,8752,3090,9,9
5,2.5,2020,8250,1,0,0,4,8,1430,590,47.4432,-122.135,1680,8959,10270,10639,2020,41,41
3,2,1390,7200,1,0,0,3,7,1390,0,47.434,-122.154,1630,7340,8590,8970,1390,23,23
3,1.75,1980,11274,1,0,0,4,7,1480,500,47.4474,-122.167,1520,8010,13254,9530,1980,51,51
3,1.75,2140,40098,1,0,0,5,8,1490,650,47.4296,-122.111,2220,35371,42238,37591,2140,69,69
4,2.75,2250,7412,1,0,0,4,8,1480,770,47.4449,-122.129,2070,7632,9662,9702,2250,44,44
5,2.5,1960,7350,1,0,0,4,7,1360,600,47.4368,-122.165,1900,7350,9310,9250,1960,50,50
3,1.5,1540,9800,1,0,0,3,7,1010,530,47.4676,-122.184,1600,8250,11340,9850,1540,46,46
3,2.25,1900,8125,1,0,0,3,7,1540,360,47.4564,-122.162,1480,8284,10025,9764,1900,50,50
3,1.75,1290,9760,1,0,0,3,7,1290,0,47.4265,-122.148,1410,8034,11050,9444,1290,40,40
3,2,1590,35988,1,0,0,4,8,1590,0,47.4365,-122.106,2780,23789,37578,26569,1590,45,45
2,2.5,3090,47044,1,0,0,4,10,2250,840,47.4291,-122.177,1860,62829,50134,64689,3090,40,40
4,2.25,2470,7698,2,0,0,3,8,2470,0,47.4406,-122.141,2330,7986,10168,10316,2470,36,36
4,1.75,2550,8976,1,0,0,5,7,1300,1250,47.4286,-122.179,2220,9477,11526,11697,2550,41,41
5,1.5,1730,9230,1,0,0,3,7,1010,720,47.4646,-122.184,1730,9230,10960,10960,1730,57,57
3,1,1170,7560,1,0,0,3,6,1170,0,47.4514,-122.178,1170,7560,8730,8730,1170,61,61
3,2.5,1770,3873,2,0,0,3,7,1770,0,47.4648,-122.144,2280,4330,5643,6610,1770,14,14
4,2.5,2620,9359,2,0,0,3,9,2620,0,47.438,-122.152,2580,7433,11979,10013,2620,32,32
5,3,3045,5030,2,0,0,3,8,3045,0,47.4386,-122.127,3045,5322,8075,8367,3045,20,20
4,3,2200,10800,1,0,0,3,6,2200,0,47.4476,-122.169,1430,10800,13000,12230,2200,59,59
3,1.75,1490,9493,1,0,0,4,8,1490,0,47.4514,-122.134,2440,9600,10983,12040,1490,43,43
3,2.5,2340,10005,1,0,0,4,8,1460,880,47.4431,-122.133,2250,8162,12345,10412,2340,41,41
4,2.5,1820,7575,1,0,0,3,7,1220,600,47.4339,-122.167,1840,7650,9395,9490,1820,44,44
3,1.5,1430,7560,1,0,0,5,6,1430,0,47.4518,-122.179,1150,7560,8990,8710,1430,61,61
4,2.5,4190,7504,2,0,0,3,7,4190,0,47.4394,-122.114,2480,6727,11694,9207,4190,15,15
3,2.25,2480,8755,2,0,0,3,8,2480,0,47.4543,-122.125,2280,9940,11235,12220,2480,40,40
3,1,1460,10914,1,0,0,4,7,1460,0,47.4511,-122.173,1490,8314,12374,9804,1460,60,60
4,2.75,2580,11900,1,0,0,4,7,1620,960,47.4475,-122.159,1570,9375,14480,10945,2580,52,52
3,1.75,1780,10409,1,0,0,3,7,1280,500,47.4627,-122.168,1780,7415,12189,9195,1780,38,38
2,1,790,7450,1,0,0,4,6,790,0,47.4743,-122.17,800,7450,8240,8250,790,75,75
3,2.5,2210,7000,2,0,0,4,8,2210,0,47.4377,-122.132,2260,7224,9210,9484,2210,34,34
4,2.5,2140,7350,2,0,0,3,8,2140,0,47.4483,-122.124,2120,8395,9490,10515,2140,34,34
4,2,1810,8750,1,0,0,2,7,1110,700,47.4307,-122.17,1810,8750,10560,10560,1810,52,52
3,2,1700,52826,1,0,0,3,7,1700,0,47.4164,-122.092,2480,114728,54526,117208,1700,28,28
3,2.25,2290,7350,2,0,0,3,8,2290,0,47.429,-122.162,2170,7529,9640,9699,2290,31,31
3,2.25,1630,12295,2,0,0,4,7,1630,0,47.4279,-122.161,1730,9948,13925,11678,1630,34,34
3,1,1580,7424,1,0,0,3,7,1010,570,47.4607,-122.171,1710,7772,9004,9482,1580,57,57
4,3,2580,6740,2,0,0,3,8,2580,0,47.4296,-122.185,2010,6740,9320,8750,2580,20,20
4,2.75,3080,6731,2,0,3,3,9,3080,0,47.4522,-122.118,3080,6731,9811,9811,3080,16,16
4,2.5,2460,5091,2,0,0,3,9,2460,0,47.45,-122.121,2490,4750,7551,7240,2460,16,16
6,2,2800,29985,1,0,0,5,7,1400,1400,47.4398,-122.08,1980,29985,32785,31965,2800,65,65
2,1,1150,12861,1,0,0,3,6,1150,0,47.4493,-122.171,1170,7574,14011,8744,1150,60,60
5,2.5,1720,10202,1,0,0,3,7,1720,0,47.4572,-122.167,1720,8478,11922,10198,1720,49,49
2,2,1770,7607,1,0,0,4,8,1770,0,47.4287,-122.163,2090,7109,9377,9199,1770,32,32
3,2.5,2080,7877,2,0,0,3,9,2080,0,47.4395,-122.151,2550,7660,9957,10210,2080,32,32
3,1.75,1230,8917,1,0,0,4,7,1230,0,47.4528,-122.172,1420,7938,10147,9358,1230,53,53
3,2.75,1720,28000,1,0,0,4,7,1720,0,47.4375,-122.176,2000,41817,29720,43817,1720,61,61
4,2,1440,7950,1,0,0,5,6,1440,0,47.4517,-122.082,1530,20037,9390,21567,1440,57,57
2,1.5,1280,8710,1,0,0,3,7,1280,0,47.4472,-122.16,1520,9375,9990,10895,1280,52,52
3,1.75,3440,10428,1,0,0,5,8,3440,0,47.449,-122.128,2160,8400,13868,10560,3440,45,45
4,2.25,2810,8560,1,0,0,3,8,1610,1200,47.4437,-122.124,2400,7600,11370,10000,2810,40,40
3,2,1240,10800,1,0,0,3,7,1240,0,47.449,-122.155,1480,8840,12040,10320,1240,52,4
5,2.5,2600,4641,2,0,0,3,7,2600,0,47.4325,-122.146,2330,4589,7241,6919,2600,14,14
5,2.25,2290,7420,1,0,0,3,7,1290,1000,47.4375,-122.166,1660,7526,9710,9186,2290,46,46
4,2.5,2500,11983,1,0,0,3,7,1320,1180,47.4292,-122.148,1460,9005,14483,10465,2500,35,7
4,2,1590,9100,1,0,0,3,7,1040,550,47.4465,-122.156,1670,9100,10690,10770,1590,52,0
3,1.75,1390,7700,1,0,0,5,7,1390,0,47.4559,-122.183,1260,7700,9090,8960,1390,54,54
3,1,1000,9170,1,0,0,3,7,1000,0,47.4405,-122.134,1610,9170,10170,10780,1000,39,39
2,1,910,9869,1,0,0,3,6,910,0,47.4572,-122.184,1480,9750,10779,11230,910,62,62
5,2.75,3630,38461,2,0,0,3,11,3630,0,47.4289,-122.094,4440,50378,42091,54818,3630,19,19
5,2.5,2600,3839,2,0,0,3,7,2600,0,47.4324,-122.145,2180,4800,6439,6980,2600,14,14
3,1,970,7503,1,0,0,4,6,970,0,47.4688,-122.163,1230,9504,8473,10734,970,52,52
4,3,2620,214750,2,0,0,3,8,2620,0,47.4239,-122.068,2060,212137,217370,214197,2620,27,27
3,2.5,2150,25705,1,0,0,3,6,2150,0,47.4514,-122.089,1850,20160,27855,22010,2150,39,6
4,1.75,1820,7381,1,0,0,5,7,1150,670,47.4567,-122.171,1610,8462,9201,10072,1820,57,57
3,2.75,3410,9360,1,0,0,4,8,3410,0,47.4497,-122.147,2260,10128,12770,12388,3410,52,52
3,1,1060,7900,1,0,0,3,7,1060,0,47.4604,-122.18,1310,7900,8960,9210,1060,58,14
4,1,1540,8400,1,0,0,3,7,770,770,47.4278,-122.152,1520,9891,9940,11411,1540,48,48
4,2.75,1970,7213,1,0,0,3,8,1170,800,47.4424,-122.126,1980,7045,9183,9025,1970,42,42
4,2.5,1940,3864,2,0,0,3,8,1940,0,47.4507,-122.12,1900,3864,5804,5764,1940,16,16
3,1,1390,21262,1,0,0,3,7,1390,0,47.4454,-122.185,1560,10800,22652,12360,1390,61,61
4,2.25,1920,9660,1,0,0,4,8,1920,0,47.4544,-122.143,1890,7800,11580,9690,1920,51,51
3,2,1970,79714,1,0,0,3,7,1070,900,47.4674,-122.107,1890,36626,81684,38516,1970,40,40
4,3.5,4300,70407,2,0,0,3,10,2710,1590,47.4472,-122.092,3520,26727,74707,30247,4300,27,27
4,3,3120,157875,2,0,0,4,8,3120,0,47.444,-122.187,1580,7050,160995,8630,3120,42,42
4,2.5,2460,5440,2,0,0,3,9,2460,0,47.448,-122.121,2460,5124,7900,7584,2460,16,16
4,2,1530,6375,2,0,0,3,7,1530,0,47.4692,-122.162,1500,8712,7905,10212,1530,77,31
3,2,1810,10684,2,0,0,3,8,1810,0,47.4619,-122.153,2140,9657,12494,11797,1810,32,32
4,1.75,1360,7700,1,0,0,4,7,1360,0,47.4558,-122.177,1321,7756,9060,9077,1360,53,53
3,1.75,1590,7280,1,0,0,3,7,1140,450,47.4288,-122.153,1590,9634,8870,11224,1590,45,45
4,2.5,2690,7947,2,0,0,3,8,2690,0,47.4248,-122.153,2160,8328,10637,10488,2690,26,26
4,3.5,3450,6873,2,0,0,3,10,2750,700,47.459,-122.118,3450,6873,10323,10323,3450,15,15
3,2,1410,7466,1,0,0,3,7,1410,0,47.427,-122.147,1410,7610,8876,9020,1410,36,36
3,2.25,1530,7906,1,0,0,3,7,1150,380,47.4418,-122.136,1460,7875,9436,9335,1530,39,39
3,2.25,1400,10436,1,0,0,4,7,1040,360,47.4261,-122.144,1860,9318,11836,11178,1400,34,34
4,2.5,2400,11640,1,0,0,5,8,1800,600,47.4485,-122.139,2440,10823,14040,13263,2400,51,51
6,1.75,2540,8400,1,0,0,3,8,1340,1200,47.4414,-122.129,1900,7695,10940,9595,2540,42,42
4,2.5,2880,7386,2,0,0,4,9,2880,0,47.4397,-122.15,2420,7663,10266,10083,2880,32,32
4,2.5,2990,8913,2,0,0,4,9,2990,0,47.4353,-122.159,2740,8030,11903,10770,2990,28,28
3,2,1410,7622,1,0,0,4,7,1410,0,47.4273,-122.147,1830,8330,9032,10160,1410,36,36
3,2.5,2740,22499,2,0,0,3,9,2740,0,47.4597,-122.153,2710,22499,25239,25209,2740,25,25
4,2.5,2690,9551,2,0,0,3,9,2690,0,47.4343,-122.156,2890,9121,12241,12011,2690,27,27
4,2.5,2090,5289,2,0,0,3,8,2090,0,47.4289,-122.164,2080,7109,7379,9189,2090,30,30
3,2.5,2130,8404,2,0,0,3,8,2130,0,47.4623,-122.13,2130,8404,10534,10534,2130,28,28
4,2.5,3670,9958,2,0,0,3,10,3670,0,47.4617,-122.159,3300,10679,13628,13979,3670,14,14
3,2,1940,40588,1,0,0,3,7,1940,0,47.4252,-122.159,1860,9657,42528,11517,1940,19,19
4,3.25,2360,8344,2,0,0,3,8,2360,0,47.4403,-122.126,1860,8410,10704,10270,2360,29,29
6,2.5,3060,17112,1,0,0,4,8,1530,1530,47.4379,-122.146,2690,16038,20172,18728,3060,52,52
3,2.5,2910,12283,2,0,2,3,10,2910,0,47.4602,-122.152,2680,22499,15193,25179,2910,26,26
3,1.75,1740,7682,1,0,0,3,8,1330,410,47.4451,-122.126,2010,8820,9422,10830,1740,41,41
4,1.75,2110,7208,1,0,0,3,8,1170,940,47.4464,-122.129,1820,7208,9318,9028,2110,44,44
4,3,3110,18843,2,0,0,3,9,3110,0,47.4619,-122.154,3080,14735,21953,17815,3110,24,24
3,2.25,1820,7420,2,0,0,4,8,1820,0,47.4368,-122.162,1900,7526,9240,9426,1820,36,36
4,5.5,6550,217374,1,0,0,3,11,5400,1150,47.4302,-122.095,4110,50378,223924,54488,6550,13,13
4,2.5,3190,9856,2,0,0,3,8,3190,0,47.4445,-122.126,2260,7996,13046,10256,3190,40,40
3,2,1480,6698,1,0,0,4,7,1080,400,47.4614,-122.168,1850,7348,8178,9198,1480,40,40
4,2.5,2600,8921,2,0,0,3,8,2600,0,47.4423,-122.178,2550,8683,11521,11233,2600,28,28
3,2,1650,7352,1,0,0,3,7,1160,490,47.4612,-122.169,1710,7350,9002,9060,1650,40,40
3,1,1180,7200,1,0,0,4,7,1180,0,47.4249,-122.178,1180,7200,8380,8380,1180,51,51
4,2,1780,7350,1,0,0,5,7,900,880,47.4562,-122.158,1480,7350,9130,8830,1780,45,45
3,2,1230,3405,1,0,0,3,7,1230,0,47.438,-122.179,1440,4066,4635,5506,1230,9,9
3,2.5,1870,3584,2,0,0,3,8,1870,0,47.4521,-122.121,1900,3920,5454,5820,1870,16,16
4,2.75,2300,18360,1,0,0,4,7,1560,740,47.4518,-122.16,1870,9588,20660,11458,2300,40,40
4,2,1960,50112,1,0,0,4,7,1050,910,47.4353,-122.084,2340,44967,52072,47307,1960,56,56
3,2.5,1850,7875,1,0,0,3,7,1250,600,47.434,-122.171,1930,8062,9725,9992,1850,51,51
4,2.5,1870,8190,1,0,0,3,7,1100,770,47.4521,-122.161,1590,9150,10060,10740,1870,42,42
4,1.75,1530,17664,1,0,0,3,7,1530,0,47.4549,-122.155,1530,11625,19194,13155,1530,51,51
4,1,1730,8706,1,0,0,4,7,1010,720,47.4586,-122.175,1369,8418,10436,9787,1730,57,57
4,2.5,2154,4153,2,0,0,3,9,2154,0,47.4557,-122.13,2154,4091,6307,6245,2154,7,7
3,2,1570,5600,1,0,0,3,8,1570,0,47.4286,-122.185,2010,5600,7170,7610,1570,20,20
4,2.5,2130,4750,2,0,0,3,8,2130,0,47.4324,-122.184,2130,4071,6880,6201,2130,10,10
4,2.5,2030,4499,2,0,0,3,8,2030,0,47.4511,-122.119,2030,4539,6529,6569,2030,16,16
5,4,7320,217800,2,0,0,3,11,7320,0,47.4473,-122.086,3270,34500,225120,37770,7320,27,27
3,2.5,2740,7923,2,0,0,3,9,2740,0,47.4349,-122.105,2740,8815,10663,11555,2740,21,21
4,2.5,2440,7155,2,0,0,3,8,2440,0,47.4501,-122.126,2450,8109,9595,10559,2440,26,26
3,2.5,1900,5194,2,0,0,3,7,1900,0,47.4391,-122.117,2230,5194,7094,7424,1900,15,15
3,1,1410,81021,1,0,0,3,7,1410,0,47.4303,-122.067,2000,81021,82431,83021,1410,70,33
2,1,800,17965,1,0,0,4,5,800,0,47.4693,-122.161,1500,8925,18765,10425,800,77,77
3,1.75,1680,9769,1,0,0,3,8,1340,340,47.4631,-122.126,1730,9686,11449,11416,1680,30,30
4,1.75,1450,10074,1,0,0,4,7,1450,0,47.4546,-122.182,1340,8023,11524,9363,1450,53,53
3,2.5,3110,9015,2,0,0,3,9,3110,0,47.4369,-122.147,2650,8960,12125,11610,3110,29,29
3,2.5,2400,99752,1,0,0,3,9,2400,0,47.3917,-122.084,2800,98010,102152,100810,2400,23,23
3,2.75,1440,7350,1,0,0,4,7,1040,400,47.4431,-122.138,1510,7350,8790,8860,1440,39,39
4,2,1560,7569,1,0,0,4,7,1560,0,47.4496,-122.155,1480,8755,9129,10235,1560,53,53
4,2.25,2780,15075,2,0,0,3,7,2780,0,47.477,-122.116,1650,25542,17855,27192,2780,34,34
5,2.75,2670,4780,2,0,0,3,8,2670,0,47.4866,-122.155,2560,5380,7450,7940,2670,6,6
4,3.5,2660,5690,2,0,0,3,8,1920,740,47.4775,-122.122,2970,5690,8350,8660,2660,5,5
3,2.5,2170,8169,2,0,0,3,8,2170,0,47.4833,-122.139,2240,6733,10339,8973,2170,16,16
4,1.75,2010,12188,1,0,0,4,7,1150,860,47.5013,-122.147,1720,8475,14198,10195,2010,59,59
4,2.75,4250,10925,2,0,0,3,10,4250,0,47.5297,-122.14,4650,11544,15175,16194,4250,16,16
3,1.75,1480,7725,1,0,0,4,7,1480,0,47.483,-122.163,1720,8379,9205,10099,1480,38,38
3,1.75,1470,7650,1,0,0,3,7,1130,340,47.4818,-122.161,1590,7500,9120,9090,1470,36,36
5,2.75,2990,6370,2,0,0,3,8,2990,0,47.4853,-122.154,2730,5740,9360,8470,2990,5,5
4,2.5,3150,5886,2,0,0,3,8,3150,0,47.4787,-122.122,2650,5886,9036,8536,3150,5,5
4,3.25,4130,11444,2,0,0,3,11,4130,0,47.5208,-122.15,3720,11431,15574,15151,4130,18,18
4,3.25,2730,54014,1,0,0,3,9,1560,1170,47.5133,-122.11,2730,111274,56744,114004,2730,12,12
4,4,4390,17832,1,0,0,4,11,2430,1960,47.5283,-122.143,3090,12369,22222,15459,4390,25,25
4,1.75,1990,23200,1,0,0,4,7,1990,0,47.486,-122.129,1950,17040,25190,18990,1990,43,43
3,1.75,1880,8424,1,0,0,4,7,1380,500,47.5116,-122.161,1970,8523,10304,10493,1880,42,42
3,1,1190,27215,1,0,0,5,7,1190,0,47.4978,-122.115,1450,56628,28405,58078,1190,76,25
3,2,1860,217800,2,0,2,3,8,1860,0,47.5157,-122.107,2500,217800,219660,220300,1860,21,21
5,3.5,3240,6919,2,0,0,3,8,2760,480,47.4779,-122.122,2970,5690,10159,8660,3240,5,5
4,2.5,2430,3249,2,0,0,3,8,2430,0,47.5048,-122.155,2650,3844,5679,6494,2430,9,9
3,2.75,3080,7282,2,0,0,3,9,3080,0,47.4826,-122.149,3080,7274,10362,10354,3080,11,11
4,2.75,2450,14803,2,0,0,4,9,2450,0,47.5261,-122.162,2330,14803,17253,17133,2450,31,31
3,2.5,2600,7210,2,0,0,3,8,2600,0,47.5123,-122.151,2350,7225,9810,9575,2600,30,30
5,1.75,1730,10368,1,0,0,5,7,1010,720,47.5008,-122.162,1730,7728,12098,9458,1730,56,56
4,2.75,3260,4900,2,0,0,3,9,3260,0,47.4812,-122.123,3260,6132,8160,9392,3260,6,6
4,3.5,2970,6587,2,0,0,3,8,2260,710,47.4776,-122.122,2970,5690,9557,8660,2970,5,5
4,2.75,2700,7992,2,0,0,3,9,2700,0,47.4831,-122.135,2840,7992,10692,10832,2700,7,7
4,5.25,6110,10369,2,0,0,3,11,6110,0,47.5285,-122.135,4190,10762,16479,14952,6110,14,14
5,4.5,3100,7260,2,0,0,3,8,3100,0,47.5004,-122.162,1650,7700,10360,9350,3100,56,15
4,2.25,2190,3850,2,0,0,3,7,2190,0,47.4861,-122.161,2190,3980,6040,6170,2190,13,13
3,1.75,1400,10350,1,0,0,4,7,1400,0,47.479,-122.132,1780,10457,11750,12237,1400,43,43
4,2.5,2220,4652,2,0,0,3,7,2220,0,47.4902,-122.154,1840,4500,6872,6340,2220,18,18
4,2.5,2480,15411,2,0,2,3,8,2480,0,47.5379,-122.16,2940,14679,17891,17619,2480,25,25
4,1.5,1300,10050,1,0,0,3,7,1300,0,47.4899,-122.116,1730,10050,11350,11780,1300,56,56
4,2.5,3140,8455,2,0,0,3,8,3140,0,47.4866,-122.147,3140,7391,11595,10531,3140,16,16
4,2.5,2550,5200,2,0,0,3,7,2550,0,47.4919,-122.153,2550,4660,7750,7210,2550,10,10
4,3,4160,13170,2,0,0,3,11,3040,1120,47.5182,-122.149,3780,13148,17330,16928,4160,18,18
4,2.25,2190,3850,2,0,0,3,7,2190,0,47.4854,-122.16,1900,3850,6040,5750,2190,13,13
3,1.75,1360,13320,1,0,0,4,7,1360,0,47.4625,-122.069,1580,13625,14680,15205,1360,34,34
4,2.75,2170,5024,2,0,0,3,8,2170,0,47.495,-122.145,2460,5024,7194,7484,2170,7,7
4,2.5,2660,5539,2,0,0,3,8,2660,0,47.4981,-122.162,2380,5539,8199,7919,2660,15,15
4,2.5,2600,7787,2,0,0,3,8,2600,0,47.4877,-122.139,2830,7787,10387,10617,2600,14,14
3,2.5,2790,19485,2,0,0,3,9,2790,0,47.4688,-122.124,2580,17859,22275,20439,2790,29,29
4,2.5,2400,7693,2,0,0,3,8,2400,0,47.4881,-122.142,2400,8038,10093,10438,2400,16,16
4,2.5,1580,7800,1,0,0,4,7,1580,0,47.481,-122.163,1320,7800,9380,9120,1580,60,60
5,2.5,3070,34991,2,0,0,3,9,3070,0,47.4721,-122.148,2150,19515,38061,21665,3070,24,24
4,3.75,4130,12320,2,0,0,3,11,4130,0,47.5194,-122.151,3690,11227,16450,14917,4130,18,18
4,2.5,2320,4524,2,0,0,3,8,2320,0,47.4798,-122.136,2330,4524,6844,6854,2320,15,15
4,2.5,2110,9825,2,0,0,3,8,2110,0,47.4979,-122.153,1650,9900,11935,11550,2110,19,19
4,2.5,2250,7526,2,0,0,3,8,2250,0,47.5123,-122.15,1980,7526,9776,9506,2250,30,30
4,2.5,2650,6875,2,0,0,3,8,2650,0,47.479,-122.124,2650,5831,9525,8481,2650,5,5
4,2,1910,10200,1,0,0,4,7,1910,0,47.4804,-122.133,1820,15600,12110,17420,1910,56,56
4,1.75,1820,14319,1,0,0,4,7,1820,0,47.4757,-122.148,1440,10018,16139,11458,1820,50,50
3,2.5,1960,1477,2,0,0,3,7,1670,290,47.4873,-122.166,1980,1467,3437,3447,1960,7,7
3,3.25,4720,32467,2,0,2,3,10,3190,1530,47.508,-122.113,3260,26386,37187,29646,4720,21,21
3,2.5,3490,12410,2,0,0,3,8,2590,900,47.4714,-122.071,1740,14448,15900,16188,3490,10,10
5,3.25,3500,10457,2,0,0,3,11,3500,0,47.5198,-122.157,3500,11734,13957,15234,3500,18,18
5,2.75,2930,10148,2,0,0,3,9,2930,0,47.4887,-122.145,2930,8425,13078,11355,2930,17,17
4,2.5,2950,4502,2,0,0,3,7,2950,0,47.5002,-122.151,2360,4502,7452,6862,2950,14,14
3,1,1140,8400,1,0,0,4,7,1140,0,47.5022,-122.144,1400,9000,9540,10400,1140,59,59
3,2,2160,105415,1,0,0,3,10,2160,0,47.4806,-122.152,2760,9620,107575,12380,2160,28,28
4,1.75,1750,18810,1,0,0,3,7,1220,530,47.4719,-122.074,1840,17424,20560,19264,1750,42,42
4,1.75,1720,9600,1,0,0,4,8,1720,0,47.4764,-122.155,1660,10720,11320,12380,1720,50,50
4,1.75,1710,10480,1,0,0,4,6,1710,0,47.4743,-122.143,1750,10480,12190,12230,1710,50,50
3,1.5,2390,23522,1,0,0,2,7,1890,500,47.4754,-122.09,2430,23958,25912,26388,2390,81,47
4,1.5,1780,7914,1,0,0,4,7,1780,0,47.5142,-122.163,1350,8069,9694,9419,1780,57,57
4,2.5,2320,4254,2,0,0,3,8,2320,0,47.48,-122.137,2330,4602,6574,6932,2320,15,15
5,2.5,2300,23345,1,0,0,5,7,1170,1130,47.4739,-122.114,2280,23345,25645,25625,2300,52,52
4,2.5,2150,9000,1,0,0,4,7,1360,790,47.4785,-122.16,1620,8400,11150,10020,2150,40,40
3,2.5,3070,22098,2,0,0,3,9,3070,0,47.4724,-122.147,3070,21803,25168,24873,3070,24,24
8,3.25,4300,10441,2,0,0,4,8,2800,1500,47.4786,-122.131,1780,10457,14741,12237,4300,40,40
3,1,1250,23680,1,0,0,5,7,1250,0,47.475,-122.11,1450,23680,24930,25130,1250,52,52
3,2.5,2540,5612,2,0,0,3,9,2540,0,47.4965,-122.157,2380,6303,8152,8683,2540,20,20
4,3.25,4020,11588,2,0,0,3,11,4020,0,47.5217,-122.155,3190,8066,15608,11256,4020,19,19
3,1.75,2430,9133,1,0,0,4,7,1410,1020,47.5116,-122.157,1980,9592,11563,11572,2430,41,41
3,2.5,2250,3757,2,0,0,3,7,2250,0,47.4787,-122.129,2250,4556,6007,6806,2250,13,13
4,2.25,2100,12738,2,0,0,4,8,2100,0,47.4698,-122.118,2000,12090,14838,14090,2100,44,44
3,1,1250,10723,1,0,0,4,7,1250,0,47.4894,-122.135,1520,10723,11973,12243,1250,58,58
3,1.75,1520,9600,1,0,0,4,7,1520,0,47.473,-122.149,1590,10183,11120,11773,1520,52,52
3,2,1490,7697,1,0,0,3,7,1490,0,47.4852,-122.164,1540,7529,9187,9069,1490,25,25
5,2.5,2100,14858,1,0,0,5,8,2100,0,47.4721,-122.123,1980,11730,16958,13710,2100,49,49
4,2.5,2350,3760,2,0,0,3,8,2350,0,47.4786,-122.123,2590,4136,6110,6726,2350,5,5
4,2.5,2900,6736,2,0,0,3,8,2900,0,47.4954,-122.152,2900,6736,9636,9636,2900,6,6
3,2.5,2240,6000,2,0,0,3,8,2240,0,47.4837,-122.138,2400,6000,8240,8400,2240,16,16
3,2.5,1790,11542,1,0,0,5,7,1190,600,47.5124,-122.16,1790,9131,13332,10921,1790,50,50
4,2.75,2220,8450,1,0,0,4,7,1260,960,47.4804,-122.157,1580,8450,10670,10030,2220,36,36
5,2.5,2890,15891,2,0,0,3,9,2890,0,47.5286,-122.16,2590,10556,18781,13146,2890,29,29
4,2.5,2810,6296,2,0,0,3,9,2810,0,47.5019,-122.151,2850,6140,9106,8990,2810,6,6
5,2.5,3190,6178,2,0,0,3,8,3190,0,47.5104,-122.154,2480,7548,9368,10028,3190,16,16
4,1,1650,9750,1,0,0,4,7,1650,0,47.4991,-122.164,1650,10112,11400,11762,1650,55,55
3,3,2840,206910,2,0,0,3,10,2840,0,47.469,-122.063,2070,25067,209750,27137,2840,20,20
4,2.5,3250,5000,2,0,0,3,8,3250,0,47.4988,-122.148,3230,5507,8250,8737,3250,11,11
4,2.5,2220,5338,2,0,0,3,7,2220,0,47.4887,-122.15,2220,5338,7558,7558,2220,18,18
6,2,2210,9870,2,0,0,4,7,2210,0,47.4751,-122.145,1390,9912,12080,11302,2210,50,20
4,3.75,4040,14212,2,0,0,3,11,4040,0,47.5189,-122.147,3940,14212,18252,18152,4040,17,17
4,2.5,2660,22050,2,0,0,3,9,2660,0,47.4911,-122.125,3060,21111,24710,24171,2660,23,23
3,2.5,2420,9592,2,0,0,3,8,1780,640,47.5093,-122.153,2420,9145,12012,11565,2420,26,26
3,2.5,2050,11690,2,0,0,4,9,2050,0,47.5279,-122.161,2410,10172,13740,12582,2050,30,30
4,2.5,2080,2999,2,0,0,3,8,2080,0,47.4909,-122.157,1630,3148,5079,4778,2080,21,21
4,2.75,3340,5700,2,0,0,3,11,3340,0,47.5059,-122.146,3340,6940,9040,10280,3340,6,6
3,1,1250,7320,1,0,0,3,7,1250,0,47.5074,-122.163,1770,7320,8570,9090,1250,51,51
3,1,1720,16552,1,0,0,4,7,1720,0,47.4772,-122.153,1550,15457,18272,17007,1720,48,48
3,2.5,1960,3953,2,0,0,3,8,1960,0,47.4904,-122.158,1690,3593,5913,5283,1960,20,20
4,2.5,1790,6590,2,0,0,3,7,1790,0,47.4829,-122.128,1950,5180,8380,7130,1790,14,14
2,1,1210,17389,1,0,0,4,5,1210,0,47.5044,-122.148,2140,14419,18599,16559,1210,71,71
3,2.5,1230,23522,1,0,0,4,7,1230,0,47.515,-122.162,2340,23522,24752,25862,1230,41,41
5,3.25,4010,12110,2,0,0,3,11,4010,0,47.5228,-122.151,4010,12334,16120,16344,4010,16,16
4,2.5,1970,5190,2,0,0,3,7,1970,0,47.515,-122.164,1840,5564,7160,7404,1970,17,17
7,1.5,2660,15111,1,0,0,4,7,2660,0,47.4644,-122.066,1710,15429,17771,17139,2660,57,57
3,2.75,4120,16365,1,0,2,3,12,4120,0,47.5265,-122.148,4020,14110,20485,18130,4120,20,20
1,1.75,750,20339,1,0,0,4,4,550,200,47.4756,-122.09,2020,23958,21089,25978,750,73,73
3,1.75,1370,9288,1,0,0,4,7,1370,0,47.4824,-122.152,1500,9864,10658,11364,1370,31,31
3,1.75,1280,10716,1,0,0,4,7,1280,0,47.4755,-122.145,1440,9870,11996,11310,1280,50,50
5,2.75,2880,8364,2,0,0,3,9,2880,0,47.4893,-122.147,3010,8296,11244,11306,2880,13,13
4,2.5,2050,5276,2,0,0,3,7,2050,0,47.491,-122.15,2480,5447,7326,7927,2050,13,13
3,2.5,3010,7014,2,0,0,3,8,3010,0,47.4949,-122.149,3030,6180,10024,9210,3010,10,10
4,2.25,3330,21785,2,0,0,3,9,3330,0,47.4725,-122.136,3330,21796,25115,25126,3330,25,25
5,2.75,2670,3800,2,0,0,3,8,2670,0,47.4783,-122.123,2670,3800,6470,6470,2670,5,5
4,2.5,2730,4526,2,0,0,3,7,2730,0,47.491,-122.153,2190,4572,7256,6762,2730,10,10
4,2.75,3130,9711,2,0,0,3,9,3130,0,47.4823,-122.124,1570,10500,12841,12070,3130,5,5
3,1.5,1360,10726,1,0,0,4,7,1360,0,47.4948,-122.134,1650,10726,12086,12376,1360,53,53
2,1.75,1300,22239,1,0,0,4,7,1300,0,47.4801,-122.092,1300,14810,23539,16110,1300,74,29
3,1.5,1540,11858,1,0,0,4,7,1540,0,47.4755,-122.157,1550,11473,13398,13023,1540,53,53
4,3.25,4800,12727,2,0,0,3,10,4800,0,47.5311,-122.134,4750,13602,17527,18352,4800,8,8
2,1,1070,32633,1,0,0,4,6,1070,0,47.4716,-122.078,1360,32156,33703,33516,1070,89,89
3,2.5,2100,17882,2,0,0,4,8,2100,0,47.4754,-122.119,2080,16686,19982,18766,2100,34,34
4,2.5,2630,5379,2,0,0,3,8,2630,0,47.4977,-122.163,2630,5379,8009,8009,2630,15,15
3,2,1880,10758,1,0,0,5,6,940,940,47.5091,-122.144,2060,21000,12638,23060,1880,67,67
5,3.25,2850,4551,2,0,0,3,8,2370,480,47.4916,-122.144,2850,4849,7401,7699,2850,13,13
4,2.5,2080,17532,2,0,0,3,9,2080,0,47.4835,-122.136,2550,12560,19612,15110,2080,23,23
4,2.75,2830,7334,2,0,0,3,8,2830,0,47.4868,-122.141,2830,7378,10164,10208,2830,14,14
3,2,1220,17652,1,0,0,4,7,1220,0,47.4712,-122.1,1990,17652,18872,19642,1220,39,39
3,1.75,2020,11050,1,0,0,4,8,1320,700,47.4706,-122.119,1940,11050,13070,12990,2020,50,50
5,4.25,4420,13497,2,0,0,3,11,3510,910,47.5262,-122.143,4220,12015,17917,16235,4420,19,19
3,1,1010,9514,1,0,0,3,7,1010,0,47.4936,-122.105,1010,9514,10524,10524,1010,50,50
4,2.5,3000,5471,2,0,0,3,8,3000,0,47.4797,-122.126,2730,5471,8471,8201,3000,6,6
3,1.75,1740,29597,1,0,0,4,7,1740,0,47.481,-122.115,1560,20741,31337,22301,1740,54,54
5,2.25,2100,10726,1,0,0,4,7,1050,1050,47.4922,-122.134,2100,10726,12826,12826,2100,56,56
3,2.5,2990,6725,2,0,0,3,9,2990,0,47.4928,-122.142,2790,6725,9715,9515,2990,16,16
4,2.5,2650,5600,2,0,0,3,8,2650,0,47.4786,-122.122,2650,5600,8250,8250,2650,5,5
4,2.75,2460,8643,2,0,0,3,9,2460,0,47.4828,-122.133,3110,8626,11103,11736,2460,8,8
3,2.5,3190,7828,2,0,0,3,9,3190,0,47.5047,-122.144,2970,7828,11018,10798,3190,13,13
3,1,1620,10610,1,0,0,4,6,1620,0,47.474,-122.125,1680,10795,12230,12475,1620,61,61
3,1,880,9035,1,0,0,4,6,880,0,47.476,-122.151,1440,10350,9915,11790,880,52,52
4,2.5,2150,3143,2,0,0,3,7,2150,0,47.5048,-122.154,2640,3200,5293,5840,2150,9,9
3,1.5,1100,8140,1,0,0,4,7,1100,0,47.5004,-122.162,1430,7700,9240,9130,1100,54,54
4,2.75,2830,8126,2,0,0,3,8,2830,0,47.4863,-122.14,2830,7916,10956,10746,2830,14,14
4,4.25,5550,12968,2,0,0,3,11,5550,0,47.5305,-122.135,4750,13001,18518,17751,5550,14,14
3,1,1250,7920,1,0,0,4,7,1250,0,47.4853,-122.126,1440,9648,9170,11088,1250,59,59
4,2,1830,21183,1,0,0,4,7,1060,770,47.4826,-122.128,1950,6120,23013,8070,1830,53,53
5,4.25,5040,9466,2,0,0,3,11,5040,0,47.5282,-122.133,4300,9417,14506,13717,5040,15,15
3,2.5,2150,8221,2,0,0,3,8,2150,0,47.5085,-122.15,2490,7951,10371,10441,2150,27,27
4,2.5,3010,9000,2,0,0,3,8,3010,0,47.4987,-122.147,3250,5531,12010,8781,3010,11,11
5,3,2720,9856,2,0,0,4,8,2720,0,47.4778,-122.146,1420,9685,12576,11105,2720,50,50
3,1.75,1780,11440,1,0,0,3,8,1350,430,47.474,-122.139,2180,11440,13220,13620,1780,42,42
3,1,1000,16376,1,0,0,3,7,1000,0,47.4825,-122.108,1420,16192,17376,17612,1000,60,60
3,1,950,10723,1,0,0,4,6,950,0,47.4899,-122.133,1520,10723,11673,12243,950,60,60
4,2.5,1840,15496,2,0,0,3,8,1840,0,47.4683,-122.07,1840,15040,17336,16880,1840,28,28
3,2,1250,8636,1,0,0,5,7,1250,0,47.5066,-122.159,1620,7653,9886,9273,1250,51,51
4,2.5,2510,4349,2,0,0,3,8,2510,0,47.4927,-122.147,2510,4314,6859,6824,2510,9,9
4,2.75,3250,5600,2,0,0,3,8,3250,0,47.4806,-122.125,2730,5667,8850,8397,3250,8,8
3,2.25,1780,9720,1,0,0,3,8,1280,500,47.4762,-122.156,1710,9790,11500,11500,1780,38,38
4,2.25,2210,14073,1,0,0,3,8,1630,580,47.4774,-122.142,2340,11340,16283,13680,2210,41,41
3,1.75,1840,11440,1,0,0,4,8,1340,500,47.474,-122.14,1940,11440,13280,13380,1840,42,42
3,2.5,1260,3855,2,0,0,3,8,1260,0,47.4908,-122.154,1310,3344,5115,4654,1260,20,20
4,2.5,2570,22215,2,0,0,5,7,2570,0,47.4833,-122.157,2460,6533,24785,8993,2570,61,61
4,2.5,2750,11830,2,0,0,3,9,2750,0,47.4698,-122.121,2310,11830,14580,14140,2750,5,5
3,1.5,1350,7800,1,0,0,3,7,1350,0,47.4805,-122.158,1510,8040,9150,9550,1350,60,60
5,2.5,2340,4500,2,0,0,3,7,2340,0,47.4911,-122.154,2190,4500,6840,6690,2340,10,10
5,1.75,1880,48787,2,0,0,3,6,1880,0,47.5094,-122.165,1690,8401,50667,10091,1880,97,97
4,3.5,3040,8414,2,0,0,3,9,2420,620,47.5222,-122.157,3470,8066,11454,11536,3040,9,9
4,2.5,2190,17600,1,0,0,4,7,1110,1080,47.4712,-122.112,1820,17600,19790,19420,2190,53,53
4,2.5,2010,16020,1,0,0,5,8,2010,0,47.4821,-122.108,1420,16020,18030,17440,2010,57,57
4,3.25,4010,13797,2,0,0,3,11,4010,0,47.5229,-122.152,3980,12120,17807,16100,4010,16,16
4,2,1850,9126,1,0,0,5,7,1850,0,47.5009,-122.164,1730,9110,10976,10840,1850,56,56
3,2.5,1760,2688,2,0,0,3,7,1760,0,47.4903,-122.166,1760,2329,4448,4089,1760,14,14
4,2.5,2420,5006,2,0,0,3,8,2420,0,47.4795,-122.126,2750,5471,7426,8221,2420,6,6
3,2.5,2610,5845,2,0,0,3,8,2610,0,47.4821,-122.142,2810,5000,8455,7810,2610,14,14
3,1,1000,9150,1,0,0,3,7,1000,0,47.4829,-122.124,1490,10647,10150,12137,1000,50,50
3,2.5,1930,10460,2,0,0,3,8,1930,0,47.4938,-122.161,2290,8228,12390,10518,1930,23,23
3,1.5,1020,11410,1,0,0,3,7,1020,0,47.4811,-122.162,1290,8400,12430,9690,1020,60,60
4,2.75,3030,6625,2,0,0,3,8,3030,0,47.4815,-122.152,3030,9620,9655,12650,3030,8,8
4,2.5,2130,11733,1,0,0,5,7,1330,800,47.512,-122.16,1800,9131,13863,10931,2130,50,50
2,2,1510,20685,1,0,0,2,6,1250,260,47.481,-122.116,1490,29527,22195,31017,1510,61,61
5,2.75,2920,6327,2,0,0,3,8,2920,0,47.4935,-122.145,2520,5026,9247,7546,2920,12,12
3,2.5,3030,9053,2,0,0,3,8,3030,0,47.4945,-122.149,3010,6026,12083,9036,3030,10,10
4,2.5,2950,4836,2,0,0,3,7,2950,0,47.479,-122.129,2120,4750,7786,6870,2950,13,13
4,2.5,3070,8086,2,0,0,3,10,3070,0,47.5399,-122.16,3320,10738,11156,14058,3070,14,14
4,2.5,2230,5000,1,0,0,3,7,1650,580,47.4799,-122.129,2090,4637,7230,6727,2230,13,13
3,1.75,1510,12408,1,0,0,4,7,1510,0,47.5069,-122.141,1480,17800,13918,19280,1510,50,50
4,1.75,1480,11200,1,0,0,4,7,1480,0,47.5064,-122.141,1480,20310,12680,21790,1480,50,50
3,1.5,1430,9600,1,0,0,4,7,1430,0,47.4737,-122.15,1590,10240,11030,11830,1430,53,53
4,2.5,2020,5501,2,0,0,3,7,2020,0,47.4937,-122.15,2020,5494,7521,7514,2020,9,9
4,2.5,2080,11050,1,0,0,4,8,2080,0,47.472,-122.119,1850,11050,13130,12900,2080,50,50
4,2.5,1970,8545,2,0,0,3,8,1970,0,47.4893,-122.138,2590,7200,10515,9790,1970,15,15
3,2,1780,8621,1,0,0,3,8,1780,0,47.5062,-122.149,2470,8542,10401,11012,1780,27,27
3,2.5,1860,11122,2,0,0,3,8,1860,0,47.5062,-122.151,2420,8542,12982,10962,1860,25,25
5,2,1540,9629,1,0,0,4,7,1540,0,47.4915,-122.143,2260,9600,11169,11860,1540,59,59
4,2.5,2680,7513,2,0,0,3,8,2680,0,47.4956,-122.161,2640,7243,10193,9883,2680,21,21
3,2,1630,10723,1,0,0,5,7,1630,0,47.4898,-122.133,1450,10723,12353,12173,1630,60,60
4,2.5,3260,6902,2,0,0,3,8,3260,0,47.4829,-122.156,3130,6588,10162,9718,3260,11,11
3,2.5,2970,21907,2,0,0,3,9,2970,0,47.4741,-122.099,2040,27917,24877,29957,2970,21,8
4,1.5,2020,7560,1,0,0,4,7,2020,0,47.502,-122.146,1410,8080,9580,9490,2020,59,59
3,2.5,1520,3003,2,0,0,3,7,1520,0,47.4876,-122.153,1820,3030,4523,4850,1520,10,10
4,2.5,2910,6338,2,0,0,3,8,2910,0,47.4804,-122.126,2500,5877,9248,8377,2910,11,11
3,1.75,1620,9600,1,0,0,4,7,1620,0,47.4749,-122.155,1660,10200,11220,11860,1620,53,53
4,3.5,4370,10860,2,0,0,3,11,4370,0,47.5066,-122.148,3560,8070,15230,11630,4370,11,11
4,2.5,1850,9136,2,0,0,3,8,1850,0,47.4943,-122.157,1930,7873,10986,9803,1850,22,22
4,2.25,2240,12650,1,0,0,4,8,1730,510,47.4777,-122.142,2150,12650,14890,14800,2240,38,38
3,2.5,2950,6545,2,0,0,3,8,2950,0,47.4828,-122.139,2400,6550,9495,8950,2950,16,16
3,1.75,1710,15844,1,0,0,4,8,1710,0,47.4706,-122.1,1990,20359,17554,22349,1710,55,55
2,2.5,1420,2229,2,0,0,3,7,1420,0,47.4871,-122.165,1500,2230,3649,3730,1420,15,15
4,2.5,3250,6933,2,0,0,3,8,3250,0,47.4956,-122.151,3030,5308,10183,8338,3250,10,10
4,2.75,2320,4344,2,0,0,3,8,2320,0,47.4862,-122.163,2310,3770,6664,6080,2320,7,7
4,2.75,2720,51396,2,0,0,4,8,2720,0,47.4777,-122.1,1960,51366,54116,53326,2720,42,42
4,2.5,2600,17388,2,0,0,3,9,2600,0,47.5283,-122.146,2950,11553,19988,14503,2600,23,23
3,1.75,1310,12750,1,0,0,3,7,1310,0,47.4695,-122.07,1790,13500,14060,15290,1310,26,26
4,2.5,2200,6400,2,0,0,3,8,2200,0,47.4856,-122.156,2600,5870,8600,8470,2200,9,9
3,1.75,1860,9629,1,0,0,4,7,1240,620,47.4913,-122.143,1940,9629,11489,11569,1860,58,58
4,2.5,2180,7203,2,0,0,4,8,2180,0,47.5119,-122.151,2350,7334,9383,9684,2180,30,30
3,1,1170,11100,1,0,0,4,6,1170,0,47.4954,-122.164,2080,8481,12270,10561,1170,51,51
4,2.5,1790,6120,2,0,0,3,7,1790,0,47.4829,-122.128,1950,5660,7910,7610,1790,14,14
3,2,1540,67953,1,0,0,3,7,1540,0,47.5018,-122.126,1250,9100,69493,10350,1540,22,22
4,1.75,2030,7210,1,0,0,3,7,1450,580,47.5067,-122.164,1750,8387,9240,10137,2030,51,51
4,2.5,2230,8560,2,0,0,3,8,2230,0,47.4877,-122.143,2400,7756,10790,10156,2230,17,17
4,2.5,2460,4774,2,0,0,3,8,2460,0,47.4912,-122.145,2510,4399,7234,6909,2460,13,13
4,2.75,2350,5589,2,0,0,3,7,2350,0,47.5098,-122.155,2014,6365,7939,8379,2350,18,18
4,2.5,2220,6800,2,0,0,3,7,2220,0,47.49,-122.15,2220,5303,9020,7523,2220,17,17
4,1.5,1970,14490,1,0,0,4,7,1970,0,47.4612,-122.069,1880,14880,16460,16760,1970,56,56
3,1,1510,10369,1,0,0,4,7,1010,500,47.4808,-122.099,1510,16057,11879,17567,1510,51,51
4,2.5,2710,6583,2,0,0,3,9,2710,0,47.4922,-122.141,2710,6583,9293,9293,2710,16,16
3,1.5,1680,8712,1,0,0,3,8,1680,0,47.4811,-122.149,1850,8797,10392,10647,1680,55,55
4,2.5,2780,4688,2,0,0,3,9,2780,0,47.5225,-122.156,3000,6029,7468,9029,2780,16,16
4,3.25,3960,12895,2,0,0,3,11,3960,0,47.5211,-122.151,3870,12040,16855,15910,3960,18,18
3,2.5,1810,7210,1,0,0,5,7,1210,600,47.5067,-122.163,1770,7210,9020,8980,1810,51,51
5,3.5,3990,9938,2,0,0,3,11,3990,0,47.5198,-122.156,3490,11734,13928,15224,3990,18,18
4,3,2590,6160,2,0,0,3,8,2590,0,47.4784,-122.122,2670,5600,8750,8270,2590,5,5
5,3.5,3200,43560,2,0,0,3,7,3200,0,47.475,-122.093,2730,43560,46760,46290,3200,30,30
6,3.5,4310,7760,2,0,0,3,10,3260,1050,47.5297,-122.155,4620,10217,12070,14837,4310,6,6
4,2.5,3250,4500,2,0,0,3,8,3250,0,47.4944,-122.15,3030,4598,7750,7628,3250,11,11
3,1,1010,14948,1,0,0,5,6,1010,0,47.4772,-122.144,1510,9600,15958,11110,1010,50,50
4,2.75,3110,11225,2,0,0,3,8,3110,0,47.4865,-122.143,2610,8535,14335,11145,3110,7,7
4,2.5,2810,11902,2,0,0,4,9,2810,0,47.5303,-122.143,2990,10754,14712,13744,2810,26,26
3,1.5,1320,13200,1,0,0,3,7,1320,0,47.5009,-122.143,1730,13200,14520,14930,1320,49,49
3,1.75,1260,10164,1,0,0,4,6,1260,0,47.4752,-122.133,1190,10640,11424,11830,1260,55,55
3,2.5,2080,16050,1,0,0,5,8,1360,720,47.4694,-122.069,1790,14550,18130,16340,2080,41,41
3,2.25,1830,25641,2,0,0,3,8,1830,0,47.4786,-122.112,1500,25641,27471,27141,1830,30,30
4,2.5,3170,5340,2,0,0,3,7,3170,0,47.4911,-122.138,3010,5340,8510,8350,3170,19,19
4,2.5,2670,8765,2,0,0,3,9,2670,0,47.4876,-122.146,2880,8765,11435,11645,2670,13,13
4,2.5,2480,4504,2,0,0,3,7,2480,0,47.4998,-122.15,2950,4504,6984,7454,2480,14,14
4,2.5,3180,5405,2,0,0,3,7,3180,0,47.4905,-122.14,2610,5403,8585,8013,3180,18,18
4,2.75,2550,7591,2,0,0,3,9,2550,0,47.5302,-122.147,2670,7796,10141,10466,2550,30,30
4,4.5,5250,48352,2,0,0,3,10,5250,0,47.4858,-122.111,2500,48352,53602,50852,5250,21,21
3,1.75,1490,7150,1,0,0,5,6,1490,0,47.5015,-122.124,1350,9100,8640,10450,1490,52,52
4,2.75,3050,4750,2,0,0,3,8,3050,0,47.4857,-122.153,2730,5480,7800,8210,3050,5,5
3,1,1040,9514,1,0,0,4,7,1040,0,47.4936,-122.102,1040,9514,10554,10554,1040,50,50
3,2,1220,14645,1,0,0,3,6,1220,0,47.4842,-122.117,1980,24960,15865,26940,1220,49,49
3,1.5,1340,25160,1,0,0,3,7,1340,0,47.475,-122.111,1440,23680,26500,25120,1340,51,51
4,2.5,2240,14667,2,0,0,4,9,2240,0,47.5276,-122.161,2410,11243,16907,13653,2240,30,30
4,3.75,3460,6738,2,0,0,3,11,3460,0,47.506,-122.145,3340,6120,10198,9460,3460,6,6
4,1.75,1760,11180,1,0,0,4,8,1760,0,47.4715,-122.118,1730,11180,12940,12910,1760,51,51
3,2.5,1530,9406,1,0,0,3,7,1270,260,47.4852,-122.162,1700,7682,10936,9382,1530,26,26
4,2.5,4660,7157,2,0,0,3,9,3020,1640,47.5352,-122.156,3300,7047,11817,10347,4660,16,16
4,2.5,4080,11054,2,0,0,3,11,4080,0,47.5188,-122.151,3520,11914,15134,15434,4080,18,18
4,3,3720,15048,3,0,0,3,7,3720,0,47.5116,-122.144,2020,15180,18768,17200,3720,40,0
5,2.75,3600,9437,2,0,0,3,9,3600,0,47.4822,-122.131,3550,9421,13037,12971,3600,5,5
5,2.75,3380,8179,2,0,0,3,9,3380,0,47.4827,-122.135,2840,8179,11559,11019,3380,8,8
3,1,1530,9465,1,0,0,4,7,1530,0,47.4915,-122.151,1530,9465,10995,10995,1530,59,59
3,2.25,2190,220414,1,0,0,4,7,1330,860,47.5041,-122.102,2550,175982,222604,178532,2190,43,43
3,2.75,2580,5200,2,0,0,3,8,2580,0,47.496,-122.151,2700,5602,7780,8302,2580,11,11
4,2.5,2220,6233,2,0,0,3,7,2220,0,47.4887,-122.15,2220,5352,8453,7572,2220,18,18
5,1.75,2330,14322,1,0,0,4,7,1180,1150,47.4768,-122.155,1690,10010,16652,11700,2330,51,51
3,1.75,1700,51649,1,0,0,5,6,1700,0,47.4704,-122.076,1100,39504,53349,40604,1700,88,88
3,2.5,2650,7286,2,0,0,3,8,2650,0,47.5084,-122.154,2400,7220,9936,9620,2650,29,29
3,2.5,3030,4500,2,0,0,3,8,3030,0,47.4944,-122.15,3030,4501,7530,7531,3030,10,10
4,2.75,2280,15347,1,0,0,5,7,2280,0,47.5218,-122.164,2280,15347,17627,17627,2280,59,59
5,2.75,2990,7420,2,0,0,3,8,2990,0,47.4944,-122.162,2290,7678,10410,9968,2990,23,23
4,2.75,3220,9825,2,0,0,3,8,3220,0,47.4863,-122.143,2820,8566,13045,11386,3220,7,7
3,1,1130,7920,1,0,0,3,7,1130,0,47.4852,-122.125,1390,8580,9050,9970,1130,58,58
3,2.5,2480,4136,2,0,0,3,8,2480,0,47.493,-122.147,2510,4314,6616,6824,2480,10,10
4,3.5,3430,13609,2,0,0,3,11,3430,0,47.5196,-122.151,3880,11614,17039,15494,3430,18,18
4,2.5,3200,12369,2,0,0,3,10,3200,0,47.5273,-122.143,3770,12960,15569,16730,3200,21,21
4,2.25,2150,27345,2,0,0,5,8,2150,0,47.469,-122.121,2200,11923,29495,14123,2150,43,43
3,1.5,1160,10125,1,0,0,4,7,1160,0,47.4919,-122.151,1440,10018,11285,11458,1160,60,60
3,1.5,1360,10726,1,0,0,4,7,1360,0,47.4948,-122.134,1650,10726,12086,12376,1360,53,53
3,1.75,2110,10200,2,0,0,4,7,2110,0,47.4744,-122.154,1800,10200,12310,12000,2110,53,53
4,2.5,2940,10382,2,0,0,4,9,2940,0,47.5333,-122.151,2980,10547,13322,13527,2940,28,28
4,2.5,2400,8038,2,0,0,3,8,2400,0,47.4881,-122.143,2040,7756,10438,9796,2400,17,17
3,2.5,2120,3757,2,0,0,3,7,2120,0,47.4787,-122.128,2230,4103,5877,6333,2120,13,13
3,2.25,2430,73151,1,0,0,3,8,2430,0,47.4749,-122.092,2800,39250,75581,42050,2430,45,45
3,1.75,1880,16262,1,0,0,5,7,1880,0,47.5089,-122.155,1900,7972,18142,9872,1880,39,39
3,1.75,1180,13927,1,0,0,5,7,1180,0,47.4818,-122.094,1400,13173,15107,14573,1180,57,57
3,1.75,1300,9079,1,0,0,3,7,1300,0,47.4834,-122.159,1890,7369,10379,9259,1300,33,33
4,2.5,2400,6811,2,0,0,3,8,2400,0,47.4959,-122.15,2710,5314,9211,8024,2400,12,12
5,3,2800,5700,2,0,0,3,8,2800,0,47.4969,-122.145,2910,5349,8500,8259,2800,5,5
2,2.5,1700,2513,2,0,0,3,8,1700,0,47.5163,-121.878,1760,2891,4213,4651,1700,10,10
3,2.5,1790,3754,2,0,0,3,8,1790,0,47.534,-121.841,1800,3393,5544,5193,1790,6,6
4,2.5,2980,8107,2,0,0,3,9,2980,0,47.5389,-121.876,2750,7760,11087,10510,2980,19,19
3,2.5,2370,6082,2,0,0,3,7,2370,0,47.5288,-121.846,2690,6152,8452,8842,2370,15,15
3,2.5,1950,5689,2,0,0,3,7,1950,0,47.5158,-121.873,2190,5653,7639,7843,1950,10,10
4,2.5,2920,6000,2,0,4,3,9,2920,0,47.5333,-121.859,3100,6001,8920,9101,2920,15,15
3,2.5,1700,4125,2,0,0,3,7,1700,0,47.5305,-121.854,1970,4105,5825,6075,1700,15,15
4,2.5,3110,6479,2,0,0,3,9,3110,0,47.5408,-121.861,3110,7075,9589,10185,3110,14,14
3,2.5,2400,6182,2,0,0,3,8,2400,0,47.5363,-121.87,2420,5829,8582,8249,2400,21,21
3,2.5,2420,8252,2,0,0,3,7,2420,0,47.5382,-121.871,2420,5818,10672,8238,2420,21,21
4,3.5,3510,6005,2,0,0,3,8,2750,760,47.5168,-121.87,3090,5866,9515,8956,3510,9,9
3,2.5,2480,5647,2,0,0,3,7,2480,0,47.5355,-121.88,2510,5018,8127,7528,2480,17,17
4,2.5,2710,6474,2,0,0,3,8,2710,0,47.5383,-121.878,2870,6968,9184,9838,2710,15,15
4,3.5,4000,15253,2,0,0,3,9,4000,0,47.5433,-121.887,3550,8747,19253,12297,4000,12,12
3,2.5,3310,4682,2,0,0,3,9,2380,930,47.5201,-121.885,2660,5166,7992,7826,3310,4,4
5,3.25,3660,11995,2,0,2,3,10,3660,0,47.5337,-121.86,3320,11241,15655,14561,3660,13,13
2,1,900,28800,1,0,0,1,6,900,0,47.5245,-121.822,1360,7200,29700,8560,900,91,91
4,2.75,3350,7857,2,0,2,3,9,3350,0,47.5398,-121.859,3870,7886,11207,11756,3350,15,15
4,2.5,2950,9010,2,0,0,3,9,2950,0,47.531,-121.86,3160,8813,11960,11973,2950,15,15
3,2.5,1590,4242,2,0,0,3,7,1590,0,47.5309,-121.876,1590,3702,5832,5292,1590,19,19
4,3.5,2910,5260,2,0,0,3,9,2910,0,47.5168,-121.883,2910,5260,8170,8170,2910,7,7
4,2.5,2170,4587,2,0,0,3,7,2170,0,47.5396,-121.889,2170,5211,6757,7381,2170,13,13
4,3.25,3910,6293,2,0,0,3,9,3130,780,47.5389,-121.86,4410,6015,10203,10425,3910,13,13
3,1.5,2450,12497,1,0,0,4,7,2450,0,47.5317,-121.834,1560,11700,14947,13260,2450,52,52
3,2.5,2360,4670,2,0,0,3,7,2360,0,47.537,-121.871,2420,5620,7030,8040,2360,21,21
4,2.5,2910,5776,2,0,2,3,8,2910,0,47.5388,-121.87,2550,6750,8686,9300,2910,21,21
4,3.5,4220,5817,2,0,0,3,9,2910,1310,47.5392,-121.862,4290,6637,10037,10927,4220,13,13
4,1.75,1950,13440,1,0,0,4,6,1950,0,47.5232,-121.821,1300,7432,15390,8732,1950,88,88
3,2.5,1970,4036,2,0,0,4,7,1970,0,47.5335,-121.869,1960,5020,6006,6980,1970,16,16
3,3.5,3690,8837,2,0,0,3,10,3690,0,47.5402,-121.876,3690,9585,12527,13275,3690,18,18
3,2.5,1470,3999,2,0,0,3,7,1470,0,47.5328,-121.871,1960,4444,5469,6404,1470,16,16
5,2.5,2160,7737,2,0,0,3,7,2160,0,47.5381,-121.872,2460,7737,9897,10197,2160,21,21
3,1.75,1430,39160,1,0,0,3,7,900,530,47.5513,-121.801,1430,40860,40590,42290,1430,94,27
2,1,1160,5750,1,0,0,4,6,1160,0,47.5322,-121.829,1160,8250,6910,9410,1160,95,95
4,2.75,2700,5150,2,0,0,3,9,2700,0,47.5209,-121.874,2700,5747,7850,8447,2700,10,10
5,2.5,2550,6405,2,0,0,3,7,2550,0,47.5191,-121.869,2190,5900,8955,8090,2550,11,11
5,2.5,2860,68519,2,0,0,5,8,2860,0,47.5265,-121.835,1670,35910,71379,37580,2860,61,61
3,1,960,9748,1,0,0,3,5,960,0,47.5259,-121.815,1600,9958,10708,11558,960,97,97
2,2.75,1760,4139,2,0,0,3,8,1760,0,47.5175,-121.878,1870,3076,5899,4946,1760,9,9
4,3.5,3510,9364,2,0,0,3,10,3510,0,47.54,-121.876,3510,9161,12874,12671,3510,18,18
4,2.75,3430,15877,1,0,4,3,11,3430,0,47.5364,-121.856,4080,14577,19307,18657,3430,14,14
4,2.75,3310,6166,2,0,0,3,9,3310,0,47.521,-121.877,3200,7027,9476,10227,3310,11,11
4,2.5,2910,7287,2,0,0,3,8,2910,0,47.5354,-121.869,2420,6180,10197,8600,2910,21,21
3,2.5,1970,3667,2,0,0,3,7,1970,0,47.5321,-121.851,1970,3739,5637,5709,1970,15,15
5,2.75,3100,5298,2,0,0,3,7,3100,0,47.5369,-121.887,2440,5250,8398,7690,3100,12,12
4,2.5,3500,11306,2,0,2,3,9,3500,0,47.5428,-121.861,3180,8028,14806,11208,3500,14,14
3,2.5,2360,6699,2,0,0,3,7,2360,0,47.5317,-121.853,2360,4744,9059,7104,2360,16,16
3,2.5,2860,8935,2,0,0,3,8,2860,0,47.5336,-121.855,2650,6167,11795,8817,2860,15,15
1,0.75,820,59677,1,0,0,3,5,820,0,47.5316,-121.764,1590,14163,60497,15753,820,20,20
2,1.75,1740,6620,1,0,0,3,8,1740,0,47.526,-121.828,1560,5400,8360,6960,1740,17,17
4,2.5,2630,6326,2,0,0,3,9,2630,0,47.5222,-121.874,3240,6229,8956,9469,2630,11,11
4,3.5,3510,9084,2,0,0,3,10,3510,0,47.5402,-121.875,3690,9568,12594,13258,3510,18,18
3,1,1300,5782,1,0,0,4,6,1300,0,47.524,-121.821,1020,7200,7082,8220,1300,60,60
4,1,1430,27153,1,0,0,4,5,1430,0,47.5372,-121.744,1880,27153,28583,29033,1430,85,85
4,3.75,4980,18069,2,0,3,3,11,4980,0,47.5348,-121.856,4080,14577,23049,18657,4980,13,13
4,2.5,2320,10046,2,0,0,3,7,2320,0,47.5406,-121.887,2320,5253,12366,7573,2320,13,13
3,2.5,1700,6396,2,0,0,3,7,1700,0,47.5333,-121.87,1700,4444,8096,6144,1700,16,16
4,2.5,2190,6578,2,0,0,3,7,2190,0,47.5305,-121.847,2190,5416,8768,7606,2190,15,15
3,2.25,1560,11997,1,0,0,3,7,1260,300,47.5378,-121.742,1820,36590,13557,38410,1560,31,31
3,2.5,2500,4203,2,0,0,3,8,2500,0,47.5346,-121.875,2460,4798,6703,7258,2500,18,18
5,3,3100,5250,2,0,0,3,7,3100,0,47.5369,-121.888,2460,5250,8350,7710,3100,13,13
5,3.75,4210,14599,2,0,3,3,10,4210,0,47.5364,-121.858,3950,13591,18809,17541,4210,15,15
4,3.25,3570,14408,2,0,2,3,10,3570,0,47.536,-121.857,4100,14577,17978,18677,3570,13,13
3,2.5,2230,5800,2,0,0,3,7,2230,0,47.5308,-121.847,2230,6088,8030,8318,2230,15,15
4,2.5,2390,5021,2,0,0,3,7,2390,0,47.5353,-121.879,2520,5333,7411,7853,2390,17,17
4,2.5,3230,5899,2,0,0,3,8,3230,0,47.515,-121.869,2720,5899,9129,8619,3230,7,7
4,3.25,3420,6752,2,0,2,3,9,3030,390,47.517,-121.876,3010,5172,10172,8182,3420,7,7
4,3.5,3220,5741,2,0,0,3,9,3220,0,47.5169,-121.886,2960,6534,8961,9494,3220,6,6
4,2.75,3260,5335,2,0,0,3,9,3260,0,47.5414,-121.864,3180,5438,8595,8618,3260,16,16
4,3.5,3510,9263,2,0,0,3,10,3510,0,47.5413,-121.877,3690,10417,12773,14107,3510,18,18
3,2.5,1800,4357,2,0,0,3,8,1800,0,47.5337,-121.841,1800,3663,6157,5463,1800,6,6
2,1.75,1560,43748,2,0,0,3,8,1560,0,47.5729,-121.676,1000,24602,45308,25602,1560,52,14
3,3,2780,6000,2,0,0,3,9,2780,0,47.5184,-121.886,2850,6000,8780,8850,2780,6,6
3,2.5,2350,4456,2,0,0,3,7,2350,0,47.5314,-121.854,2350,4456,6806,6806,2350,15,15
4,2.5,2580,5823,2,0,0,3,8,2580,0,47.5374,-121.875,2380,5823,8403,8203,2580,17,17
4,2.5,3060,7161,2,0,0,3,8,2860,200,47.5383,-121.879,2950,6822,10221,9772,3060,14,14
5,3.5,3340,5000,2,0,0,3,8,2580,760,47.5168,-121.871,3420,5000,8340,8420,3340,7,7
3,1.5,760,40039,1,0,0,3,6,760,0,47.5295,-121.829,980,6000,40799,6980,760,113,113
4,3.5,3720,13591,2,0,3,3,10,3720,0,47.536,-121.858,4210,14282,17311,18492,3720,15,15
3,2.5,2720,6439,2,0,0,3,9,2720,0,47.5422,-121.86,3180,7320,9159,10500,2720,14,14
3,2.5,2410,4293,2,0,0,3,7,2410,0,47.5196,-121.869,2190,5900,6703,8090,2410,12,12
3,2.5,1800,3265,2,0,0,3,8,1800,0,47.5338,-121.841,1800,3663,5065,5463,1800,5,5
3,2.5,1970,4058,2,0,0,3,7,1970,0,47.5308,-121.853,2340,4067,6028,6407,1970,15,15
5,1,3240,5324,2,0,0,3,9,3240,0,47.523,-121.875,3240,6036,8564,9276,3240,12,12
3,2.5,2070,4697,2,0,0,3,7,2070,0,47.5307,-121.875,2230,4437,6767,6667,2070,17,17
4,3,2640,5267,2,0,0,3,7,2640,0,47.5298,-121.88,2640,5670,7907,8310,2640,18,18
4,2.5,2550,6382,2,0,0,3,7,2550,0,47.5202,-121.87,2430,5900,8932,8330,2550,12,12
4,2.5,2590,5756,2,0,0,3,8,2590,0,47.5356,-121.875,2620,6109,8346,8729,2590,18,18
5,3.25,3940,9780,2,0,0,3,9,3940,0,47.5435,-121.888,3550,8468,13720,12018,3940,12,12
3,2.5,2060,4399,2,0,0,3,7,2060,0,47.5415,-121.884,2060,4399,6459,6459,2060,12,12
2,1.75,1310,10200,1,0,0,4,6,1310,0,47.5231,-121.82,1500,7200,11510,8700,1310,72,72
3,2.5,1970,6295,2,0,0,3,7,1970,0,47.5158,-121.874,2710,6009,8265,8719,1970,8,8
5,3.25,3340,9075,2,0,0,3,8,2600,740,47.5446,-121.88,2770,6646,12415,9416,3340,14,14
1,1,480,4560,1,0,0,3,5,480,0,47.5253,-121.826,890,4803,5040,5693,480,97,97
3,2.5,2170,5866,2,0,0,3,7,2170,0,47.5403,-121.889,2440,5798,8036,8238,2170,13,13
3,1.75,1790,27427,1,0,0,3,7,1130,660,47.532,-121.761,1610,16684,29217,18294,1790,41,41
4,2.5,2460,6454,2,0,0,3,7,2460,0,47.5381,-121.89,2320,4578,8914,6898,2460,13,13
4,2.5,2340,6973,2,0,0,3,8,1930,410,47.5451,-121.882,2950,6908,9313,9858,2340,14,14
2,1,910,9000,1,0,0,3,5,910,0,47.526,-121.81,1290,9000,9910,10290,910,96,96
3,2.5,1950,4949,2,0,0,3,7,1950,0,47.5155,-121.87,2200,5740,6899,7940,1950,10,10
4,2.5,2490,6537,2,0,0,3,8,2490,0,47.5185,-121.884,2520,5848,9027,8368,2490,6,6
3,2.75,1890,3930,2,0,0,3,8,1890,0,47.5337,-121.867,2100,4259,5820,6359,1890,20,20
3,2.5,2410,4656,2,0,0,3,7,2410,0,47.5203,-121.874,2410,4840,7066,7250,2410,10,10
3,2.5,1650,2787,2,0,0,3,8,1650,0,47.5336,-121.838,1760,2787,4437,4547,1650,5,5
3,2.5,2400,5817,2,0,0,3,8,2400,0,47.5371,-121.87,2420,5817,8217,8237,2400,21,21
4,2.5,3340,5314,2,0,0,3,10,3340,0,47.5167,-121.885,3220,5500,8654,8720,3340,9,9
4,2.75,3190,8737,2,0,0,3,9,3190,0,47.523,-121.877,3240,7131,11927,10371,3190,13,13
3,2.5,1800,3168,2,0,0,3,8,1800,0,47.5342,-121.841,1800,3393,4968,5193,1800,5,5
2,2,1550,435600,1,0,0,2,7,1550,0,47.5145,-121.853,1600,217800,437150,219400,1550,47,47
5,4.75,5180,17811,2,0,2,3,11,4070,1110,47.5405,-121.868,3960,15103,22991,19063,5180,18,18
4,3.5,4490,5099,2,0,0,3,9,3390,1100,47.5394,-121.861,4290,5537,9589,9827,4490,13,13
4,2.5,2440,5088,2,0,0,3,7,2440,0,47.5406,-121.889,2440,5762,7528,8202,2440,12,12
4,2.75,3010,6854,2,0,2,3,9,2570,440,47.5171,-121.876,1830,2952,9864,4782,3010,7,7
3,2.75,1890,3938,2,0,0,3,8,1890,0,47.5336,-121.867,1890,4142,5828,6032,1890,20,20
6,3.75,5960,20197,2,0,4,3,10,3900,2060,47.5398,-121.869,3860,12800,26157,16660,5960,14,14
3,2.5,1470,3976,2,0,0,3,7,1470,0,47.526,-121.826,1490,4400,5446,5890,1470,20,20
4,3,5940,11533,2,0,4,3,11,4950,990,47.5443,-121.87,4240,12813,17473,17053,5940,15,15
3,3.5,2500,4270,2,0,0,3,8,2500,0,47.536,-121.877,2420,4205,6770,6625,2500,19,19
4,2.5,2400,3986,2,0,0,3,8,2400,0,47.5344,-121.877,2070,3986,6386,6056,2400,20,20
3,2.5,2430,5867,2,0,0,3,7,2430,0,47.5162,-121.872,2620,5866,8297,8486,2430,8,8
4,4,4000,9309,2,0,0,3,9,4000,0,47.5421,-121.888,3920,8048,13309,11968,4000,12,12
4,2.5,2910,6250,2,0,0,3,8,2910,0,47.538,-121.87,2550,6250,9160,8800,2910,20,20
2,1.75,1610,158558,1,0,0,2,6,1610,0,47.5319,-121.84,1800,3572,160168,5372,1610,71,71
2,2.5,1620,3196,2,0,0,3,8,1620,0,47.5167,-121.878,1750,2828,4816,4578,1620,11,11
4,2.5,2870,6658,2,0,0,3,8,2870,0,47.5394,-121.878,2770,6658,9528,9428,2870,15,15
3,2.5,2690,4819,2,0,0,3,7,2690,0,47.5302,-121.849,2360,4829,7509,7189,2690,15,15
4,2.5,1890,5395,2,0,0,3,7,1890,0,47.5415,-121.883,2060,5395,7285,7455,1890,13,13
4,2.5,3550,8048,2,0,0,3,9,3550,0,47.5422,-121.888,3920,7871,11598,11791,3550,12,12
3,2.5,1450,3748,2,0,0,3,7,1450,0,47.532,-121.85,1970,3748,5198,5718,1450,15,15
5,4.5,4630,6324,2,0,0,3,9,3210,1420,47.5382,-121.86,4420,6790,10954,11210,4630,13,13
4,2.75,3710,7984,2,0,0,3,9,3710,0,47.5352,-121.868,2950,7984,11694,10934,3710,20,20
2,1,1360,69260,1,0,0,4,5,1360,0,47.5229,-121.838,1460,69260,70620,70720,1360,82,82
4,2.5,2070,3982,2,0,0,3,7,2070,0,47.531,-121.854,2340,4067,6052,6407,2070,15,15
3,2,1680,5246,1,0,0,3,7,1680,0,47.5206,-121.868,2430,6883,6926,9313,1680,12,12
3,2.5,2100,5824,2,0,2,3,8,2100,0,47.5334,-121.867,1890,4140,7924,6030,2100,20,20
3,2.5,1960,4709,2,0,0,3,7,1960,0,47.5322,-121.871,1700,4444,6669,6144,1960,16,16
4,2.5,2430,5000,2,0,0,3,7,2430,0,47.515,-121.873,2430,5441,7430,7871,2430,10,10
2,1,1060,10600,1,0,0,3,6,1060,0,47.5375,-121.742,1560,21344,11660,22904,1060,51,51
3,2.5,2240,6396,2,0,0,3,7,2240,0,47.5356,-121.881,2610,5128,8636,7738,2240,17,17
4,1,1170,34925,1,0,0,4,6,1170,0,47.5305,-121.841,1610,28108,36095,29718,1170,77,77
3,2.5,2100,5112,2,0,0,3,8,2100,0,47.5338,-121.867,2100,4370,7212,6470,2100,20,20
6,3.5,3600,6875,2,0,0,3,8,2740,860,47.5401,-121.879,3150,6663,10475,9813,3600,15,15
4,2.5,3830,4644,2,0,0,3,8,2900,930,47.5384,-121.88,3400,6163,8474,9563,3830,15,15
3,2.75,2450,5750,2,0,0,3,9,2450,0,47.5439,-121.862,3200,8036,8200,11236,2450,6,6
3,3,2780,6000,2,0,0,3,9,2780,0,47.5184,-121.886,2850,6000,8780,8850,2780,6,6
3,2.5,2490,5928,2,0,2,3,8,2490,0,47.5385,-121.87,2420,6381,8418,8801,2490,21,21
4,2.5,2500,4945,2,0,0,3,9,2500,0,47.5185,-121.885,2760,6000,7445,8760,2500,6,6
3,2.75,3230,5250,2,0,0,3,9,2680,550,47.5196,-121.878,2710,5250,8480,7960,3230,5,5
3,2.5,3110,11727,2,0,2,3,9,3110,0,47.5445,-121.871,4240,13353,14837,17593,3110,17,17
4,3.5,2550,8698,2,0,0,3,7,2550,0,47.5216,-121.869,2430,5519,11248,7949,2550,12,12
4,2.5,2890,9775,2,0,2,3,8,2890,0,47.5339,-121.854,2640,7184,12665,9824,2890,15,15
5,2.5,3200,6455,2,0,0,3,9,3200,0,47.5446,-121.862,3290,7924,9655,11214,3200,10,10
3,2.5,2280,6134,2,0,0,3,8,2280,0,47.5335,-121.854,2640,6167,8414,8807,2280,15,15
0,0,1470,4800,2,0,0,3,7,1470,0,47.5265,-121.828,1060,7200,6270,8260,1470,23,23
4,2.5,2470,3811,2,0,0,3,8,2470,0,47.5362,-121.877,2400,4266,6281,6666,2470,20,20
3,2.75,1940,3088,2,0,3,3,8,1770,170,47.5185,-121.878,1410,2335,5028,3745,1940,11,11
4,2.25,2140,6355,2,0,0,3,7,2140,0,47.5367,-121.88,2480,5746,8495,8226,2140,17,17
3,2.75,1770,3172,2,0,0,3,8,1770,0,47.5164,-121.878,1760,2891,4942,4651,1770,10,10
4,2.5,3290,6203,2,0,0,3,9,3290,0,47.5441,-121.86,2990,6835,9493,9825,3290,11,11
4,3.5,2910,5260,2,0,0,3,9,2910,0,47.5168,-121.883,2910,5260,8170,8170,2910,7,7
3,2.5,1650,4777,2,0,0,3,8,1650,0,47.5336,-121.841,1800,3331,6427,5131,1650,6,6
3,2.5,2370,7875,2,0,0,3,9,2370,0,47.5427,-121.863,2660,7752,10245,10412,2370,16,16
4,2.5,2720,4738,2,0,0,3,8,2720,0,47.515,-121.869,2590,5740,7458,8330,2720,7,7
3,2.5,2700,6037,2,0,0,3,8,2700,0,47.5376,-121.879,2740,6054,8737,8794,2700,15,15
4,2.5,2710,6937,2,0,0,3,7,2710,0,47.5153,-121.871,2380,5866,9647,8246,2710,10,10
4,2.5,2020,7200,1,0,0,4,6,2020,0,47.5223,-121.818,1440,7200,9220,8640,2020,65,65
3,2.5,2070,3986,2,0,0,3,8,2070,0,47.5348,-121.877,2090,3986,6056,6076,2070,20,20
4,2.5,1950,5000,2,0,0,3,8,1950,0,47.515,-121.872,2710,5000,6950,7710,1950,7,7
3,2.5,3060,7831,2,0,2,3,9,3060,0,47.5401,-121.861,3140,7438,10891,10578,3060,15,15
4,3.25,3030,7644,2,0,0,3,8,2830,200,47.5457,-121.881,3400,6908,10674,10308,3030,13,13
4,2.5,2070,4427,2,0,0,3,7,2070,0,47.5208,-121.869,2070,4556,6497,6626,2070,12,12
4,2.75,3120,7644,2,0,0,3,10,3120,0,47.5156,-121.884,2980,6050,10764,9030,3120,9,9
3,3.25,3140,37120,1,0,0,3,9,1760,1380,47.5244,-121.842,2100,13500,40260,15600,3140,35,35
4,2.5,2830,14538,2,0,0,3,8,2830,0,47.5405,-121.882,2270,6939,17368,9209,2830,16,16
3,1,1250,13503,1,0,0,4,6,1250,0,47.526,-121.829,1450,13503,14753,14953,1250,88,88
4,1,1730,177657,1,0,0,3,5,1730,0,47.5163,-121.829,1400,45175,179387,46575,1730,71,71
3,2.75,3230,5200,2,0,0,3,9,2680,550,47.519,-121.878,3100,4900,8430,8000,3230,5,5
3,2.5,1720,4515,2,0,0,3,7,1720,0,47.5426,-121.879,2220,4618,6235,6838,1720,14,14
4,2.5,3470,14271,2,0,0,3,9,3470,0,47.5423,-121.877,3450,9380,17741,12830,3470,14,14
2,2,1750,2731,2,0,0,3,8,1750,0,47.5169,-121.878,1650,2731,4481,4381,1750,7,7
3,2,2250,222156,1,0,0,3,7,2250,0,47.542,-121.792,2110,121968,224406,124078,2250,32,32
3,2.5,1950,4345,2,0,0,3,7,1950,0,47.5202,-121.873,2260,4345,6295,6605,1950,12,12
3,2.5,2090,32718,2,1,4,3,7,1550,540,47.3338,-122.511,1200,192268,34808,193468,2090,100,32
2,1,940,15450,1,0,0,4,6,940,0,47.4408,-122.461,1370,34820,16390,36190,940,93,93
2,2,2930,14057,1,0,2,4,8,1680,1250,47.4025,-122.463,2234,61011,16987,63245,2930,39,39
3,1.75,2060,58341,1,0,4,3,8,1100,960,47.4193,-122.439,1230,14904,60401,16134,2060,37,37
3,2.5,3136,54450,1,0,0,5,8,3136,0,47.3999,-122.472,2300,54450,57586,56750,3136,109,109
3,1.75,1560,82328,1,0,0,3,7,1560,0,47.3674,-122.503,2100,205603,83888,207703,1560,45,45
3,2.5,2750,226512,2,0,0,3,9,2750,0,47.4376,-122.456,1250,211266,229262,212516,2750,19,19
3,1,1190,85226,1,0,0,5,5,1190,0,47.365,-122.462,1360,46960,86416,48320,1190,84,84
3,1.75,2000,12669,1,0,3,4,7,1200,800,47.3579,-122.446,1580,12055,14669,13635,2000,54,54
1,1,920,91476,1,0,0,3,6,920,0,47.448,-122.472,1746,91476,92396,93222,920,23,12
2,0.75,1392,43710,1,0,0,4,7,1392,0,47.4491,-122.453,1640,99316,45102,100956,1392,41,41
2,1.75,1210,131115,1,0,0,5,7,1210,0,47.4599,-122.45,2020,185565,132325,187585,1210,69,69
3,1,1120,32250,1,0,0,4,6,1120,0,47.447,-122.482,1010,335289,33370,336299,1120,85,85
4,3,3230,438213,2,0,0,3,9,3230,0,47.4141,-122.47,1600,144619,441443,146219,3230,20,20
2,1.75,1728,95950,1,0,3,3,9,1728,0,47.4579,-122.443,1720,35735,97678,37455,1728,7,7
2,1,960,28717,1,0,0,4,6,960,0,47.3356,-122.502,1860,28717,29677,30577,960,35,35
4,3,2580,9601,2,0,0,4,7,2130,450,47.3726,-122.433,1900,10092,12181,11992,2580,27,27
3,2.5,2260,251460,1,0,0,3,10,2260,0,47.4096,-122.449,1610,244372,253720,245982,2260,24,24
3,2.5,2960,69351,2,1,3,4,9,2960,0,47.4,-122.42,2350,41433,72311,43783,2960,29,29
3,2,1400,45738,2,0,0,4,8,1400,0,47.3624,-122.455,2390,56628,47138,59018,1400,38,38
3,1.5,1400,14850,1,0,0,4,7,1400,0,47.4471,-122.464,1350,14850,16250,16200,1400,109,109
2,1.75,1550,7764,1,1,4,4,8,1550,0,47.358,-122.446,1690,11620,9314,13310,1550,54,28
5,2,2120,137565,1,0,0,3,7,2120,0,47.4558,-122.507,2120,157123,139685,159243,2120,106,106
2,1,990,45528,1,0,0,4,7,990,0,47.5013,-122.463,1730,45528,46518,47258,990,27,27
3,1.75,2130,5489,1,0,0,3,8,1370,760,47.4489,-122.456,1750,7200,7619,8950,2130,20,20
2,2,1440,213008,2,0,0,4,7,1440,0,47.3604,-122.457,1630,161172,214448,162802,1440,29,29
2,2.25,1730,31491,2,1,2,4,7,1730,0,47.373,-122.464,1400,12410,33221,13810,1730,72,26
3,2.5,3490,28213,1,0,2,3,9,2242,1248,47.365,-122.456,2120,56628,31703,58748,3490,10,10
2,0.75,440,8313,1,1,3,4,5,440,0,47.4339,-122.512,880,26289,8753,27169,440,76,76
3,1,1290,12415,1,0,0,3,6,1290,0,47.3719,-122.461,1620,12415,13705,14035,1290,111,111
3,3.25,3786,38038,1,1,4,3,9,1934,1852,47.3907,-122.448,2850,33361,41824,36211,3786,41,8
3,2.75,2830,505166,1,1,3,4,8,1830,1000,47.3782,-122.514,2120,21988,507996,24108,2830,57,57
4,1,1200,11834,1,1,3,3,6,1200,0,47.4557,-122.443,1670,47462,13034,49132,1200,47,47
2,1,1120,9912,1,0,0,4,6,1120,0,47.3735,-122.43,1540,9750,11032,11290,1120,39,39
2,2,2280,641203,2,0,0,3,9,2280,0,47.4125,-122.455,2030,224334,643483,226364,2280,29,29
3,2,2080,12972,1,0,0,4,7,1250,830,47.3733,-122.432,1530,10089,15052,11619,2080,38,38
4,2,2280,39848,2,0,0,4,8,2280,0,47.5003,-122.465,1900,38472,42128,40372,2280,28,28
4,3.5,3400,234352,2,0,0,3,8,2500,900,47.4335,-122.449,1300,39639,237752,40939,3400,28,28
3,2,2410,50654,1,0,0,3,7,2410,0,47.4154,-122.458,1900,36300,53064,38200,2410,24,24
3,2.5,2030,217805,1,0,0,3,9,2030,0,47.3942,-122.515,1870,109468,219835,111338,2030,20,20
2,1.5,1995,115670,1,0,1,4,8,1995,0,47.4022,-122.464,2142,29375,117665,31517,1995,28,28
3,2.5,2010,14298,2,0,0,3,7,2010,0,47.5069,-122.472,2010,14298,16308,16308,2010,42,42
4,2.75,2300,37533,1,0,3,5,8,1550,750,47.3714,-122.431,2130,10092,39833,12222,2300,40,40
4,3.25,1946,17786,2,0,1,4,7,1946,0,47.359,-122.452,1460,16661,19732,18121,1946,29,29
3,1.75,1444,249126,1,0,0,3,7,1444,0,47.4104,-122.486,1760,224770,250570,226530,1444,11,11
4,3.5,2490,18042,2,0,0,3,8,2490,0,47.4161,-122.441,1960,21107,20532,23067,2490,16,16
2,1,1240,27042,1,0,1,3,6,1000,240,47.5026,-122.465,2140,20059,28282,22199,1240,76,76
3,3,1970,20978,2,1,3,4,9,1770,200,47.3844,-122.438,2280,75396,22948,77676,1970,39,39
2,1,830,26329,1,1,3,4,6,830,0,47.4012,-122.425,2030,27338,27159,29368,830,91,91
2,2,1651,18200,1,0,0,3,6,1651,0,47.4621,-122.461,1510,89595,19851,91105,1651,73,73
3,1.5,1150,27319,1,0,0,4,6,1150,0,47.3933,-122.454,1700,30691,28469,32391,1150,43,43
3,4.25,3300,308080,2,0,2,4,9,2520,780,47.3979,-122.416,2130,90604,311380,92734,3300,43,43
3,2.5,2753,65005,1,1,2,5,9,2165,588,47.4041,-122.451,2680,72513,67758,75193,2753,66,66
2,0.75,840,40642,1,1,4,4,6,840,0,47.404,-122.447,1850,64069,41482,65919,840,82,82
1,0.75,760,10079,1,1,4,5,5,760,0,47.4683,-122.438,1230,14267,10839,15497,760,83,83
3,1.75,1726,197326,2,0,0,4,7,1726,0,47.3484,-122.505,2114,99316,199052,101430,1726,37,37
4,1.75,1275,20000,1,0,0,4,6,1275,0,47.3796,-122.49,1660,20000,21275,21660,1275,28,28
3,2.75,1820,52889,2,0,0,3,8,1820,0,47.501,-122.463,1820,45528,54709,47348,1820,28,28
2,1,833,143947,1,0,0,3,5,833,0,47.3889,-122.482,1380,143947,144780,145327,833,13,13
3,1.75,2240,78225,2,0,0,5,8,2240,0,47.4638,-122.484,2030,202554,80465,204584,2240,43,43
2,1,2034,13392,1,1,4,5,7,1159,875,47.3312,-122.503,1156,15961,15426,17117,2034,72,72
3,1.75,1860,48076,1,0,0,4,8,1860,0,47.5051,-122.461,1410,23066,49936,24476,1860,90,90
3,2.5,1656,108900,1,0,0,4,7,1656,0,47.3758,-122.425,2030,29859,110556,31889,1656,34,34
2,2.25,2320,18919,2,1,4,4,8,2320,0,47.3905,-122.462,1610,18919,21239,20529,2320,43,43
4,1.75,2470,131790,2,0,2,3,8,2470,0,47.4421,-122.444,1470,92747,134260,94217,2470,82,82
3,1.75,1640,53400,1,0,0,4,7,1640,0,47.3944,-122.506,1850,380279,55040,382129,1640,53,53
2,1,1300,39639,1,0,0,4,6,1300,0,47.466,-122.452,1880,98881,40939,100761,1300,59,59
4,2.5,2780,35000,1,0,0,4,9,2780,0,47.7386,-122.091,2740,35072,37780,37812,2780,34,34
4,2.5,2120,57050,2,0,0,3,9,2120,0,47.7611,-122.128,3320,39082,59170,42402,2120,30,30
4,2.25,2490,23478,2,0,0,3,8,2490,0,47.7547,-122.094,2030,12611,25968,14641,2490,38,38
4,2.5,2601,34335,2,0,0,3,9,2601,0,47.742,-122.087,2080,32336,36936,34416,2601,24,24
3,1,1300,12600,1,0,0,4,7,1300,0,47.7422,-122.1,1480,13530,13900,15010,1300,50,50
5,3.25,2950,67475,1,0,0,3,8,2530,420,47.7233,-122.117,2620,39820,70425,42440,2950,38,11
4,1.75,1910,8117,1,0,0,3,7,1460,450,47.7344,-122.173,1810,8100,10027,9910,1910,44,44
4,3,3740,30884,2,0,0,3,9,3060,680,47.7505,-122.117,3240,37031,34624,40271,3740,31,31
4,2.5,2960,41656,2,0,0,3,10,2960,0,47.7319,-122.132,3900,35104,44616,39004,2960,34,34
4,2.25,2600,28600,1,0,0,3,8,1810,790,47.7757,-122.139,2580,26950,31200,29530,2600,51,51
5,3,2200,103237,1,0,0,3,7,1160,1040,47.7726,-122.111,2300,103237,105437,105537,2200,48,48
4,2.5,2700,37431,1,0,0,4,8,1600,1100,47.7258,-122.117,2290,37431,40131,39721,2700,41,41
4,3,3370,47959,2,0,0,4,10,3370,0,47.733,-122.129,3370,38896,51329,42266,3370,38,38
3,2,1760,6875,1,0,0,4,8,1760,0,47.74,-122.093,1670,13650,8635,15320,1760,52,52
4,2.5,3530,49222,2,0,0,4,9,3530,0,47.7285,-122.112,3750,49222,52752,52972,3530,33,33
3,2.5,1480,3851,2,0,0,3,8,1480,0,47.7732,-122.163,1650,4716,5331,6366,1480,21,21
3,2.25,1900,46609,1,0,0,4,7,1440,460,47.7529,-122.116,2460,43560,48509,46020,1900,50,50
3,2.5,2560,35265,2,0,0,3,9,2560,0,47.7354,-122.095,2820,35496,37825,38316,2560,38,38
5,2.5,4470,35124,2,0,0,3,11,4470,0,47.7377,-122.084,4050,34118,39594,38168,4470,35,35
4,2.75,1960,48787,1,0,0,4,9,1960,0,47.7484,-122.111,1970,36425,50747,38395,1960,36,36
3,1.75,2300,35722,1,0,0,3,9,2300,0,47.7455,-122.112,2600,34798,38022,37398,2300,35,35
3,1.75,1000,14061,1,0,0,4,7,1000,0,47.7417,-122.093,1260,12635,15061,13895,1000,52,52
3,1,1250,9786,1,0,0,4,7,1250,0,47.7622,-122.163,1660,9621,11036,11281,1250,50,50
3,2.5,2510,47044,1,0,0,4,7,1910,600,47.7531,-122.14,2510,42803,49554,45313,2510,44,44
4,2.75,1930,13041,1,0,0,4,8,1180,750,47.7502,-122.085,1880,10234,14971,12114,1930,39,39
5,4,5610,22529,2,0,0,3,11,4090,1520,47.7239,-122.092,3860,24751,28139,28611,5610,23,23
4,3.25,2400,29252,2,0,0,4,8,2400,0,47.743,-122.131,2280,45000,31652,47280,2400,37,37
4,2.75,2560,83200,1,0,0,3,8,1860,700,47.7511,-122.111,1990,38332,85760,40322,2560,39,39
4,2.5,3220,35400,2,0,0,3,9,3220,0,47.7547,-122.114,3050,35252,38620,38302,3220,28,28
4,2.5,2390,38258,2,0,0,3,8,2390,0,47.7433,-122.094,1960,17113,40648,19073,2390,18,18
3,1.75,1630,28600,1,0,0,3,8,1630,0,47.7742,-122.14,2260,26000,30230,28260,1630,52,52
5,2.75,3320,23760,2,0,0,4,8,2190,1130,47.7498,-122.146,2520,36720,27080,39240,3320,44,44
3,1,960,9531,1,0,0,5,7,960,0,47.7619,-122.162,1670,9250,10491,10920,960,50,50
3,2.25,1600,45613,2,0,0,4,8,1600,0,47.7523,-122.117,2320,43005,47213,45325,1600,36,36
4,1.75,1870,16549,1,0,0,3,8,1870,0,47.7482,-122.083,1870,10804,18419,12674,1870,50,50
3,1,1250,20040,1,0,0,3,7,1250,0,47.7514,-122.108,1640,19840,21290,21480,1250,49,49
3,2.25,1850,12000,1,0,0,4,7,1300,550,47.7408,-122.101,1580,12616,13850,14196,1850,42,42
3,2.25,1790,10209,1,0,0,3,7,1290,500,47.7492,-122.086,1840,9900,11999,11740,1790,52,52
4,2.5,2810,7549,2,0,0,3,9,2810,0,47.7441,-122.173,2750,7642,10359,10392,2810,27,27
3,1.75,1600,9579,1,0,0,3,8,1180,420,47.7662,-122.159,1750,9829,11179,11579,1600,42,42
4,1.75,2440,16730,1,0,0,3,7,1390,1050,47.7406,-122.11,1390,11600,19170,12990,2440,43,43
3,1.75,1910,12596,1,0,0,3,7,1340,570,47.7399,-122.099,1550,13310,14506,14860,1910,42,42
3,1.75,1930,7210,1,0,0,3,7,1110,820,47.735,-122.174,1870,7877,9140,9747,1930,44,44
3,2.25,2080,111513,1,0,0,3,8,1680,400,47.7403,-122.112,2440,107157,113593,109597,2080,42,42
4,2.75,3110,35235,2,0,0,4,9,3110,0,47.7355,-122.095,2790,35445,38345,38235,3110,36,36
3,2.5,2970,23100,1,0,0,3,7,1510,1460,47.7735,-122.133,2390,20300,26070,22690,2970,52,52
3,1.75,1790,15142,1,0,0,3,7,1360,430,47.7362,-122.172,1910,7500,16932,9410,1790,43,43
3,2,1410,9600,1,0,0,4,7,1410,0,47.7591,-122.146,1410,9600,11010,11010,1410,36,36
3,2.5,1580,5725,2,0,0,3,7,1580,0,47.7611,-122.161,1510,5725,7305,7235,1580,15,15
4,2.75,2730,35075,1,0,0,3,8,1530,1200,47.7726,-122.139,2310,35000,37805,37310,2730,40,40
4,2.5,2280,27441,2,0,0,3,8,2280,0,47.7628,-122.123,2350,35020,29721,37370,2280,23,23
3,2.5,2850,36585,2,0,0,3,10,2850,0,47.7376,-122.102,3340,35671,39435,39011,2850,32,32
3,2.25,2080,70567,2,0,0,3,8,2080,0,47.7221,-122.124,3730,43560,72647,47290,2080,29,29
3,2.75,2440,76531,1,0,0,3,10,1640,800,47.7672,-122.161,1890,10042,78971,11932,2440,39,39
2,1,1840,81892,1,0,0,3,6,1840,0,47.7694,-122.124,2550,40089,83732,42639,1840,64,64
2,2,1440,15000,1,0,0,3,7,1440,0,47.7648,-122.159,1780,15000,16440,16780,1440,34,34
3,2.5,2500,7394,2,0,0,3,9,2500,0,47.7441,-122.173,2790,7642,9894,10432,2500,29,29
3,1.5,1730,40250,2,0,0,4,8,1730,0,47.7499,-122.111,1730,36250,41980,37980,1730,36,36
3,2.5,2320,98445,1,0,0,4,8,1380,940,47.7323,-122.116,2830,54014,100765,56844,2320,41,41
3,1,1070,10563,1,0,0,3,7,1070,0,47.7687,-122.166,1840,9638,11633,11478,1070,50,50
4,2.25,3310,127631,2,0,0,5,9,3310,0,47.732,-122.134,3830,43959,130941,47789,3310,95,58
3,1.75,1920,9102,1,0,0,3,7,1920,0,47.7487,-122.082,1920,9760,11022,11680,1920,51,51
2,1.5,1370,159865,1,0,0,3,7,1370,0,47.7592,-122.092,1370,16217,161235,17587,1370,59,59
4,2.5,3020,6068,2,0,0,3,9,3020,0,47.773,-122.16,3240,5757,9088,8997,3020,13,13
3,1,900,9600,1,0,0,4,7,900,0,47.7423,-122.173,1220,8240,10500,9460,900,49,49
3,2.5,2670,47480,2,0,3,3,9,2670,0,47.7443,-122.114,2760,42800,50150,45560,2670,38,38
3,2.5,2000,3837,2,0,0,3,8,2000,0,47.7713,-122.167,2210,4075,5837,6285,2000,8,8
4,2.5,2960,28005,2,0,0,3,10,2960,0,47.7477,-122.117,3510,35248,30965,38758,2960,30,30
3,3.5,2876,5086,2,0,0,3,8,2360,516,47.7511,-122.173,2390,4419,7962,6809,2876,12,12
2,1.5,1750,46173,2,0,0,4,8,1750,0,47.7397,-122.126,2220,42224,47923,44444,1750,55,55
3,1.75,1750,16748,1,0,0,3,7,1330,420,47.7421,-122.089,1750,16050,18498,17800,1750,41,41
4,2.5,3480,59242,2,0,0,3,11,3480,0,47.7391,-122.102,2930,39400,62722,42330,3480,31,31
4,2.5,4020,44431,2,0,0,3,10,4020,0,47.7467,-122.132,3440,52900,48451,56340,4020,32,32
4,2.25,2310,36136,2,0,0,4,9,2310,0,47.7506,-122.122,3930,36136,38446,40066,2310,42,42
4,1,1020,42966,1,0,0,4,6,1020,0,47.7617,-122.11,2250,37680,43986,39930,1020,97,97
4,3,3580,35261,1,0,0,3,10,3580,0,47.7577,-122.134,3540,36750,38841,40290,3580,34,34
4,3.5,3740,41458,2,0,2,3,11,3740,0,47.7375,-122.139,3750,38325,45198,42075,3740,19,19
3,1.75,1780,9689,1,0,0,3,7,1130,650,47.7628,-122.163,1660,9786,11469,11446,1780,43,43
3,1.75,2580,40392,1,0,0,3,9,1390,1190,47.7637,-122.134,2460,46173,42972,48633,2580,33,33
3,2.5,2450,3582,2,0,0,3,9,2450,0,47.7749,-122.159,2490,5449,6032,7939,2450,11,11
3,2.5,1670,3565,2,0,0,3,7,1670,0,47.7623,-122.161,1510,3770,5235,5280,1670,20,20
4,2.5,2320,12042,1,0,0,4,7,1320,1000,47.763,-122.16,2160,7054,14362,9214,2320,44,44
5,3.5,3760,4857,2,0,3,3,9,2820,940,47.7398,-122.167,3000,5693,8617,8693,3760,15,15
3,2.25,1870,7200,1,0,0,3,7,1390,480,47.734,-122.174,1830,7876,9070,9706,1870,44,44
3,2.75,2550,54014,2,0,0,4,8,1980,570,47.7596,-122.117,2180,21600,56564,23780,2550,52,52
4,2.25,2510,9800,2,0,0,3,9,2510,0,47.753,-122.145,2440,11000,12310,13440,2510,41,41
4,3.25,4100,241322,2,0,0,3,9,2500,1600,47.7302,-122.096,3770,87821,245422,91591,4100,38,38
4,2.25,2070,20280,2,0,0,4,7,2070,0,47.774,-122.134,2190,21560,22350,23750,2070,51,51
3,1,1030,9834,1,0,0,3,7,1030,0,47.7676,-122.164,1210,9875,10864,11085,1030,50,50
3,1,1250,17380,1,0,0,4,7,1250,0,47.7502,-122.108,1410,18200,18630,19610,1250,49,49
4,2.5,3720,35000,2,0,0,3,10,3720,0,47.7582,-122.13,3720,35000,38720,38720,3720,36,36
4,1.75,1790,45738,1,0,0,3,8,1410,380,47.7453,-122.129,1870,47480,47528,49350,1790,43,43
3,1.75,1930,36210,1,0,0,3,8,1930,0,47.7692,-122.128,1930,35060,38140,36990,1930,42,42
5,3.25,4410,35192,2,0,2,3,12,3880,530,47.7522,-122.13,4410,59677,39602,64087,4410,29,29
4,2,2970,52567,2,0,0,3,8,2970,0,47.7333,-122.128,3280,46676,55537,49956,2970,95,29
3,1.75,1530,26642,1,0,0,3,7,1180,350,47.7422,-122.097,1550,13566,28172,15116,1530,31,31
3,1.75,2120,9350,1,0,0,3,7,1280,840,47.7562,-122.145,2200,9000,11470,11200,2120,40,40
3,2.25,1770,8000,1,0,0,4,7,1350,420,47.7358,-122.17,1850,7875,9770,9725,1770,43,43
3,2.5,3450,48787,2,0,0,3,10,3450,0,47.739,-122.129,2810,41040,52237,43850,3450,32,32
3,1,1290,8974,1,0,0,5,7,1290,0,47.74,-122.173,1540,7500,10264,9040,1290,43,43
4,2.25,2170,8050,1,0,0,3,7,1220,950,47.7354,-122.174,1820,7700,10220,9520,2170,43,43
3,1,1360,73616,1,0,0,3,7,1360,0,47.7528,-122.119,2040,50965,74976,53005,1360,48,48
4,3,2740,2811,2,0,0,3,8,2240,500,47.7738,-122.158,2740,3596,5551,6336,2740,16,16
3,1.75,1880,45738,1,0,0,4,8,1410,470,47.7662,-122.114,2340,38556,47618,40896,1880,39,39
4,2.25,2850,7453,2,0,0,3,9,2850,0,47.7439,-122.174,2700,8468,10303,11168,2850,28,28
3,1,1150,12402,1,0,0,4,6,1150,0,47.7422,-122.099,1400,13600,13552,15000,1150,50,50
3,3.25,3130,28001,1,0,0,3,9,2210,920,47.7741,-122.122,2710,34999,31131,37709,3130,34,34
3,2.5,2410,64073,1,0,0,4,8,1820,590,47.7457,-122.141,2980,48760,66483,51740,2410,43,43
2,1,1680,9250,1,0,0,3,7,860,820,47.7618,-122.162,1590,9542,10930,11132,1680,50,50
3,1.75,1520,7252,1,0,0,3,7,1140,380,47.7358,-122.175,1910,7820,8772,9730,1520,44,44
3,1,1200,16000,1,0,0,3,7,1200,0,47.7452,-122.101,1960,15500,17200,17460,1200,49,49
3,2.5,2830,6536,2,0,0,3,9,2830,0,47.7462,-122.172,2710,6954,9366,9664,2830,30,30
3,1.75,2300,16474,1,0,0,3,7,1220,1080,47.7609,-122.144,1940,15601,18774,17541,2300,35,35
4,1,1430,8400,1,0,0,3,6,730,700,47.7417,-122.172,1310,8240,9830,9550,1430,50,50
3,3.5,2690,104544,2,0,0,3,8,2690,0,47.7717,-122.112,2300,81698,107234,83998,2690,71,24
3,1.75,1820,8400,1,0,0,3,7,1340,480,47.734,-122.17,1900,8112,10220,10012,1820,43,43
3,2.5,1860,43170,2,0,0,3,8,1860,0,47.7712,-122.136,2270,40835,45030,43105,1860,33,33
3,1.75,1290,10117,1,0,0,3,7,1290,0,47.7598,-122.146,1770,11839,11407,13609,1290,35,35
5,2.75,2970,36817,2,0,0,4,8,2970,0,47.7731,-122.139,2730,29150,39787,31880,2970,41,41
3,1.75,1970,7100,1,0,0,3,7,1590,380,47.7353,-122.172,1790,7455,9070,9245,1970,43,43
3,2,2130,35169,1,0,0,4,8,2130,0,47.7489,-122.123,2860,43560,37299,46420,2130,30,30
3,2.5,1990,7397,2,0,0,3,9,1990,0,47.7703,-122.165,2210,7397,9387,9607,1990,26,26
4,2.25,1910,8400,2,0,0,3,7,1910,0,47.7352,-122.175,1910,8400,10310,10310,1910,44,44
3,2.5,2610,35000,2,0,0,3,10,2610,0,47.7377,-122.101,3060,35427,37610,38487,2610,31,31
4,2.5,2630,6100,2,0,0,3,8,2630,0,47.7735,-122.167,2360,5765,8730,8125,2630,15,15
3,1.75,2930,19876,1,0,0,3,9,2030,900,47.7443,-122.17,2740,11499,22806,14239,2930,26,26
3,2.5,1630,15200,1,0,0,3,7,1120,510,47.7454,-122.103,2050,15200,16830,17250,1630,31,31
3,2.5,1800,3074,2,0,0,3,7,1800,0,47.7631,-122.149,1610,2929,4874,4539,1800,16,16
3,2.75,2930,5569,1,0,0,3,9,1860,1070,47.7648,-122.164,2580,11045,8499,13625,2930,15,15
3,3.25,2990,189852,2,0,0,4,10,2990,0,47.746,-122.138,3500,48760,192842,52260,2990,45,45
4,2.25,1780,2684,2,0,0,3,7,1780,0,47.7642,-122.149,1670,2426,4464,4096,1780,17,17
3,3,2540,18900,1,0,0,3,7,1580,960,47.754,-122.144,2270,16000,21440,18270,2540,41,41
3,2.25,1790,5794,1,0,0,3,7,1380,410,47.7477,-122.171,2140,7769,7584,9909,1790,34,34
5,3.25,5600,107157,2,0,0,3,10,3440,2160,47.7341,-122.102,3470,75794,112757,79264,5600,31,31
4,2.75,2630,15000,1,0,0,4,7,1690,940,47.7425,-122.089,1800,16500,17630,18300,2630,43,43
3,2.5,4930,77536,2,0,0,3,9,3930,1000,47.7634,-122.139,2760,7351,82466,10111,4930,38,38
3,1.75,1500,13430,1,0,0,3,7,1500,0,47.7527,-122.082,1500,13430,14930,14930,1500,42,42
5,2.25,2500,13500,1,0,0,3,7,1850,650,47.7564,-122.144,2300,9750,16000,12050,2500,40,40
4,2.5,2550,6256,2,0,0,3,9,2550,0,47.7742,-122.166,2460,8256,8806,10716,2550,27,27
3,2.25,2770,57745,2,0,0,3,8,2770,0,47.775,-122.124,2720,46765,60515,49485,2770,34,34
3,2.5,2700,7434,2,0,0,3,9,2700,0,47.7434,-122.174,2660,8405,10134,11065,2700,28,28
1,2.25,2140,10350,1,0,0,3,7,1470,670,47.7352,-122.17,1980,8400,12490,10380,2140,43,43
4,2.5,2180,11200,1,0,0,4,8,2180,0,47.7476,-122.086,1790,11200,13380,12990,2180,51,51
4,4.25,5860,52889,2,0,0,4,10,4910,950,47.7245,-122.095,3320,39066,58749,42386,5860,23,23
4,3.25,3400,99170,1,0,0,4,8,2000,1400,47.7293,-122.099,3460,47920,102570,51380,3400,39,39
2,1.75,1060,16470,1,0,0,3,7,1060,0,47.7409,-122.089,1790,16748,17530,18538,1060,42,42
3,2.5,3780,35273,1,0,0,3,10,3780,0,47.7499,-122.119,3450,35273,39053,38723,3780,33,33
3,1.5,1240,9196,1,0,0,3,8,1240,0,47.7562,-122.094,1690,10800,10436,12490,1240,51,51
4,2.5,2660,40312,2,0,0,4,8,2660,0,47.7532,-122.139,2650,45302,42972,47952,2660,42,42
3,2.5,1940,10035,2,0,0,4,8,1940,0,47.7438,-122.172,2810,8333,11975,11143,1940,25,25
4,2.25,1780,10748,2,0,0,4,8,1780,0,47.762,-122.11,2070,37680,12528,39750,1780,55,55
4,2.75,2730,6856,2,0,0,3,8,2730,0,47.7739,-122.164,2520,5569,9586,8089,2730,16,16
4,1.75,1640,13566,1,0,0,4,7,1120,520,47.7423,-122.099,1470,13530,15206,15000,1640,42,42
3,1.75,2220,17568,1,0,0,4,8,2220,0,47.749,-122.083,2070,11745,19788,13815,2220,52,52
3,2.5,2060,11231,2,0,0,3,8,2060,0,47.7571,-122.141,2140,10224,13291,12364,2060,32,32
3,2.5,2970,23100,1,0,0,3,7,1510,1460,47.7735,-122.133,2390,20300,26070,22690,2970,52,52
3,1,1280,9630,1,0,0,3,7,1280,0,47.7677,-122.163,1300,9453,10910,10753,1280,51,51
4,1,1140,7208,1,0,0,3,7,900,240,47.742,-122.173,1300,7991,8348,9291,1140,49,49
4,2.5,2280,9725,2,0,0,3,8,2280,0,47.7568,-122.141,2140,8780,12005,10920,2280,33,33
4,3,3180,80837,2,0,0,3,11,3180,0,47.7336,-122.134,3180,38715,84017,41895,3180,34,34
4,2,1980,23625,2,0,0,3,8,1980,0,47.7553,-122.092,2300,24640,25605,26940,1980,81,30
3,2.5,1940,5660,2,0,0,3,8,1940,0,47.7511,-122.17,2110,4581,7600,6691,1940,18,18
4,3.5,4170,4524,2,0,0,3,9,3500,670,47.7726,-122.162,3510,5001,8694,8511,4170,12,12
3,2.25,2670,150270,2,0,0,3,9,2670,0,47.7601,-122.134,3080,81054,152940,84134,2670,34,34
3,1.75,2020,8970,1,0,0,4,7,1180,840,47.7571,-122.145,2140,8008,10990,10148,2020,38,38
4,2.5,3030,30000,2,0,0,4,9,3030,0,47.7468,-122.112,2600,34932,33030,37532,3030,38,38
3,1,1200,9800,1,0,0,4,7,1200,0,47.7412,-122.109,1220,10220,11000,11440,1200,48,48
4,2.25,2640,8800,1,0,0,3,8,1620,1020,47.7552,-122.148,2500,11700,11440,14200,2640,39,39
4,2.25,1960,14834,1,0,0,4,8,1330,630,47.7434,-122.095,1540,15000,16794,16540,1960,43,43
4,3.75,3820,53574,1,0,0,3,10,3820,0,47.7337,-122.121,3140,54014,57394,57154,3820,25,25
3,2.5,2050,4876,2,0,0,3,8,2050,0,47.7746,-122.158,2320,4065,6926,6385,2050,14,14
3,2.5,1800,11034,2,0,0,4,8,1800,0,47.7558,-122.142,1940,8900,12834,10840,1800,32,32
4,2.5,3160,16564,2,0,0,3,10,3160,0,47.6365,-122.04,3160,12415,19724,15575,3160,32,32
3,2,1430,7125,1,0,0,4,7,1430,0,47.6256,-122.059,1570,8075,8555,9645,1430,35,35
4,3.75,3980,7828,2,0,0,3,10,3980,0,47.6303,-122.065,3980,8910,11808,12890,3980,18,18
3,1.75,2330,14892,1,0,0,3,8,1970,360,47.6267,-122.046,2570,14217,17222,16787,2330,39,39
4,3.25,3850,19842,2,0,3,3,11,3180,670,47.6239,-122.065,4320,19500,23692,23820,3850,30,30
4,2.25,2180,7297,2,0,0,3,8,2180,0,47.6459,-122.058,2250,9781,9477,12031,2180,35,35
2,1.75,1270,7500,1,0,0,4,7,1270,0,47.6186,-122.063,1280,7500,8770,8780,1270,37,37
5,2.75,3210,8001,2,0,0,3,9,3210,0,47.5935,-122.061,3190,6624,11211,9814,3210,5,5
4,3.5,4910,9444,1,0,0,3,11,3110,1800,47.6502,-122.066,4560,11063,14354,15623,4910,12,12
3,2.25,1570,6810,1,0,0,3,8,1180,390,47.6176,-122.044,1620,6584,8380,8204,1570,31,31
3,2.25,1520,14080,2,0,0,3,7,1520,0,47.6273,-122.059,1530,9758,15600,11288,1520,35,35
4,2.25,2130,11900,2,0,0,3,9,2130,0,47.6408,-122.058,2590,11900,14030,14490,2130,43,43
4,2.25,2240,8376,1,0,0,3,8,1740,500,47.6323,-122.029,1890,7875,10616,9765,2240,35,35
3,1.75,1440,11787,1,0,0,3,8,1440,0,47.6276,-122.033,2190,11787,13227,13977,1440,36,36
4,2.5,2340,8955,2,0,0,3,9,2340,0,47.6283,-122.026,2340,8955,11295,11295,2340,29,29
4,3.5,3270,15704,2,0,0,3,9,2110,1160,47.6256,-122.042,3020,8582,18974,11602,3270,29,29
3,2.5,1910,11550,1,0,0,3,8,1910,0,47.6213,-122.064,2230,11550,13460,13780,1910,16,16
4,2.5,2040,7412,2,0,0,3,8,2040,0,47.6347,-122.026,2050,7830,9452,9880,2040,31,31
4,2.5,3330,8897,2,0,0,3,10,3330,0,47.6484,-122.08,3150,7515,12227,10665,3330,18,18
3,2.25,1450,19206,2,0,0,3,7,1450,0,47.62,-122.052,1710,21485,20656,23195,1450,30,30
4,2.5,2990,5400,2,0,0,3,8,2990,0,47.6122,-122.009,2890,6538,8390,9428,2990,14,14
3,2.25,1960,10139,2,0,0,3,8,1960,0,47.6481,-122.061,2080,9753,12099,11833,1960,35,35
3,2.5,2600,10092,1,0,0,3,9,2600,0,47.6223,-122.032,2440,9298,12692,11738,2600,35,35
5,3.5,4510,16305,2,0,0,3,10,2820,1690,47.6346,-122.011,4330,18741,20815,23071,4510,16,16
4,2.5,2620,5450,2,0,0,3,9,2620,0,47.6301,-122.019,2590,5371,8070,7961,2620,18,18
4,2.5,2640,4200,2,0,0,3,8,2640,0,47.6038,-122.02,2460,4200,6840,6660,2640,21,21
3,1.75,1470,6018,1,0,0,3,8,1470,0,47.6171,-122.044,1720,6584,7488,8304,1470,32,32
3,2.5,4560,17622,2,0,0,4,9,3800,760,47.621,-122.03,2360,15000,22182,17360,4560,33,33
4,2.25,2170,7737,2,0,0,3,8,2170,0,47.637,-122.029,1850,8869,9907,10719,2170,32,32
4,2.5,2290,11072,2,0,0,3,9,2290,0,47.6283,-122.03,2340,9774,13362,12114,2290,33,33
3,2.5,1830,8022,2,0,0,3,8,1830,0,47.6198,-122.044,2030,7736,9852,9766,1830,32,32
4,2.5,2720,10000,2,0,0,3,10,2720,0,47.6293,-122.051,2720,10020,12720,12740,2720,32,32
4,1.75,2660,11315,2,0,0,4,8,2660,0,47.6204,-122.044,1980,11315,13975,13295,2660,36,36
4,2.75,3390,6298,2,0,0,3,9,3390,0,47.5906,-122.062,3390,7111,9688,10501,3390,8,8
3,2.25,2100,7335,2,0,0,3,8,2100,0,47.647,-122.061,2050,8930,9435,10980,2100,36,36
3,2.5,2390,8315,2,0,0,4,9,2390,0,47.6271,-122.028,2370,7816,10705,10186,2390,29,29
3,1.5,1930,11092,1,0,0,3,7,1500,430,47.634,-122.033,1230,10964,13022,12194,1930,36,36
3,1.75,1540,9154,1,0,0,3,8,1540,0,47.6207,-122.042,1990,10273,10694,12263,1540,36,36
4,2.5,2310,5526,2,0,0,3,9,2310,0,47.6299,-122.02,2500,5769,7836,8269,2310,16,16
4,2.5,2740,11975,2,0,0,4,8,2740,0,47.6315,-122.028,2310,9068,14715,11378,2740,28,28
4,2.5,2210,9875,2,0,0,3,9,2210,0,47.6285,-122.025,2440,8799,12085,11239,2210,29,29
5,3.25,3360,6120,2,0,0,3,9,3360,0,47.607,-122.053,3230,5398,9480,8628,3360,5,5
4,2.5,1850,11250,1,0,0,3,7,1210,640,47.6264,-122.062,1650,7623,13100,9273,1850,38,38
4,3.25,3270,6027,2,0,0,3,10,3270,0,47.6346,-122.063,3270,6546,9297,9816,3270,18,18
5,4.5,4140,7924,2,0,0,3,10,4140,0,47.6102,-121.993,3960,8410,12064,12370,4140,14,14
4,2.5,2300,7989,2,0,0,3,9,2300,0,47.6273,-122.034,2280,8835,10289,11115,2300,29,29
2,3,2770,10800,1,0,0,5,8,1910,860,47.6082,-122.057,2140,10800,13570,12940,2770,35,35
3,2.5,2690,17461,2,0,3,3,10,2690,0,47.654,-122.088,3610,16887,20151,20497,2690,22,22
3,1.75,2420,65501,2,0,1,3,8,2420,0,47.6525,-122.087,2970,19036,67921,22006,2420,35,35
4,2.5,2570,5520,2,0,0,3,9,2570,0,47.6145,-122.027,2470,5669,8090,8139,2570,19,19
4,3,3040,36246,1,0,0,3,9,2680,360,47.6093,-122.07,3520,13178,39286,16698,3040,96,0
3,2,1680,8080,1,0,0,3,8,1680,0,47.6168,-122.045,1800,7503,9760,9303,1680,32,32
3,2.5,2250,19270,2,0,0,3,8,2250,0,47.6569,-122.088,2940,19541,21520,22481,2250,20,20
4,2.5,2490,12929,2,0,0,3,9,2490,0,47.6161,-122.021,2440,12929,15419,15369,2490,36,36
3,3.5,2150,4368,2,0,0,3,8,1610,540,47.6213,-122.065,2390,16630,6518,19020,2150,21,21
4,2.5,2740,10533,2,0,0,3,9,2740,0,47.6095,-122.006,2760,8603,13273,11363,2740,22,22
3,2.25,1620,12309,2,0,0,3,7,1620,0,47.6188,-122.029,2030,13963,13929,15993,1620,32,32
4,2.5,2710,5500,2,0,0,3,9,2710,0,47.6027,-122.023,2710,6242,8210,8952,2710,20,20
3,2.5,2390,4555,2,0,0,3,9,2390,0,47.6199,-122.025,2540,4500,6945,7040,2390,13,13
4,2.75,2520,12500,2,0,0,3,8,1720,800,47.6225,-122.064,2520,13000,15020,15520,2520,40,40
3,2,2070,10023,1,0,0,3,8,1220,850,47.6492,-122.062,2130,9694,12093,11824,2070,38,38
3,2.25,1810,8158,1,0,0,3,8,1450,360,47.6258,-122.038,1740,9532,9968,11272,1810,35,35
3,2.5,2160,7500,1,0,1,3,7,1430,730,47.6188,-122.064,1560,7500,9660,9060,2160,40,40
1,0.75,530,33278,1,0,2,4,4,530,0,47.6412,-122.079,2830,14311,33808,17141,530,69,69
3,2.25,1440,15661,1,0,0,3,8,1180,260,47.6225,-122.038,1440,13963,17101,15403,1440,31,31
4,2.5,3650,7090,2,0,0,3,10,3650,0,47.606,-122.052,3860,7272,10740,11132,3650,11,11
3,2.75,2590,223027,2,0,0,3,9,2590,0,47.6145,-122.001,3410,212137,225617,215547,2590,36,36
4,3.5,4360,24603,2,0,0,3,12,4360,0,47.6035,-122.005,4770,27521,28963,32291,4360,21,21
3,1.5,1090,9862,1,0,0,3,8,1090,0,47.6256,-122.036,1710,9862,10952,11572,1090,32,32
3,4.25,3840,9751,2,0,0,3,10,3840,0,47.6347,-122.064,3230,7189,13591,10419,3840,21,21
2,2.5,1620,14467,2,0,0,3,7,1620,0,47.6306,-122.035,1470,13615,16087,15085,1620,38,38
4,2.25,3140,12150,2,0,0,3,9,3140,0,47.6361,-122.047,2370,12054,15290,14424,3140,40,40
3,2,1230,11413,1,0,0,3,7,990,240,47.6321,-122.034,1570,11517,12643,13087,1230,35,35
4,2.5,2900,5505,2,0,0,3,8,2900,0,47.6063,-122.02,2970,5251,8405,8221,2900,17,17
4,2.5,3220,14463,2,0,0,3,8,3220,0,47.6261,-122.047,2550,12109,17683,14659,3220,41,41
5,2.5,3470,12003,2,0,0,3,8,3470,0,47.624,-122.048,2220,12283,15473,14503,3470,41,41
3,3.25,3230,7639,2,0,0,3,10,3230,0,47.6338,-122.063,3230,7772,10869,11002,3230,20,20
4,2.5,2230,14694,1,0,0,4,7,1180,1050,47.6305,-122.034,1470,13458,16924,14928,2230,38,38
4,3.5,2770,8049,2,0,0,3,9,2770,0,47.6469,-122.081,3410,7447,10819,10857,2770,17,17
3,1.75,1740,10000,1,0,0,3,7,1740,0,47.617,-122.058,1350,7500,11740,8850,1740,43,5
4,3.5,4210,9414,2,0,0,3,9,4210,0,47.6067,-122.022,3950,8880,13624,12830,4210,18,18
3,2.25,2180,7741,2,0,0,3,9,2180,0,47.6482,-122.072,2300,8581,9921,10881,2180,33,33
4,2.5,3030,6813,2,0,0,3,9,3030,0,47.6296,-122.029,2310,8682,9843,10992,3030,32,32
3,1.75,1370,9680,1,0,0,4,7,1370,0,47.6127,-122.045,1370,10208,11050,11578,1370,42,42
4,3.25,4190,10259,2,0,0,3,11,3150,1040,47.6332,-122.066,4300,11919,14449,16219,4190,19,19
4,2.5,2570,7980,2,0,0,3,9,2570,0,47.6378,-122.065,2760,6866,10550,9626,2570,21,21
4,3.25,3450,6184,2,0,0,3,9,3450,0,47.6072,-122.054,3020,5369,9634,8389,3450,5,5
4,2.5,3460,9699,2,0,0,3,10,3460,0,47.637,-122.04,3140,10631,13159,13771,3460,32,32
3,2.25,1710,21485,2,0,0,3,7,1710,0,47.6198,-122.053,1680,21485,23195,23165,1710,30,30
3,2,2320,65340,1,0,0,3,9,2320,0,47.6106,-122.055,3100,59603,67660,62703,2320,27,27
3,2.5,2070,4132,2,0,0,3,8,2070,0,47.6036,-122.015,1530,5606,6202,7136,2070,20,20
5,2.25,2520,11700,2,0,0,3,9,2520,0,47.6322,-122.053,2530,12000,14220,14530,2520,42,42
4,3.5,4300,108865,2,0,0,3,11,4300,0,47.6258,-122.005,4650,107498,113165,112148,4300,5,5
4,2.75,2300,12633,2,0,0,3,9,2300,0,47.6218,-122.032,2240,9246,14933,11486,2300,35,35
4,3.5,5360,25800,1,0,0,3,9,3270,2090,47.6099,-122.054,2650,21781,31160,24431,5360,48,48
4,3,3040,11651,2,0,0,3,10,3040,0,47.6348,-122.038,2540,11815,14691,14355,3040,32,32
3,2.25,2120,18255,1,0,0,3,8,1590,530,47.6279,-122.037,2120,12997,20375,15117,2120,35,35
4,2.5,2260,9696,1,0,0,3,9,2260,0,47.643,-122.066,2400,12111,11956,14511,2260,36,36
4,2.5,2970,5722,2,0,0,3,9,2970,0,47.6134,-122.042,3940,4848,8692,8788,2970,14,14
5,2.75,2830,6137,2,0,0,3,9,2830,0,47.5932,-122.058,3170,6285,8967,9455,2830,9,9
3,2.5,2280,10879,2,0,0,3,9,2280,0,47.6217,-122.034,2400,9536,13159,11936,2280,35,35
4,2.5,3250,48037,1,0,2,3,8,2030,1220,47.6326,-122.07,2970,48037,51287,51007,3250,34,34
3,2.5,2820,14250,2,0,0,3,11,2820,0,47.6396,-122.054,2820,12600,17070,15420,2820,28,28
4,2.25,2090,8579,2,0,0,3,8,2090,0,47.6364,-122.03,1850,8843,10669,10693,2090,32,32
2,1.5,1330,15873,1,0,0,3,7,900,430,47.6359,-122.033,1610,12043,17203,13653,1330,35,35
4,2.5,2440,6733,2,0,0,3,9,2440,0,47.6374,-122.064,2570,6496,9173,9066,2440,20,20
4,2.5,2790,6540,2,0,0,3,9,2790,0,47.6087,-122.016,2790,6270,9330,9060,2790,20,20
3,1.75,1300,12731,1,0,0,3,8,1300,0,47.6236,-122.04,1700,13556,14031,15256,1300,38,38
4,2.75,2050,7171,1,0,0,3,8,1540,510,47.6194,-122.042,1960,7110,9221,9070,2050,31,31
3,1.5,1140,7500,1,0,0,3,7,1140,0,47.619,-122.064,1380,7500,8640,8880,1140,43,43
3,2.5,3190,49137,2,0,0,3,9,3190,0,47.6027,-122.043,3240,53143,52327,56383,3190,31,31
3,2.5,2080,4556,2,0,0,3,8,2080,0,47.6036,-122.014,1530,5606,6636,7136,2080,20,20
4,1.75,2010,12044,1,0,0,3,9,2010,0,47.6446,-122.068,2200,11144,14054,13344,2010,37,37
5,3.25,4230,21455,2,0,0,3,10,2720,1510,47.6375,-122.015,3280,22393,25685,25673,4230,29,29
4,2.5,2350,9779,1,0,0,3,10,2350,0,47.6411,-122.065,2700,10441,12129,13141,2350,32,32
3,2.5,2830,4334,3,1,4,3,10,2830,0,47.6318,-122.071,2830,38211,7164,41041,2830,13,13
3,2.25,1570,8111,2,0,0,3,8,1570,0,47.6324,-122.028,1990,7875,9681,9865,1570,35,35
4,2.25,2210,8101,2,0,0,3,9,2210,0,47.6475,-122.07,2330,8842,10311,11172,2210,34,34
4,2.75,3488,9614,2,0,0,3,10,3488,0,47.6055,-122.013,3600,10891,13102,14491,3488,21,21
4,2.75,3630,11775,2,0,0,3,10,3630,0,47.6378,-122.066,3800,12451,15405,16251,3630,20,20
5,4.5,4350,13405,2,0,0,3,11,4350,0,47.6018,-122.06,3990,7208,17755,11198,4350,5,5
2,1,1280,12086,1,0,0,3,7,850,430,47.634,-122.033,1280,10452,13366,11732,1280,36,36
4,2.5,3210,14910,2,0,0,3,10,3210,0,47.6073,-122.062,3280,14910,18120,18190,3210,24,24
3,2.5,2810,6300,2,0,0,3,8,2810,0,47.6077,-122.02,2860,6630,9110,9490,2810,18,18
4,2.5,4120,22370,2,0,0,3,10,4120,0,47.6239,-122.023,3180,7257,26490,10437,4120,22,22
3,2,1350,10200,1,0,0,3,7,1350,0,47.6159,-122.05,1820,9600,11550,11420,1350,42,42
4,3.5,4170,4322,2,0,0,3,9,2940,1230,47.6136,-122.041,2970,4922,8492,7892,4170,14,14
4,2.5,2410,7140,2,0,0,3,8,2410,0,47.6329,-122.021,2350,7140,9550,9490,2410,26,26
3,2.5,2260,10153,2,0,0,3,10,2260,0,47.641,-122.068,2740,10153,12413,12893,2260,32,32
3,2,1010,21340,1,0,0,3,8,1010,0,47.6223,-122.043,1700,13045,22350,14745,1010,39,39
3,2.75,1620,7500,1,0,0,5,7,1140,480,47.6175,-122.065,1900,7500,9120,9400,1620,40,40
3,2,1910,5040,1,0,0,3,8,1910,0,47.6312,-122.061,1980,4275,6950,6255,1910,48,48
4,2.25,2260,11900,2,0,0,3,9,2260,0,47.6415,-122.057,2470,11900,14160,14370,2260,43,43
4,2.5,2340,8248,2,0,0,3,8,2340,0,47.6314,-122.03,2140,9963,10588,12103,2340,30,30
3,2.5,1730,4102,3,1,4,3,8,1730,0,47.645,-122.084,2340,16994,5832,19334,1730,23,23
4,2.5,2810,11120,2,0,0,3,9,2810,0,47.6337,-122.044,3100,12672,13930,15772,2810,37,37
3,3.5,3190,6776,2,0,0,3,10,3190,0,47.6348,-122.064,3230,7189,9966,10419,3190,21,21
3,2,1690,16061,1,0,0,3,7,1690,0,47.6359,-122.035,1280,12436,17751,13716,1690,35,35
4,2.25,3190,11597,2,0,0,3,10,2300,890,47.6323,-122.039,2990,10679,14787,13669,3190,35,35
3,2,2260,9568,1,0,0,3,8,1780,480,47.6457,-122.058,2250,9744,11828,11994,2260,34,34
4,2.5,3420,8405,2,0,0,3,10,3420,0,47.6328,-122.064,3230,8460,11825,11690,3420,19,19
5,2.75,3030,7679,2,0,0,3,9,3030,0,47.593,-122.057,3080,6341,10709,9421,3030,5,5
4,2.5,2740,7140,2,0,0,3,8,2740,0,47.6334,-122.021,2260,7035,9880,9295,2740,26,26
4,2.5,2650,11108,2,0,0,3,10,2650,0,47.6304,-122.051,2650,11585,13758,14235,2650,32,32
3,2,2070,9195,1,0,0,3,8,1220,850,47.6491,-122.061,2080,9551,11265,11631,2070,37,37
3,2.5,2849,9588,2,0,0,3,10,2849,0,47.6487,-122.079,3190,8897,12437,12087,2849,18,18
3,2.5,1900,8744,2,0,0,3,8,1900,0,47.62,-122.043,2030,8744,10644,10774,1900,32,32
3,2.25,1580,12177,1,0,0,3,7,1200,380,47.6254,-122.045,1660,11374,13757,13034,1580,38,38
4,2.5,2390,8432,2,0,0,3,9,2390,0,47.6027,-122.024,2710,7417,10822,10127,2390,21,21
4,2.5,2400,6137,2,0,0,3,8,2400,0,47.6187,-122.04,2120,7468,8537,9588,2400,29,29
5,2.75,3330,12408,1,0,0,3,10,1740,1590,47.6318,-122.058,2780,12000,15738,14780,3330,43,43
4,3.5,3380,11270,2,0,1,3,9,2160,1220,47.6124,-122.06,2910,11214,14650,14124,3380,12,12
2,2.25,1510,7280,2,0,0,3,7,1510,0,47.6264,-122.058,1510,8120,8790,9630,1510,32,32
3,2,1550,27003,1,0,0,3,8,1550,0,47.606,-122.056,2400,27003,28553,29403,1550,37,37
4,2.5,2160,10987,1,0,0,4,8,1440,720,47.6333,-122.034,1280,11617,13147,12897,2160,38,12
3,2.25,2060,31400,2,0,0,3,8,2060,0,47.6216,-122.056,2160,34500,33460,36660,2060,35,35
3,2.5,2670,10496,2,0,0,3,9,2670,0,47.6272,-122.026,2490,8636,13166,11126,2670,30,30
3,1,1330,15678,1,0,0,3,7,900,430,47.6355,-122.037,1330,12696,17008,14026,1330,35,35
3,1.75,1520,11085,1,0,0,3,8,1520,0,47.646,-122.068,2310,9647,12605,11957,1520,36,36
3,1.75,2120,9146,1,0,0,3,8,1260,860,47.6475,-122.064,2040,10485,11266,12525,2120,38,38
4,2.75,3140,7928,2,0,0,3,9,3140,0,47.5923,-122.058,3500,7055,11068,10555,3140,6,6
3,2.5,2030,7549,1,0,0,3,8,2030,0,47.6187,-122.044,2040,7130,9579,9170,2030,31,31
3,2.5,2140,8925,2,0,0,3,8,2140,0,47.6314,-122.027,2310,8956,11065,11266,2140,28,28
3,2.5,2430,5400,2,0,0,3,8,2430,0,47.6062,-122.057,2640,11990,7830,14630,2430,12,12
5,2.75,3170,7062,2,0,0,3,9,3170,0,47.5937,-122.061,3210,6891,10232,10101,3170,5,5
4,1.75,2410,8447,2,0,3,4,8,2060,350,47.6499,-122.088,2520,14789,10857,17309,2410,83,34
3,2.25,2206,82031,1,0,2,3,6,866,1340,47.6302,-122.069,2590,53024,84237,55614,2206,36,36
3,1.75,1780,11096,1,0,0,3,7,1210,570,47.617,-122.051,1780,10640,12876,12420,1780,40,40
4,2.5,2820,8307,2,0,0,3,9,2820,0,47.6253,-122.027,2820,8307,11127,11127,2820,29,29
4,2.75,3580,12000,1,0,0,3,10,1840,1740,47.6319,-122.05,2910,12428,15580,15338,3580,40,40
4,3.25,3640,60086,2,0,0,3,10,3640,0,47.6328,-122.016,2900,51721,63726,54621,3640,14,14
3,2.25,1820,9694,1,0,0,3,7,1240,580,47.6157,-122.05,1820,9694,11514,11514,1820,42,42
4,3,3570,10273,1,0,3,3,9,2630,940,47.6394,-122.077,3640,15324,13843,18964,3570,84,8
4,2.5,2990,5669,2,0,0,3,8,2990,0,47.6119,-122.011,3110,5058,8659,8168,2990,16,16
3,2.5,3720,11610,2,0,0,3,11,3720,0,47.636,-122.049,3530,11877,15330,15407,3720,37,37
3,2.5,1790,8144,2,0,0,3,8,1790,0,47.6169,-122.045,1800,7503,9934,9303,1790,30,30
4,2.5,2860,6600,2,0,0,3,9,2860,0,47.6067,-122.017,2790,6723,9460,9513,2860,19,19
4,2.75,2210,10800,1,0,0,4,8,1170,1040,47.6086,-122.059,2210,10800,13010,13010,2210,22,22
3,2.75,2540,4694,2,0,0,3,9,2540,0,47.6214,-122.024,2600,6344,7234,8944,2540,14,14
4,2.25,2490,10720,1,0,1,4,7,1400,1090,47.6137,-122.06,3080,10720,13210,13800,2490,40,40
3,2.5,3750,7821,2,0,0,3,9,3750,0,47.6325,-122.064,3210,8405,11571,11615,3750,18,18
3,2.5,1430,9240,2,0,0,3,7,1430,0,47.6258,-122.058,1480,8125,10670,9605,1430,35,35
5,2.5,4670,15857,2,0,0,3,11,4670,0,47.63,-122.011,3810,14824,20527,18634,4670,21,21
3,2,1010,7380,1,0,0,3,7,1010,0,47.6273,-122.062,1650,9030,8390,10680,1010,37,37
3,3.5,2880,11340,1,0,0,3,8,1690,1190,47.6113,-122.058,2530,11340,14220,13870,2880,39,1
3,2.5,1980,9061,2,0,0,4,8,1980,0,47.6366,-122.029,1930,8869,11041,10799,1980,32,32
3,3.25,4610,81935,2,0,0,4,9,4610,0,47.6217,-122.021,2900,43500,86545,46400,4610,35,35
3,2.5,2500,10359,2,0,0,3,10,2500,0,47.6286,-122.051,2580,10142,12859,12722,2500,33,33
3,1,1860,44431,1,0,0,4,6,1860,0,47.6057,-122.038,2000,44431,46291,46431,1860,72,72
3,3,2440,15540,2,0,0,3,9,2440,0,47.6104,-122.06,2440,15283,17980,17723,2440,27,27
3,2,2070,9195,1,0,0,3,8,1220,850,47.6491,-122.061,2080,9551,11265,11631,2070,37,37
5,3.5,3690,11928,2,0,0,3,9,2540,1150,47.6108,-122.06,2640,11928,15618,14568,3690,13,13
3,2.5,2370,55321,3,0,0,4,8,2370,0,47.6148,-122.057,2590,41553,57691,44143,2370,37,37
4,1.75,2410,8447,2,0,3,4,8,2060,350,47.6499,-122.088,2520,14789,10857,17309,2410,83,34
3,2.25,2180,9246,2,0,0,3,9,2180,0,47.6215,-122.031,2300,9298,11426,11598,2180,35,35
4,2.5,3030,7864,2,0,0,3,9,3030,0,47.6075,-122.017,2790,7034,10894,9824,3030,20,20
4,2.25,2510,31584,2,0,0,4,9,2510,0,47.6153,-122.054,2510,39221,34094,41731,2510,40,40
5,2.75,3460,7977,2,0,0,3,9,3460,0,47.5908,-122.062,3390,6630,11437,10020,3460,8,8
4,2.5,3100,8529,2,0,0,3,9,3100,0,47.6252,-122.029,2710,8344,11629,11054,3100,29,29
5,3.25,3710,34200,2,0,0,3,8,2510,1200,47.6101,-122.047,1720,23100,37910,24820,3710,33,33
3,2,1320,10720,2,0,0,3,8,1320,0,47.6203,-122.037,1910,13639,12040,15549,1320,38,38
3,2.5,2830,9680,2,0,0,3,10,2830,0,47.6249,-122.024,2970,8691,12510,11661,2830,28,28
5,1.5,3360,5225,2,0,0,3,9,3360,0,47.6072,-122.053,3230,5368,8585,8598,3360,5,5
6,4,3180,6551,2,0,0,3,9,3180,0,47.6236,-122.023,3230,7602,9731,10832,3180,5,5
4,2.5,2790,7938,2,0,0,3,9,2790,0,47.6223,-122.026,2780,7779,10728,10559,2790,22,22
4,2.5,3670,54450,2,0,0,3,10,3670,0,47.6211,-122.016,2900,49658,58120,52558,3670,20,20
5,3.25,3480,6507,2,0,0,3,9,3480,0,47.607,-122.053,3360,5398,9987,8758,3480,5,5
4,2.5,3280,6181,2,0,0,3,10,3280,0,47.6484,-122.081,3110,7570,9461,10680,3280,18,18
4,2.75,3520,5500,2,0,0,3,9,3520,0,47.6181,-122.056,3340,5500,9020,8840,3520,5,5
3,2.25,2730,10675,2,0,0,3,9,2730,0,47.6289,-122.042,2770,10570,13405,13340,2730,29,29
4,2.25,2450,11960,1,0,0,3,10,2450,0,47.6351,-122.06,2600,11960,14410,14560,2450,40,40
3,2.5,2400,12546,1,0,0,3,9,2400,0,47.6317,-122.041,2940,12150,14946,15090,2400,36,36
4,3.25,3820,15293,2,0,0,3,10,3820,0,47.6097,-122.017,2790,7142,19113,9932,3820,16,16
4,2.5,2370,9517,1,0,0,3,9,1630,740,47.6222,-122.034,2440,9035,11887,11475,2370,35,35
4,2.5,2990,9643,2,0,0,3,9,2990,0,47.6292,-122.024,2990,8666,12633,11656,2990,16,16
4,2.75,3090,5859,2,0,0,3,9,3090,0,47.6057,-122.047,2960,5250,8949,8210,3090,9,9
4,2.5,5730,44947,2,0,4,3,11,4280,1450,47.6052,-122.064,3310,17628,50677,20938,5730,28,28
3,2.25,2220,15757,1,0,0,3,8,1280,940,47.6212,-122.043,2020,14098,17977,16118,2220,37,37
4,2.5,2940,12600,1,0,0,4,8,1850,1090,47.6294,-122.062,2030,11770,15540,13800,2940,45,45
4,2.5,1620,8125,2,0,0,4,7,1620,0,47.6255,-122.059,1480,8120,9745,9600,1620,36,36
4,2.5,3040,6887,2,0,0,3,8,3040,0,47.6073,-122.015,2790,7196,9927,9986,3040,20,20
3,2.5,2520,10223,2,0,0,3,10,2520,0,47.631,-122.042,2630,10091,12743,12721,2520,31,31
3,3.5,3590,6402,2,0,0,3,10,3590,0,47.6336,-122.063,3230,7305,9992,10535,3590,20,20
3,2.5,1770,3993,2,0,0,3,8,1770,0,47.6027,-122.02,1820,4046,5763,5866,1770,20,20
3,2,1010,12252,1,0,0,3,8,1010,0,47.6224,-122.045,1840,11497,13262,13337,1010,39,39
4,2.5,3720,8633,2,0,0,3,10,3720,0,47.6085,-122.013,3515,9660,12353,13175,3720,20,20
3,2.5,3180,12600,2,0,0,4,11,3180,0,47.6366,-122.058,3030,12835,15780,15865,3180,41,41
3,2.5,1790,7167,2,0,0,3,8,1790,0,47.6176,-122.045,1680,7418,8957,9098,1790,30,30
4,2.25,2340,13383,1,0,0,3,8,1170,1170,47.6211,-122.037,1810,12532,15723,14342,2340,36,36
3,2,1800,12440,1,0,0,3,8,1220,580,47.6254,-122.05,2460,12352,14240,14812,1800,41,41
4,2.5,2410,15899,2,0,3,3,9,2410,0,47.6242,-122.04,2360,11412,18309,13772,2410,29,29
5,2.75,3010,4919,2,0,0,3,9,3010,0,47.6067,-122.052,3230,5415,7929,8645,3010,5,5
3,2.5,2330,3610,2,0,0,3,8,2330,0,47.6022,-122.021,1830,2948,5940,4778,2330,20,20
4,2.5,2800,5368,2,0,0,3,8,2800,0,47.6076,-122.053,2790,5368,8168,8158,2800,16,16
4,2.25,1960,12436,2,0,0,3,8,1960,0,47.6276,-122.037,1960,12436,14396,14396,1960,35,35
3,1.75,2170,26460,1,0,0,3,8,1450,720,47.6147,-122.045,2090,29075,28630,31165,2170,33,33
4,2.75,3540,5500,2,0,0,3,9,3540,0,47.6181,-122.056,3540,5500,9040,9040,3540,5,5
4,2.25,2190,15491,2,0,0,3,8,2190,0,47.6299,-122.039,2090,15039,17681,17129,2190,38,38
5,3.5,3840,8279,2,0,0,3,9,3840,0,47.6039,-122.059,3570,8279,12119,11849,3840,18,18
4,2,1990,29078,2,0,0,3,9,1990,0,47.6471,-122.057,2310,28353,31068,30663,1990,35,35
4,2.5,3280,25211,2,0,3,3,11,3280,0,47.6398,-122.05,3280,25211,28491,28491,3280,34,34
5,2.75,2080,13189,2,0,0,3,8,2080,0,47.6288,-122.031,2030,11847,15269,13877,2080,32,32
3,2.25,1920,10961,2,0,0,3,8,1920,0,47.6432,-122.057,2000,10706,12881,12706,1920,38,38
3,2.25,2520,12000,1,0,0,3,10,2520,0,47.6381,-122.062,2510,12000,14520,14510,2520,41,41
2,1,1090,10481,1,0,0,2,7,780,310,47.632,-122.03,1160,10533,11571,11693,1090,38,38
4,2.5,3070,5936,2,0,0,3,9,3070,0,47.5902,-121.988,3160,5936,9006,9096,3070,14,14
4,2.5,1800,4500,2,0,0,3,8,1800,0,47.5998,-122.014,1800,4500,6300,6300,1800,20,20
4,2.25,2450,34092,2,0,0,4,8,2450,0,47.5751,-122.049,2410,35378,36542,37788,2450,39,39
4,3.75,3550,15151,2,0,0,3,11,3550,0,47.5888,-121.971,4340,15151,18701,19491,3550,15,15
4,5.25,4140,14757,2,0,2,3,11,4140,0,47.5871,-121.969,4440,15523,18897,19963,4140,14,14
4,3,3240,5562,2,0,0,3,10,3240,0,47.5919,-121.975,3380,5562,8802,8942,3240,6,6
4,2.5,3880,7208,2,0,0,3,10,3880,0,47.5841,-121.971,3280,7221,11088,10501,3880,13,13
4,2.75,3350,6500,2,0,0,3,10,3350,0,47.5838,-122.027,2960,6970,9850,9930,3350,20,20
4,3.5,5370,323215,2,0,0,3,10,5370,0,47.6003,-122.076,3780,9891,328585,13671,5370,17,17
4,2.75,2760,5670,2,0,0,3,10,2760,0,47.5819,-122.047,2760,6600,8430,9360,2760,5,5
3,2.25,2290,14585,2,0,0,3,8,2290,0,47.5874,-122.074,1660,36961,16875,38621,2290,38,38
3,3.5,3500,9473,2,0,0,3,10,3500,0,47.5807,-121.972,3510,7833,12973,11343,3500,11,11
3,2.5,1990,4936,2,0,0,3,8,1990,0,47.5911,-122.018,2250,4815,6926,7065,1990,15,15
4,2.5,2518,4663,2,0,0,3,8,2518,0,47.5894,-122.017,2280,4525,7181,6805,2518,14,14
4,2.75,3790,10669,2,0,0,3,10,3790,0,47.5976,-121.983,3750,11634,14459,15384,3790,20,20
4,2,3380,90968,1,0,0,4,9,1690,1690,47.5936,-122.077,3380,42740,94348,46120,3380,40,40
3,2.5,2980,16996,2,0,0,3,10,2980,0,47.595,-122.016,2980,15438,19976,18418,2980,27,27
3,1.5,1460,78408,1,0,0,4,7,1460,0,47.59,-122.058,3320,7787,79868,11107,1460,56,56
3,2.5,2170,5500,2,0,0,3,8,2170,0,47.5975,-122.018,2170,5862,7670,8032,2170,19,19
4,2.5,4080,10295,2,0,0,3,10,4080,0,47.5933,-121.982,3470,10295,14375,13765,4080,21,21
4,2.5,2380,13435,2,0,0,3,10,2380,0,47.5833,-122.028,2730,9677,15815,12407,2380,27,27
3,2.25,2120,40518,1,0,0,3,8,2120,0,47.5896,-122.009,2480,13492,42638,15972,2120,52,52
4,2.5,3130,10860,2,0,0,3,10,3130,0,47.56,-122.04,3130,10860,13990,13990,3130,29,29
4,2.25,2620,10536,1,0,0,3,8,1520,1100,47.5847,-122.075,2760,12431,13156,15191,2620,40,40
3,2.25,2675,40910,2,0,0,3,8,2675,0,47.5916,-122.055,2300,39438,43585,41738,2675,35,35
4,2.75,3190,9023,2,0,0,3,9,3190,0,47.5898,-121.989,3159,5615,12213,8774,3190,14,14
4,2.5,2550,4630,2,0,0,3,7,2550,0,47.5928,-122.004,2550,5151,7180,7701,2550,14,14
4,2,2000,46902,2,0,0,3,8,2000,0,47.5851,-122.072,2420,38130,48902,40550,2000,41,41
4,3.5,4210,6481,2,0,3,3,9,3260,950,47.5765,-122.072,3920,5331,10691,9251,4210,5,5
4,2.5,2390,5800,2,0,0,3,9,2390,0,47.5965,-122.038,2590,6507,8190,9097,2390,19,19
3,2.25,1820,13362,1,0,0,3,8,1220,600,47.5898,-122.052,2050,15000,15182,17050,1820,42,42
4,2.5,3160,13063,2,0,0,3,10,3160,0,47.5996,-122.021,3350,14213,16223,17563,3160,20,20
4,2.5,1820,20011,2,0,0,3,8,1820,0,47.5842,-122.045,2710,33915,21831,36625,1820,32,32
3,1.75,2000,11880,2,0,0,3,8,2000,0,47.5882,-122.052,1820,15120,13880,16940,2000,40,40
5,3.5,4280,6530,2,0,3,3,10,4280,0,47.5941,-121.973,3960,6863,10810,10823,4280,5,5
4,3.25,3330,7809,2,0,0,3,9,3330,0,47.5977,-121.976,3100,6465,11139,9565,3330,15,15
5,2.75,2570,12906,2,0,0,3,8,2570,0,47.5814,-122.05,2580,12927,15476,15507,2570,32,32
4,2.5,2961,12146,2,0,0,3,9,2961,0,47.5839,-122.052,2620,17749,15107,20369,2961,21,21
3,2,2020,10584,1,0,0,3,10,2020,0,47.5851,-122.028,3030,9870,12604,12900,2020,25,25
4,3.5,3080,5250,2,0,0,3,9,3080,0,47.5992,-121.972,2980,5509,8330,8489,3080,16,16
4,2.75,2830,13059,2,0,0,3,10,2830,0,47.595,-121.986,3840,11596,15889,15436,2830,21,21
4,3.5,3640,4983,2,0,3,3,9,2790,850,47.5619,-122.027,3270,14700,8623,17970,3640,5,5
3,2.5,1560,5259,2,0,0,3,8,1560,0,47.5985,-122.016,2170,5461,6819,7631,1560,20,20
3,2.5,2700,5764,2,0,0,3,9,2700,0,47.5618,-122.027,3270,14700,8464,17970,2700,5,5
3,2.5,2780,33503,1,0,1,4,8,2110,670,47.5844,-122.081,3150,15542,36283,18692,2780,50,50
4,2.75,3010,15992,2,0,0,3,11,3010,0,47.5895,-121.994,3330,12333,19002,15663,3010,23,23
5,2.5,3320,9024,2,0,0,3,9,3320,0,47.5865,-122.056,3320,7665,12344,10985,3320,20,20
4,2.75,3190,10970,2,0,0,3,10,3190,0,47.5862,-122.029,2850,8416,14160,11266,3190,25,25
3,2.75,3010,1842,2,0,0,3,9,3010,0,47.5836,-121.994,2950,4200,4852,7150,3010,8,8
3,2,1640,9972,1,0,0,4,7,1640,0,47.5812,-122.002,1680,10165,11612,11845,1640,42,42
4,2.5,3610,13292,2,0,0,3,10,3610,0,47.5868,-121.974,3000,10776,16902,13776,3610,23,23
4,2,1480,11171,1,0,0,4,6,1480,0,47.5849,-122.051,2790,20680,12651,23470,1480,72,72
4,2.75,2800,19168,2,0,0,3,10,2800,0,47.5911,-122.037,2010,16020,21968,18030,2800,27,27
3,3.25,3240,4185,2,0,0,3,8,2770,470,47.5794,-122.03,2660,4692,7425,7352,3240,8,8
3,2.5,1990,3984,2,0,0,3,8,1990,0,47.5914,-122.017,2320,3984,5974,6304,1990,15,15
4,2.75,3770,24897,2,0,2,4,8,2550,1220,47.5824,-122.078,2640,11502,28667,14142,3770,55,55
4,3.5,3150,6175,2,0,0,3,9,3150,0,47.5966,-122.017,3150,6986,9325,10136,3150,18,18
3,2.5,1650,4218,2,0,0,3,8,1650,0,47.5998,-122.016,1650,4559,5868,6209,1650,19,19
4,2.5,2470,77550,1,0,0,4,7,2470,0,47.5888,-122.011,2490,40894,80020,43384,2470,32,32
4,2.75,2820,8009,2,0,0,3,9,2820,0,47.6,-121.977,2820,7398,10829,10218,2820,18,18
4,3.5,3460,7702,2,0,0,3,10,3460,0,47.5942,-121.977,3380,7464,11162,10844,3460,9,9
4,3,2990,6695,2,0,0,3,10,2990,0,47.5817,-122.047,2760,6600,9685,9360,2990,5,5
4,2.25,3720,12384,1,0,2,5,8,1860,1860,47.5836,-122.074,3180,15541,16104,18721,3720,49,49
5,3,2970,10335,2,0,0,3,9,2970,0,47.598,-122.019,2970,10335,13305,13305,2970,19,19
3,2.5,2180,15693,1,0,0,4,8,1850,330,47.592,-122.082,2270,24000,17873,26270,2180,40,40
3,2.25,2840,59677,1,0,0,3,7,1580,1260,47.5828,-122.044,2220,31688,62517,33908,2840,52,52
3,2.5,2000,22000,2,0,0,3,8,2000,0,47.59,-122.081,2180,19800,24000,21980,2000,40,40
3,2.75,3200,6699,2,0,0,3,9,3200,0,47.5884,-121.991,3020,6699,9899,9719,3200,15,15
4,3.25,4740,76230,2,0,0,3,10,4740,0,47.5931,-122.071,3340,49206,80970,52546,4740,32,32
3,1.75,1780,37801,1,0,0,3,7,1300,480,47.5858,-122.015,2380,47480,39581,49860,1780,42,42
2,3.25,2070,3128,2,1,3,3,9,1760,310,47.5686,-122.06,2740,3568,5198,6308,2070,31,31
4,2.5,2600,6015,2,0,0,3,8,2600,0,47.5971,-122.031,2910,5305,8615,8215,2600,15,15
2,3.25,1550,1767,3,1,3,3,8,1550,0,47.5684,-122.06,2710,3444,3317,6154,1550,13,13
4,2.5,3620,17133,1,0,4,3,10,2220,1400,47.5604,-122.027,3530,17026,20753,20556,3620,26,26
4,3.25,3200,7081,2,0,0,3,9,3200,0,47.5886,-121.989,3120,6094,10281,9214,3200,15,15
4,3.5,4070,10976,2,0,0,3,10,4070,0,47.5805,-121.97,4080,10106,15046,14186,4070,15,15
4,1.75,2970,14880,1,0,4,5,9,1560,1410,47.5907,-122.086,3310,13388,17850,16698,2970,57,57
4,2.5,3950,10856,3,0,0,3,10,3950,0,47.5818,-121.996,3200,10856,14806,14056,3950,6,6
4,3.25,3490,7024,2,0,0,3,10,3490,0,47.5834,-121.972,3450,6866,10514,10316,3490,13,13
4,2.5,2990,12788,2,0,0,3,10,2990,0,47.5601,-122.037,3250,12212,15778,15462,2990,31,31
4,3,3690,9892,2,0,0,3,10,3690,0,47.5937,-121.982,3430,11294,13582,14724,3690,21,21
4,2.5,2080,5191,2,0,0,3,8,2080,0,47.5978,-122.017,2170,5518,7271,7688,2080,18,18
4,2.5,3230,7331,2,0,0,3,10,3230,0,47.5823,-121.97,3480,7447,10561,10927,3230,15,15
4,3.5,4570,16219,2,0,0,3,11,4570,0,47.5859,-121.968,4700,16500,20789,21200,4570,17,17
3,2,3250,50529,2,0,0,4,8,3250,0,47.5849,-122.016,2370,47480,53779,49850,3250,41,41
5,3,2970,7261,2,0,0,3,9,2970,0,47.5994,-122.019,2970,8437,10231,11407,2970,20,20
4,2.5,3070,5762,2,0,0,3,10,3070,0,47.5847,-122.08,3630,6500,8832,10130,3070,19,19
3,2.5,3140,10983,2,0,0,3,10,3140,0,47.5595,-122.04,3140,10983,14123,14123,3140,28,28
3,1.75,1840,9401,1,0,0,3,8,1840,0,47.5847,-122.075,2850,14323,11241,17173,1840,48,48
3,2.5,2840,6854,2,0,0,3,9,2840,0,47.6006,-121.978,2840,7398,9694,10238,2840,17,17
4,2.75,2600,36583,1,0,0,5,8,1580,1020,47.593,-122.054,2300,27820,39183,30120,2600,43,43
5,3.5,4140,7642,2,0,0,3,8,4140,0,47.591,-122.008,3330,6953,11782,10283,4140,16,16
4,2.5,2730,4385,2,0,0,3,8,2730,0,47.5975,-122.038,2670,4644,7115,7314,2730,18,18
4,2.5,2280,4602,2,0,0,3,8,2280,0,47.5895,-122.019,2280,4193,6882,6473,2280,16,16
3,1.75,2910,35200,1,0,0,3,8,2910,0,47.5747,-122.035,2590,37500,38110,40090,2910,40,40
4,3.5,3560,6562,2,0,0,3,10,3560,0,47.5929,-121.974,3710,6562,10122,10272,3560,5,5
5,4,3720,15200,2,0,0,3,10,3720,0,47.5956,-122.026,4100,19036,18920,23136,3720,14,14
4,3.25,7000,28206,1,1,4,4,12,3500,3500,47.5928,-122.086,4913,14663,35206,19576,7000,28,28
4,4,3200,7708,2,0,0,3,10,3200,0,47.5816,-121.97,3480,7944,10908,11424,3200,15,15
5,4.5,4030,13474,2,0,0,3,11,4030,0,47.5812,-121.995,3860,12438,17504,16298,4030,19,19
3,2.75,2230,14400,1,0,0,4,8,1460,770,47.5791,-122.048,2200,13280,16630,15480,2230,42,42
3,2.5,3510,9824,2,0,0,3,9,3510,0,47.5635,-122.032,3510,10588,13334,14098,3510,17,17
3,1.75,1720,15225,1,0,0,4,7,1020,700,47.579,-122.051,1860,13588,16945,15448,1720,49,49
3,2.5,1650,4648,2,0,0,3,8,1650,0,47.5968,-122.015,1800,5637,6298,7437,1650,18,18
3,2,1600,16530,1,0,0,5,7,1600,0,47.5821,-122.016,1850,41006,18130,42856,1600,52,52
4,4,4930,22093,2,0,3,3,12,4930,0,47.5874,-121.965,4630,18889,27023,23519,4930,15,15
6,2.75,3610,17580,1,0,4,5,9,2070,1540,47.5739,-122.069,2890,14060,21190,16950,3610,60,60
4,3.5,2690,6164,2,0,0,3,9,2690,0,47.599,-121.973,2910,5000,8854,7910,2690,17,17
4,2.25,3190,52953,2,0,0,4,10,3190,0,47.5933,-122.075,3190,51400,56143,54590,3190,39,39
4,3,3150,9703,2,0,0,3,9,3150,0,47.5962,-122.018,3150,8819,12853,11969,3150,18,18
3,2.5,3090,20785,2,0,0,4,10,3090,0,47.5602,-122.03,3400,7566,23875,10966,3090,28,28
4,3.5,3350,19487,1,0,0,3,11,2460,890,47.5796,-121.998,3360,19460,22837,22820,3350,27,27
4,2.5,2450,20348,1,0,0,3,8,1410,1040,47.5887,-122.064,2450,50094,22798,52544,2450,41,41
5,2.75,3170,8093,2,0,0,3,9,3170,0,47.5933,-122.06,3210,7062,11263,10272,3170,5,5
3,2,2110,18815,2,0,0,5,7,2110,0,47.5836,-122.042,2690,21010,20925,23700,2110,40,40
5,4,4180,12042,2,0,0,3,10,4180,0,47.5959,-122.014,1800,6052,16222,7852,4180,5,5
4,2.5,3670,7000,2,0,0,3,10,3670,0,47.5854,-122.08,3680,7437,10670,11117,3670,14,14
3,1.75,1670,39639,1,0,0,4,8,1670,0,47.5929,-121.989,2330,30492,41309,32822,1670,43,22
5,2.5,3220,4759,2,0,0,3,8,3220,0,47.5957,-122.032,2550,4759,7979,7309,3220,16,16
4,2.5,2930,18199,2,0,0,3,9,2930,0,47.5937,-122.047,2930,33976,21129,36906,2930,21,21
5,3.5,5050,16500,2,0,2,3,11,5050,0,47.5863,-121.967,4570,16500,21550,21070,5050,18,18
5,4,4360,8030,2,0,0,3,10,4360,0,47.5923,-121.973,3570,6185,12390,9755,4360,4,4
4,3,3150,9318,2,0,0,3,9,3150,0,47.5959,-122.018,3150,9318,12468,12468,3150,18,18
4,2.5,3090,12511,2,0,0,4,10,3090,0,47.5932,-121.983,3100,10882,15601,13982,3090,21,21
3,2.5,1910,4941,2,0,0,3,8,1910,0,47.5989,-122.016,1910,4941,6851,6851,1910,20,20
3,2.5,3100,23790,2,0,0,3,9,3100,0,47.5882,-122.011,2250,40854,26890,43104,3100,17,17
4,2.5,2990,7231,2,0,0,3,9,2990,0,47.5623,-122.032,3160,8339,10221,11499,2990,18,18
4,2.5,3220,6399,2,0,0,3,9,3220,0,47.5883,-121.991,2850,6399,9619,9249,3220,15,15
4,2.5,3510,6745,2,0,0,3,10,3510,0,47.6016,-122.074,3320,8370,10255,11690,3510,21,21
4,3.5,4610,11676,2,0,0,3,10,4610,0,47.6011,-121.983,3900,11164,16286,15064,4610,19,19
4,2.5,3920,12415,2,0,0,3,10,3920,0,47.5658,-122.032,3639,12805,16335,16444,3920,22,22
5,2.5,3320,7266,2,0,0,3,9,3320,0,47.5862,-122.054,3060,10269,10586,13329,3320,19,19
4,3.5,2890,5911,2,0,0,3,9,2370,520,47.5754,-122.071,3490,6093,8801,9583,2890,5,5
4,2.5,2540,8706,2,0,0,3,9,2540,0,47.5855,-122.031,2540,6239,11246,8779,2540,22,22
5,3,2970,6500,2,0,0,3,9,2970,0,47.5973,-122.018,2970,6588,9470,9558,2970,19,19
4,2.75,4030,10888,2,0,0,3,10,4030,0,47.5651,-122.034,3720,10756,14918,14476,4030,22,22
3,1.75,1970,54450,1,0,0,3,8,1570,400,47.5936,-122.012,2460,36677,56420,39137,1970,39,39
4,2.5,2670,4410,2,0,0,3,8,2670,0,47.5978,-122.038,2670,4410,7080,7080,2670,20,20
4,3.5,3860,6543,2,0,0,3,10,3860,0,47.5934,-121.974,3760,6888,10403,10648,3860,5,5
3,3.5,2940,6431,2,0,0,3,10,2940,0,47.5818,-122.047,2760,6695,9371,9455,2940,5,5
4,3.5,4220,8417,3,0,0,3,10,4220,0,47.5869,-122.054,3730,8435,12637,12165,4220,7,7
4,3,3150,7778,2,0,0,3,9,3150,0,47.5972,-122.018,2970,6500,10928,9470,3150,19,19
4,2.5,2590,9753,2,0,0,3,10,2590,0,47.5848,-122.027,2800,9917,12343,12717,2590,26,26
3,2.5,2300,9752,2,0,2,3,8,2300,0,47.5825,-122.076,2640,10764,12052,13404,2300,51,12
3,2.5,1990,5149,2,0,0,3,8,1990,0,47.5895,-122.019,2280,4506,7139,6786,1990,16,16
4,2.5,2510,5936,2,0,0,3,9,2510,0,47.5847,-122.032,2760,6060,8446,8820,2510,21,21
4,1.75,2190,41000,2,0,0,3,8,2190,0,47.5755,-122.033,2590,35370,43190,37960,2190,39,39
5,3.75,3830,8131,2,0,0,3,10,3830,0,47.5837,-121.971,3570,7290,11961,10860,3830,14,14
4,2.5,2990,5122,2,0,0,3,8,2990,0,47.5773,-122.055,3140,7875,8112,11015,2990,15,15
4,3.75,2540,20662,2,0,0,3,10,2540,0,47.5882,-122.01,2490,37731,23202,40221,2540,21,21
4,2.5,3560,13981,2,0,0,3,10,3560,0,47.6002,-121.98,3840,13624,17541,17464,3560,19,19
4,2.5,2927,12171,2,0,0,3,10,2927,0,47.5948,-121.983,2967,12166,15098,15133,2927,21,21
2,1,1240,57000,1,0,0,3,7,1240,0,47.597,-122.059,3050,25545,58240,28595,1240,57,57
3,2,1380,15426,1,0,0,4,7,1380,0,47.5951,-122.036,1380,15426,16806,16806,1380,51,51
3,2.25,3000,11665,1,1,4,3,11,3000,0,47.5884,-122.086,3000,15959,14665,18959,3000,18,18
3,2.25,1820,13362,1,0,0,3,8,1220,600,47.5898,-122.052,2050,15000,15182,17050,1820,42,42
3,1.75,1880,108900,1,0,0,3,7,1880,0,47.5913,-122.01,2730,37731,110780,40461,1880,41,41
4,2.5,3250,8970,2,0,0,3,10,3250,0,47.5862,-122.037,3240,8449,12220,11689,3250,25,25
5,4.25,4150,12015,2,0,0,3,10,4150,0,47.5816,-122.021,3230,27520,16165,30750,4150,5,5
3,2,1860,42800,1,0,0,4,7,930,930,47.5898,-122.004,1980,11250,44660,13230,1860,36,36
4,2.5,3570,6246,2,0,0,3,7,3570,0,47.5927,-122.006,2260,5231,9816,7491,3570,14,14
4,2.75,2640,6240,2,0,0,3,9,2640,0,47.5788,-122.059,2640,5898,8880,8538,2640,18,18
3,2.5,2510,6320,2,0,0,3,9,2510,0,47.5868,-122.033,2518,5819,8830,8337,2510,23,23
4,2.5,2770,5686,2,0,0,3,9,2770,0,47.5997,-121.973,2910,5000,8456,7910,2770,15,15
3,2.5,2730,11380,2,0,0,3,10,2730,0,47.58,-122.057,2800,10070,14110,12870,2730,24,24
4,2.5,3270,8223,2,0,0,3,10,3270,0,47.6018,-122.073,3460,8872,11493,12332,3270,21,21
4,2.5,3290,6465,2,0,0,3,9,3290,0,47.5981,-121.976,3100,5929,9755,9029,3290,17,17
5,2.75,3390,5211,2,0,0,3,9,3390,0,47.5977,-121.981,3210,5211,8601,8421,3390,15,15
4,3,4120,14021,2,0,0,3,11,4120,0,47.5985,-122.026,4390,14684,18141,19074,4120,14,14
3,2.5,2940,15875,2,0,0,3,10,2940,0,47.5947,-122.016,2980,15875,18815,18855,2940,25,25
4,2.25,2610,24931,2,0,0,3,8,2610,0,47.5771,-122.05,2550,18306,27541,20856,2610,36,36
3,2.5,2320,5284,2,0,0,3,8,2320,0,47.591,-122.017,2320,4383,7604,6703,2320,15,15
4,3.75,4120,8258,2,0,0,3,10,4120,0,47.5872,-122.055,3730,8332,12378,12062,4120,7,7
5,2.75,3430,15119,2,0,0,3,10,3430,0,47.5678,-122.032,3430,12045,18549,15475,3430,21,21
4,2.25,2380,35008,1,0,0,3,8,2380,0,47.5834,-122.001,2250,34794,37388,37044,2380,42,42
4,2.75,2710,41811,1,0,0,4,8,1690,1020,47.5836,-122.046,2110,35656,44521,37766,2710,24,24
4,2.5,2850,37522,2,0,0,3,9,2850,0,47.5852,-121.992,2980,35280,40372,38260,2850,32,32
4,2.75,3150,7035,2,0,0,3,9,3150,0,47.5979,-121.974,3200,7035,10185,10235,3150,15,15
4,2.5,2230,10414,1,0,0,5,7,1450,780,47.5816,-122,1960,10240,12644,12200,2230,45,45
4,2.75,3780,10308,2,0,0,3,10,3780,0,47.589,-121.983,3500,10740,14088,14240,3780,20,20
7,3.75,5100,21802,2,0,0,3,10,3640,1460,47.595,-122.04,3350,10005,26902,13355,5100,18,18
4,3.25,3526,15958,2,0,0,3,10,3526,0,47.567,-122.033,3639,15090,19484,18729,3526,22,22
3,1,1440,54315,1,0,0,3,7,790,650,47.591,-122.01,2690,40518,55755,43208,1440,45,45
4,4,5320,20041,2,0,0,3,11,5320,0,47.5852,-121.966,4640,17268,25361,21908,5320,16,16
4,2.75,2050,17859,1,0,0,4,7,1300,750,47.5945,-122.056,2960,20908,19909,23868,2050,52,52
3,1.75,2570,39634,2,0,0,3,8,2570,0,47.596,-122.08,2990,39634,42204,42624,2570,35,35
4,3.25,3830,10005,2,0,0,3,10,3830,0,47.5953,-122.039,2555,5204,13835,7759,3830,18,18
4,3.75,3320,8030,2,0,0,3,10,3320,0,47.5818,-121.972,3740,8030,11350,11770,3320,14,14
4,2.5,2280,4534,2,0,0,3,8,2280,0,47.5902,-122.018,2246,4534,6814,6780,2280,16,16
4,2.25,2620,33578,2,0,0,3,7,2620,0,47.5921,-122.013,2520,35160,36198,37680,2620,42,42
4,2.5,2850,5664,2,0,0,3,9,2850,0,47.5835,-121.996,2850,5475,8514,8325,2850,18,18
4,2.75,3190,5408,2,0,0,3,9,3190,0,47.5903,-121.988,3160,5773,8598,8933,3190,14,14
4,2.5,2510,35020,1,0,0,4,8,1610,900,47.5834,-122.003,2080,34398,37530,36478,2510,42,42
4,3.5,3110,108464,2,0,2,4,8,3110,0,47.592,-122.018,2340,4938,111574,7278,3110,40,40
4,2.5,1800,4338,2,0,0,3,8,1800,0,47.5962,-122.015,1800,4507,6138,6307,1800,18,18
4,2.5,4240,43995,2,0,0,3,10,4240,0,47.6008,-122.044,3720,59522,48235,63242,4240,30,30
5,3.5,4380,14925,2,0,0,3,11,4380,0,47.5848,-121.969,4310,14633,19305,18943,4380,16,16
3,2.5,1900,6224,2,0,0,3,7,1900,0,47.5941,-122.004,2260,5450,8124,7710,1900,14,14
4,3.25,3960,7012,2,0,0,3,10,3960,0,47.5854,-122.08,3680,8522,10972,12202,3960,14,14
4,2.5,2980,12764,2,0,0,3,10,2980,0,47.5857,-122.027,3080,9810,15744,12890,2980,25,25
5,3.5,3500,10794,2,0,0,3,10,3500,0,47.5887,-121.974,3110,10837,14294,13947,3500,23,23
5,5,5000,32909,2,0,0,3,10,5000,0,47.6012,-122.022,3030,12601,37909,15631,5000,19,19
4,2.75,2830,10240,2,0,0,4,9,2830,0,47.5903,-121.986,3490,10240,13070,13730,2830,21,21
4,2.5,2810,10986,2,0,0,3,10,2810,0,47.5943,-121.981,3540,10986,13796,14526,2810,22,22
4,2.5,3730,9847,2,0,0,3,10,3730,0,47.587,-121.976,3490,10219,13577,13709,3730,22,22
4,2.5,2810,52062,1,0,0,4,9,2810,0,47.5941,-122.029,3330,49783,54872,53113,2810,31,31
3,2.5,2890,8470,2,0,0,3,10,2890,0,47.5785,-122.054,3000,8879,11360,11879,2890,23,23
5,2.75,3490,8230,2,0,0,3,10,3490,0,47.5825,-121.97,3480,7331,11720,10811,3490,14,14
3,1.5,1540,20281,1,0,0,3,7,1540,0,47.5817,-122.007,1710,21090,21821,22800,1540,42,42
4,2.5,3290,6012,2,0,0,3,9,3290,0,47.5961,-121.98,3210,6005,9302,9215,3290,14,14
4,2.5,3370,9629,2,0,0,3,10,3370,0,47.5896,-121.978,3360,10335,12999,13695,3370,20,20
4,2.75,3430,13907,2,0,0,3,11,3430,0,47.5879,-121.993,3250,13851,17337,17101,3430,24,24
4,2.75,2810,7302,2,0,0,3,9,2810,0,47.5985,-121.977,2820,7302,10112,10122,2810,17,17
3,2.5,1660,15000,1,0,0,4,7,1660,0,47.5803,-122.05,2060,15015,16660,17075,1660,49,49
4,2.75,2030,56192,1,0,0,3,8,1550,480,47.752,-122.073,2510,44866,58222,47376,2030,40,40
4,2.5,2280,65836,2,0,0,3,8,2280,0,47.7237,-122.076,2300,97574,68116,99874,2280,15,15
4,2.25,3440,14237,2,0,0,3,9,3440,0,47.7241,-122.065,3250,18365,17677,21615,3440,37,37
4,2.5,2790,43091,2,0,0,4,9,2790,0,47.7759,-122.08,2750,35290,45881,38040,2790,30,30
3,2.5,2680,28243,2,0,0,3,9,2680,0,47.7637,-122.05,2670,32130,30923,34800,2680,26,26
4,2.5,3190,14565,2,0,0,3,11,3190,0,47.713,-122.072,3420,20475,17755,23895,3190,29,29
4,2.5,3520,35991,2,0,0,4,10,3520,0,47.7437,-122.035,3210,35991,39511,39201,3520,27,27
2,1,1140,75132,1,0,0,3,7,1140,0,47.7349,-122.074,2570,35200,76272,37770,1140,63,63
4,2.25,2590,36256,2,0,0,3,8,2590,0,47.769,-122.094,2670,35657,38846,38327,2590,41,41
4,2.75,2890,46609,2,0,0,4,9,2890,0,47.7454,-122.061,2880,68824,49499,71704,2890,38,38
3,2.5,2990,32239,2,0,0,4,8,2990,0,47.7718,-122.095,2990,36497,35229,39487,2990,41,41
4,2.5,2370,41338,2,0,0,3,8,2370,0,47.7379,-122.052,2340,46661,43708,49001,2370,24,24
3,2.5,2880,36820,2,0,0,3,10,2880,0,47.766,-122.044,3190,36820,39700,40010,2880,27,27
4,2.75,3220,15467,2,0,0,3,11,3220,0,47.7128,-122.083,3670,16641,18687,20311,3220,25,25
4,2.5,3190,14565,2,0,0,3,11,3190,0,47.713,-122.072,3420,20475,17755,23895,3190,29,29
3,2.5,2620,51354,2,0,0,3,9,2620,0,47.7211,-122.028,2620,37042,53974,39662,2620,21,21
4,2.5,2770,45514,2,0,0,4,9,2770,0,47.7751,-122.088,2940,49495,48284,52435,2770,30,30
3,2,1540,67756,1,0,0,3,7,1540,0,47.721,-122.078,2060,67756,69296,69816,1540,119,42
4,3.25,3740,12080,1,0,0,3,10,2000,1740,47.7214,-122.056,4210,15277,15820,19487,3740,31,31
3,2.5,2130,219978,2,0,0,3,8,2130,0,47.7754,-122.032,3340,217800,222108,221140,2130,33,33
3,2,1510,43560,1,0,0,3,7,1510,0,47.7218,-122.079,2060,67756,45070,69816,1510,65,65
3,1,1330,9540,1,0,0,4,7,1330,0,47.758,-122.075,1250,10350,10870,11600,1330,48,48
4,2.5,2570,50308,1,0,0,3,10,2570,0,47.7418,-122.039,3420,37891,52878,41311,2570,26,26
4,3.25,4060,52707,2,0,0,4,9,4060,0,47.7615,-122.041,3100,50755,56767,53855,4060,23,23
4,2.5,3140,28037,2,0,0,4,10,3140,0,47.7304,-122.082,2990,35001,31177,37991,3140,28,28
3,2.25,3330,15258,2,0,0,3,10,3330,0,47.7262,-122.06,3360,14850,18588,18210,3330,33,33
5,2.25,3210,61419,1,0,0,3,8,3210,0,47.7632,-122.09,2820,48351,64629,51171,3210,40,40
4,2.75,2890,16397,2,0,0,3,10,2890,0,47.7102,-122.072,3170,16397,19287,19567,2890,22,22
3,2.25,2080,50965,1,0,0,3,8,1590,490,47.7506,-122.063,2270,51836,53045,54106,2080,40,40
3,1,1120,10576,1,0,0,4,7,1120,0,47.7575,-122.072,1300,10000,11696,11300,1120,50,50
4,2.25,4230,37769,2,0,0,3,11,4230,0,47.7287,-122.077,3890,37034,41999,40924,4230,30,30
4,3,3280,62726,1,0,0,3,7,3280,0,47.7509,-122.056,3210,73616,66006,76826,3280,40,40
3,2.25,2100,43560,1,0,0,4,8,1330,770,47.7511,-122.072,2100,43560,45660,45660,2100,42,42
3,1,1120,9075,1,0,0,3,7,1120,0,47.7551,-122.072,1120,9705,10195,10825,1120,42,42
4,2.5,3100,36562,2,0,0,3,10,3100,0,47.7646,-122.065,3080,39351,39662,42431,3100,25,25
3,1,1160,9180,1,0,0,3,7,1160,0,47.7427,-122.072,1160,10282,10340,11442,1160,51,51
4,2.5,3420,30410,2,0,0,3,9,3420,0,47.7745,-122.088,2940,45916,33830,48856,3420,31,31
3,2.5,1960,47044,2,0,0,4,8,1960,0,47.7573,-122.07,2020,29004,49004,31024,1960,41,41
3,1.75,1280,16200,1,0,0,3,8,1030,250,47.7427,-122.071,1160,10565,17480,11725,1280,43,43
4,2.5,2970,34981,2,0,0,3,9,2970,0,47.7365,-122.037,3170,30277,37951,33447,2970,21,21
6,4.25,6900,244716,2,0,0,4,9,4820,2080,47.7506,-122.012,4170,266587,251616,270757,6900,17,17
4,2.75,2700,35362,2,0,0,5,8,2700,0,47.7628,-122.094,2810,35915,38062,38725,2700,43,43
3,2.75,2660,32757,1,0,0,4,8,2660,0,47.7649,-122.098,2720,35191,35417,37911,2660,44,44
3,1,1160,11776,1,0,0,3,7,1160,0,47.7427,-122.074,1160,10050,12936,11210,1160,51,51
5,3.75,4130,226076,2,0,0,3,9,3170,960,47.715,-122.065,4130,55321,230206,59451,4130,34,34
3,1.75,2410,51763,1,0,0,4,8,1410,1000,47.7429,-122.056,2410,49207,54173,51617,2410,38,38
4,3,2420,12000,1,0,0,3,9,2420,0,47.7267,-122.063,3100,13020,14420,16120,2420,35,35
3,2.5,2790,53143,2,0,0,4,9,2790,0,47.7687,-122.036,2740,47916,55933,50656,2790,28,28
4,2.5,3600,203425,2,0,0,3,9,3400,200,47.7597,-122.018,3150,202989,207025,206139,3600,40,40
3,3.5,3830,221284,2,0,0,3,10,3530,300,47.7641,-122.023,2920,148539,225114,151459,3830,26,26
4,3,4480,42717,2,0,0,3,9,4480,0,47.7711,-122.088,3140,41632,47197,44772,4480,32,32
4,2.5,3550,35689,2,0,0,4,9,3550,0,47.7503,-122.074,3350,35711,39239,39061,3550,28,28
4,2.25,2430,32496,1,0,0,3,9,2430,0,47.7642,-122.048,2750,35506,34926,38256,2430,26,26
4,2.5,2360,43017,2,0,0,3,9,2360,0,47.774,-122.077,2750,40334,45377,43084,2360,30,30
4,3.75,3830,41263,2,0,0,4,11,3830,0,47.7237,-122.042,5600,56568,45093,62168,3830,29,29
3,2.25,2350,51400,1,0,0,3,7,1390,960,47.7417,-122.053,2350,51400,53750,53750,2350,42,42
3,2.5,2420,198198,2,0,0,3,9,2420,0,47.772,-122.022,2780,179467,200618,182247,2420,22,22
3,2.5,3550,32807,2,0,0,3,9,3550,0,47.7292,-122.082,3270,35001,36357,38271,3550,30,30
4,3.5,4270,40097,1,0,0,4,12,4270,0,47.7354,-122.078,3510,36149,44367,39659,4270,26,26
3,1.5,2060,44866,1,0,0,3,8,2060,0,47.7503,-122.051,2320,43995,46926,46315,2060,66,66
3,2.5,3030,30007,1,0,0,4,10,3030,0,47.743,-122.036,3360,34983,33037,38343,3030,27,27
4,4,6050,84942,2,0,2,3,9,4150,1900,47.7466,-122.029,2700,199504,90992,202204,6050,10,10
4,2.5,2050,34222,2,0,0,4,8,2050,0,47.7572,-122.022,2240,51400,36272,53640,2050,30,30
4,2.5,2870,35757,2,0,0,4,9,2870,0,47.7568,-122.05,2700,41221,38627,43921,2870,42,42
3,1.5,1190,11996,1,0,0,4,7,1190,0,47.7561,-122.071,1190,9756,13186,10946,1190,50,50
3,1,1160,9525,1,0,0,4,7,1160,0,47.7431,-122.073,1160,10640,10685,11800,1160,51,51
2,1,1070,189486,1,0,0,3,6,1070,0,47.7199,-122.085,1970,60548,190556,62518,1070,77,77
4,2.5,3430,64441,2,0,0,3,8,3430,0,47.7694,-122.064,3580,64441,67871,68021,3430,6,6
3,2.5,2980,43301,1,0,0,4,8,1930,1050,47.7631,-122.093,2890,35915,46281,38805,2980,41,41
4,1.75,2020,36400,1,0,0,4,8,1550,470,47.7627,-122.076,2520,38255,38420,40775,2020,43,43
5,4.75,3830,35000,1,0,0,3,8,2130,1700,47.7597,-122.079,2750,36150,38830,38900,3830,43,43
4,2.5,3960,38615,2,0,0,3,10,3960,0,47.7249,-122.024,3290,43560,42575,46850,3960,19,19
4,2.5,3360,40471,2,0,0,4,10,3360,0,47.742,-122.035,3150,36823,43831,39973,3360,25,25
4,2.75,3370,12447,2,0,0,3,10,3370,0,47.7309,-122.058,3700,13129,15817,16829,3370,28,28
4,2.5,3210,18901,2,0,0,3,10,3210,0,47.709,-122.073,3330,18901,22111,22231,3210,26,26
4,3,4270,85643,2,0,0,3,11,4270,0,47.7711,-122.048,3760,51170,89913,54930,4270,28,28
4,2.5,2920,32219,2,0,0,5,10,2920,0,47.7439,-122.041,3420,37206,35139,40626,2920,24,24
4,3,3810,217800,2,0,0,3,9,3810,0,47.7696,-122.021,2580,217364,221610,219944,3810,16,16
3,2.5,2560,43608,2,0,0,3,9,2560,0,47.7614,-122.026,3000,54088,46168,57088,2560,17,17
3,2.75,3270,39586,1,0,0,3,11,3270,0,47.731,-122.078,3480,35998,42856,39478,3270,31,31
3,1,1160,9750,1,0,0,3,7,1160,0,47.7422,-122.073,1160,9650,10910,10810,1160,52,52
3,1,1300,9300,1,0,0,4,7,1300,0,47.7562,-122.073,1300,10064,10600,11364,1300,42,42
3,2.5,2260,33042,1,0,0,3,9,1660,600,47.7634,-122.086,2600,40115,35302,42715,2260,33,33
4,1.75,1780,9794,1,0,0,3,7,1780,0,47.7419,-122.073,1160,9750,11574,10910,1780,52,52
3,2.5,2980,18935,1,0,0,3,11,2980,0,47.7133,-122.079,3670,18225,21915,21895,2980,29,29
5,2.75,2910,53898,1,0,0,5,7,1510,1400,47.7201,-122.062,3210,216928,56808,220138,2910,40,40
4,2.5,2200,110642,1,0,0,5,7,1330,870,47.7409,-122.052,2290,51400,112842,53690,2200,40,40
4,2.5,2710,49044,2,0,0,3,9,2710,0,47.774,-122.08,2560,38190,51754,40750,2710,31,31
3,2.5,2680,43995,2,0,0,3,9,2680,0,47.7655,-122.086,2520,37277,46675,39797,2680,33,33
4,3.5,4040,50479,2,0,0,3,11,4040,0,47.7196,-122.048,3770,40899,54519,44669,4040,32,32
3,2.25,3000,18450,1,0,0,3,10,3000,0,47.7274,-122.062,2980,12304,21450,15284,3000,36,36
4,2.25,2380,36446,2,0,0,4,8,2380,0,47.7644,-122.072,2790,40005,38826,42795,2380,42,42
3,2.5,2460,38794,2,0,0,3,9,2460,0,47.7602,-122.022,2470,51400,41254,53870,2460,20,20
4,3.5,4380,66613,1,0,0,3,11,4380,0,47.7279,-122.048,4010,70109,70993,74119,4380,26,26
4,2.5,2340,41600,1,0,0,3,8,1640,700,47.7466,-122.077,2340,34960,43940,37300,2340,42,42
4,2.25,2450,62290,2,0,0,3,8,2450,0,47.7603,-122.074,2450,41181,64740,43631,2450,43,43
4,2.5,3220,22588,2,0,0,3,10,3220,0,47.7311,-122.055,3220,22922,25808,26142,3220,23,23
4,2.5,3290,35001,2,0,0,3,10,3290,0,47.7231,-122.038,4090,40371,38291,44461,3290,28,28
2,3,3160,66646,2,0,0,3,7,3160,0,47.7479,-122.034,3140,38790,69806,41930,3160,26,26
4,2.5,3560,46644,2,0,0,3,11,3560,0,47.7268,-122.05,3520,50261,50204,53781,3560,27,27
4,1.75,1810,21650,2,0,0,4,7,1810,0,47.7358,-122.076,2700,29680,23460,32380,1810,58,58
3,3,3460,13129,2,0,0,3,9,2560,900,47.7315,-122.058,3460,12568,16589,16028,3460,31,31
3,2.5,2950,35108,1,0,0,3,10,2950,0,47.7316,-122.035,3810,35181,38058,38991,2950,24,24
3,2.5,2400,97138,2,0,0,5,8,2400,0,47.7361,-122.046,2230,54450,99538,56680,2400,36,36
3,2.5,1350,187313,1,0,0,4,7,1350,0,47.7369,-122.049,2310,49222,188663,51532,1350,22,22
5,5.75,7730,230868,2,0,0,3,12,6660,1070,47.7615,-122.084,2660,39292,238598,41952,7730,15,15
3,3,4040,14338,2,0,0,3,10,3030,1010,47.7268,-122.06,3360,14142,18378,17502,4040,33,33
4,2,3390,16025,2,0,0,4,10,3390,0,47.7222,-122.056,3950,15277,19415,19227,3390,32,32
4,2.5,2940,29013,2,0,0,3,10,2940,0,47.7635,-122.044,3010,34071,31953,37081,2940,27,27
4,2.5,2990,16809,2,0,0,3,11,2990,0,47.7123,-122.073,3340,18752,19799,22092,2990,29,29
3,2.5,2080,12032,2,0,0,3,8,2080,0,47.7455,-122.073,2320,9900,14112,12220,2080,41,41
4,2.25,3200,53357,2,0,0,4,9,3200,0,47.755,-122.035,2650,54014,56557,56664,3200,47,47
4,2.5,3490,18521,2,0,0,4,9,3490,0,47.7406,-122.07,2850,18521,22011,21371,3490,29,29
4,2.25,2710,38180,2,0,0,4,8,2710,0,47.77,-122.097,2590,38180,40890,40770,2710,42,42
4,1.75,2860,48351,1,0,0,3,8,1710,1150,47.7605,-122.085,2460,43560,51211,46020,2860,41,41
4,3.75,5300,37034,2,0,0,3,11,5300,0,47.7283,-122.076,3730,37034,42334,40764,5300,30,30
4,2.5,3320,38032,2,0,0,4,10,3320,0,47.7478,-122.036,3270,37804,41352,41074,3320,28,28
3,2.5,3260,91911,2,0,0,4,9,3260,0,47.737,-122.074,2520,65775,95171,68295,3260,35,35
3,1,1660,11783,1,0,0,4,7,1160,500,47.7563,-122.075,1320,10541,13443,11861,1660,41,41
3,1.75,2290,44866,1,0,0,3,8,1390,900,47.7398,-122.041,2410,44866,47156,47276,2290,38,38
3,2.5,2180,37042,2,0,0,3,9,2180,0,47.722,-122.026,2880,32688,39222,35568,2180,21,21
3,2.25,2190,107593,2,0,0,4,8,2190,0,47.7731,-122.08,2570,47777,109783,50347,2190,36,36
3,1.75,1960,43332,1,0,0,4,7,1400,560,47.739,-122.048,2010,44431,45292,46441,1960,37,37
4,2.5,3890,34513,2,0,0,3,10,3890,0,47.7749,-122.048,3600,28435,38403,32035,3890,23,23
4,2.5,3300,165528,2,0,0,3,8,3300,0,47.7657,-122.028,3030,144696,168828,147726,3300,35,35
4,2,2990,102366,1,0,0,4,8,2990,0,47.3068,-122.088,2820,57140,105356,59960,2990,45,45
3,3.5,4080,217697,1,0,3,3,10,4080,0,47.2604,-122.139,2710,217790,221777,220500,4080,19,19
4,2.5,2007,4968,2,0,0,3,9,2007,0,47.3301,-122.191,2189,5852,6975,8041,2007,10,10
4,2.5,1860,8709,2,0,0,3,8,1860,0,47.3289,-122.17,1990,6825,10569,8815,1860,25,25
4,2.5,2810,11897,2,0,0,3,8,2810,0,47.3251,-122.186,1770,4240,14707,6010,2810,16,16
4,2.5,2798,5085,2,0,0,3,9,2798,0,47.3308,-122.187,2502,5707,7883,8209,2798,8,8
4,2.5,2560,5102,2,0,0,3,8,2560,0,47.3404,-122.181,2586,5059,7662,7645,2560,6,6
3,2.25,2840,107157,2,0,0,4,9,2840,0,47.2848,-122.118,2600,215622,109997,218222,2840,36,36
4,2.25,1800,9350,1,0,0,3,8,1800,0,47.2959,-122.191,2060,8800,11150,10860,1800,50,50
3,2.5,1608,4800,2,0,0,3,8,1608,0,47.2585,-122.201,2009,4800,6408,6809,1608,6,6
3,2.5,2570,4600,2,0,0,3,8,2570,0,47.2582,-122.196,2570,5000,7170,7570,2570,5,5
3,2.5,1500,7401,2,0,0,3,8,1500,0,47.2625,-122.221,1720,7171,8901,8891,1500,21,21
5,3.5,2660,6978,2,0,0,3,8,1980,680,47.2631,-122.212,2220,7294,9638,9514,2660,23,23
3,1.5,1350,81549,1,0,0,2,7,1350,0,47.3099,-122.09,2220,93825,82899,96045,1350,53,53
3,1,1090,3315,1,0,0,4,6,1090,0,47.3159,-122.183,960,3120,4405,4080,1090,50,50
3,2,1330,35060,1,0,0,3,7,1330,0,47.3128,-122.13,1660,35100,36390,36760,1330,30,30
2,1.5,1800,26615,1,0,0,5,7,1240,560,47.302,-122.123,2010,26337,28415,28347,1800,32,32
3,2.5,1608,4000,2,0,0,3,8,1608,0,47.2582,-122.198,2009,4983,5608,6992,1608,5,5
3,2.5,2100,213008,1,0,0,3,8,2100,0,47.2984,-122.144,1330,214315,215108,215645,2100,29,29
3,1,1070,8250,1,0,0,3,7,1070,0,47.2899,-122.192,1190,8250,9320,9440,1070,58,58
5,3,3270,9146,2,0,0,3,7,3270,0,47.3342,-122.169,3200,6300,12416,9500,3270,17,17
3,1.5,1370,8470,1,0,0,4,7,1370,0,47.2874,-122.192,1710,8800,9840,10510,1370,58,58
2,1.75,2510,19141,2,0,0,3,9,2510,0,47.3103,-122.199,2400,13030,21651,15430,2510,42,42
3,1.75,1700,11613,1,0,0,5,7,1180,520,47.2874,-122.187,1500,12377,13313,13877,1700,42,42
3,3,3760,188760,1,0,0,4,10,2640,1120,47.308,-122.087,2820,50543,192520,53363,3760,40,40
3,2.5,1600,6315,2,0,0,3,8,1600,0,47.2611,-122.198,1608,4300,7915,5908,1600,6,6
4,2.25,3360,10810,2,0,0,4,9,3360,0,47.3316,-122.203,2590,10810,14170,13400,3360,31,31
4,2.25,2640,31941,1,0,0,4,9,2640,0,47.3099,-122.116,2780,35365,34581,38145,2640,33,33
4,2.5,2010,7226,2,0,0,3,8,2010,0,47.2588,-122.21,2160,7696,9236,9856,2010,24,24
4,3.25,4280,47179,2,0,0,3,10,3050,1230,47.3017,-122.127,2820,43401,51459,46221,4280,17,17
4,2.5,2370,6500,2,0,0,3,9,2370,0,47.3328,-122.173,2590,6137,8870,8727,2370,21,21
4,2.5,2640,7883,2,0,0,3,8,2640,0,47.3124,-122.188,2150,7683,10523,9833,2640,29,29
3,2.5,2242,4500,2,0,0,3,8,2242,0,47.2583,-122.198,2009,4500,6742,6509,2242,5,5
3,2.5,2242,4800,2,0,0,3,8,2242,0,47.2581,-122.2,2009,4800,7042,6809,2242,6,6
3,1.5,2240,87625,1,0,0,2,7,1480,760,47.3043,-122.094,1920,110206,89865,112126,2240,39,39
4,2.5,2810,6481,2,0,0,3,9,2810,0,47.333,-122.172,2660,6958,9291,9618,2810,21,21
2,1,1520,4700,2,0,0,4,7,1520,0,47.3187,-122.182,1140,3906,6220,5046,1520,41,41
4,2.5,2640,8055,2,0,0,3,9,2640,0,47.315,-122.193,1650,8055,10695,9705,2640,15,15
4,2.5,3750,218506,2,0,0,3,10,3750,0,47.3045,-122.103,2540,39413,222256,41953,3750,28,28
3,2.5,1769,7324,2,0,0,3,9,1769,0,47.3307,-122.188,2502,6017,9093,8519,1769,7,7
3,2.25,3050,10689,2,0,0,4,9,3050,0,47.3326,-122.201,2697,10925,13739,13622,3050,31,31
3,2,1440,7210,1,0,0,3,8,1440,0,47.3128,-122.184,1700,7245,8650,8945,1440,36,36
6,3,3320,15600,1,0,0,4,8,1660,1660,47.2983,-122.166,2330,15360,18920,17690,3320,42,42
2,1,1140,101529,1,0,0,3,6,1140,0,47.2592,-122.228,1580,101529,102669,103109,1140,87,87
3,1.5,2390,32109,1,0,0,3,7,2390,0,47.3028,-122.102,1370,32109,34499,33479,2390,44,7
4,2.5,1990,5577,2,0,0,3,7,1990,0,47.3191,-122.191,2020,6400,7567,8420,1990,20,20
4,2.5,2701,5821,2,0,0,3,7,2701,0,47.2873,-122.177,2566,5843,8522,8409,2701,6,6
3,2,1680,81893,1,0,0,3,7,1680,0,47.3248,-122.179,2480,38637,83573,41117,1680,28,28
3,1.75,1100,7373,1,0,0,4,7,1100,0,47.3124,-122.183,1430,8415,8473,9845,1100,51,51
3,1.75,1900,36769,1,0,0,3,8,1900,0,47.3041,-122.066,1950,35847,38669,37797,1900,32,32
3,1.75,1628,286355,1,0,0,3,7,1628,0,47.2558,-122.122,1490,216344,287983,217834,1628,23,23
3,1.75,1460,10000,1,0,0,4,8,1460,0,47.342,-122.195,1930,14175,11460,16105,1460,52,52
3,2.5,2880,426452,2,0,3,3,7,2880,0,47.2485,-122.101,1460,320890,429332,322350,2880,40,40
3,1.75,1980,9220,2,0,0,3,8,1980,0,47.2602,-122.219,2080,8305,11200,10385,1980,32,32
4,2.5,1890,6962,2,0,0,3,8,1890,0,47.3328,-122.187,2170,6803,8852,8973,1890,22,22
4,2.5,4090,215186,2,0,0,4,8,3670,420,47.2964,-122.116,2430,142005,219276,144435,4090,40,40
3,2.5,2720,6014,2,0,0,3,7,2720,0,47.3344,-122.174,2760,6537,8734,9297,2720,17,17
3,2.5,2620,78843,1,0,3,4,7,1310,1310,47.2584,-122.093,2330,130244,81463,132574,2620,55,55
4,2.25,2140,8874,2,0,0,3,8,2140,0,47.2654,-122.217,2140,8789,11014,10929,2140,33,33
4,2.5,1720,5805,2,0,0,3,8,1720,0,47.3286,-122.208,2360,7700,7525,10060,1720,19,19
3,2.5,1608,4818,2,0,0,3,8,1608,0,47.2583,-122.203,2009,5200,6426,7209,1608,7,7
4,1,1430,8355,1,0,0,4,7,1430,0,47.3178,-122.174,1550,7938,9785,9488,1430,36,36
3,2.25,1590,9200,1,0,0,4,7,1110,480,47.2917,-122.184,1880,9200,10790,11080,1590,40,40
3,2.5,2242,5744,2,0,0,3,8,2242,0,47.2597,-122.199,2009,5712,7986,7721,2242,7,7
5,2.5,2570,61855,1,0,0,4,7,1470,1100,47.3013,-122.109,1990,49658,64425,51648,2570,38,38
4,3,2830,213879,2,0,0,4,8,2830,0,47.2925,-122.107,2250,213008,216709,215258,2830,32,32
3,2,1570,5250,1,0,0,3,7,1570,0,47.3163,-122.188,1570,5250,6820,6820,1570,21,21
3,2,1560,32137,1,0,0,5,7,910,650,47.3197,-122.117,1470,29150,33697,30620,1560,43,43
3,2.25,1950,9600,1,0,0,4,7,1200,750,47.2762,-122.148,1760,8850,11550,10610,1950,32,32
4,2.5,2230,6487,2,0,0,3,7,2230,0,47.3287,-122.169,2230,6882,8717,9112,2230,16,16
4,2.5,2578,4554,2,0,0,3,9,2578,0,47.2603,-122.194,2647,4554,7132,7201,2578,5,5
3,2.5,1572,4000,2,0,0,3,8,1572,0,47.2615,-122.198,1608,5175,5572,6783,1572,6,6
4,2.5,2623,7184,2,0,0,3,8,2623,0,47.259,-122.202,2010,4939,9807,6949,2623,7,7
5,2.75,2720,193406,1,0,4,4,7,1700,1020,47.2838,-122.121,2820,248292,196126,251112,2720,51,51
4,2.5,2430,5366,2,0,0,3,8,2430,0,47.3352,-122.19,2100,5414,7796,7514,2430,17,17
3,1.75,1300,7958,1,0,0,3,7,1300,0,47.3162,-122.194,1640,8698,9258,10338,1300,23,23
3,2.5,3110,217800,2,0,0,3,9,3110,0,47.3281,-122.124,2220,217800,220910,220020,3110,18,18
4,2.5,2570,6466,2,0,0,3,9,2570,0,47.3324,-122.17,2520,6667,9036,9187,2570,20,20
3,1.75,1520,7500,1,0,0,3,8,1520,0,47.2646,-122.219,2180,7506,9020,9686,1520,34,34
4,2.5,2598,5553,2,0,0,3,9,2598,0,47.3412,-122.178,2502,4900,8151,7402,2598,5,5
3,2,1190,6833,1,0,0,3,7,1190,0,47.3191,-122.18,1540,8000,8023,9540,1190,24,24
4,2.5,1983,6002,2,0,0,3,9,1983,0,47.3281,-122.164,2502,4750,7985,7252,1983,7,7
3,2.75,2540,8604,2,0,0,3,8,2540,0,47.3209,-122.185,2260,7438,11144,9698,2540,28,28
3,1.75,1880,11700,1,0,0,4,7,1880,0,47.3213,-122.187,2230,35200,13580,37430,1880,51,51
3,2,1290,5757,1,0,0,3,7,1290,0,47.3175,-122.17,1580,6798,7047,8378,1290,25,25
4,2.75,2570,7264,2,0,0,3,8,1720,850,47.258,-122.208,2420,7911,9834,10331,2570,21,21
3,2.25,1552,3600,2,0,0,3,7,1552,0,47.3198,-122.178,1677,3600,5152,5277,1552,7,7
3,2.5,1520,9864,1,0,0,3,7,1160,360,47.3186,-122.171,1580,7425,11384,9005,1520,26,26
4,3.25,4386,12275,1,0,0,3,10,2356,2030,47.3329,-122.2,3060,10925,16661,13985,4386,13,13
4,2.5,2701,4500,2,0,0,3,9,2701,0,47.2586,-122.194,2570,4800,7201,7370,2701,5,5
4,3,2040,7145,1,0,0,3,8,1490,550,47.3275,-122.171,1940,7145,9185,9085,2040,25,25
4,1.75,2190,125452,1,0,2,3,9,2190,0,47.2703,-122.069,3000,125017,127642,128017,2190,51,51
4,3,2040,5050,1,0,0,3,8,1490,550,47.3266,-122.175,2020,6118,7090,8138,2040,26,26
3,2.25,2120,3400,2,0,0,3,7,2120,0,47.3364,-122.17,2420,3400,5520,5820,2120,17,17
5,3.5,3480,12821,2,0,2,3,10,2890,590,47.2641,-122.215,3400,9870,16301,13270,3480,15,15
3,2.5,2200,34680,2,0,0,3,9,2200,0,47.3139,-122.116,2560,35840,36880,38400,2200,34,34
4,4.25,4883,26040,2,0,3,3,10,3859,1024,47.263,-122.216,3736,9870,30923,13606,4883,13,13
4,2.5,2880,213444,1,0,0,5,8,2140,740,47.2887,-122.109,2810,213444,216324,216254,2880,35,35
3,2.5,1680,6755,2,0,0,3,8,1680,0,47.3293,-122.17,1860,7257,8435,9117,1680,25,25
3,2.5,2190,7904,2,0,0,3,8,2190,0,47.2617,-122.21,2190,7669,10094,9859,2190,24,24
4,2.5,2710,5880,2,0,0,3,9,2710,0,47.3314,-122.172,2520,6000,8590,8520,2710,21,21
3,1.75,1310,8670,1,0,0,4,6,1310,0,47.3156,-122.186,2622,7191,9980,9813,1310,35,35
3,1.75,1500,7800,1,0,0,3,7,1500,0,47.3141,-122.192,1490,7800,9300,9290,1500,51,51
4,2.5,2540,6688,2,0,0,3,9,2540,0,47.3314,-122.18,2810,6776,9228,9586,2540,17,17
3,2.5,2110,208737,2,0,3,3,9,2110,0,47.2674,-122.072,2390,125017,210847,127407,2110,42,42
3,2.5,2680,7836,2,0,0,3,8,2680,0,47.3203,-122.185,2340,8040,10516,10380,2680,29,5
1,1,720,123710,1,0,0,4,6,720,0,47.2893,-122.084,1860,297514,124430,299374,720,84,84
5,2.5,2180,8240,1,0,0,4,8,1220,960,47.3122,-122.191,2050,7590,10420,9640,2180,42,42
4,2.5,2590,11018,2,0,0,3,8,2590,0,47.2634,-122.211,2400,8042,13608,10442,2590,21,21
3,1.75,2280,139392,1,0,0,3,8,2280,0,47.291,-122.118,2280,117176,141672,119456,2280,42,42
4,2.5,2568,5000,2,0,0,3,9,2568,0,47.2596,-122.194,2547,4500,7568,7047,2568,5,5
4,1.75,2040,15000,1,0,0,4,7,1360,680,47.3107,-122.189,2310,15000,17040,17310,2040,52,52
4,2.5,2708,4772,2,0,0,3,9,2708,0,47.3413,-122.178,2502,4900,7480,7402,2708,5,5
3,1.75,1260,15000,1,0,0,4,7,1260,0,47.2737,-122.153,2400,21715,16260,24115,1260,36,36
3,2.25,1860,12000,1,0,0,4,7,1860,0,47.2942,-122.19,1815,9604,13860,11419,1860,43,43
4,2,1980,10051,1,0,0,3,7,1980,0,47.3231,-122.103,1520,10125,12031,11645,1980,50,11
3,1.75,1330,9200,1,0,0,4,7,1330,0,47.2916,-122.185,1590,9200,10530,10790,1330,46,46
3,2.5,2860,43821,2,0,0,4,9,2860,0,47.3163,-122.142,2370,65340,46681,67710,2860,29,29
4,2.5,1960,5642,2,0,0,3,7,1960,0,47.3167,-122.187,1870,5250,7602,7120,1960,21,21
3,3.25,2090,51212,1,0,0,3,8,1510,580,47.3097,-122.099,2690,40820,53302,43510,2090,30,30
4,1.75,1560,31299,1,0,0,4,7,1560,0,47.3384,-122.164,2460,44907,32859,47367,1560,54,54
4,2.75,4140,24190,2,0,0,3,11,4140,0,47.3062,-122.15,3950,24190,28330,28140,4140,17,17
4,2.5,2303,3826,2,0,0,3,8,2303,0,47.3258,-122.165,2516,4500,6129,7016,2303,13,13
3,2.5,1970,7500,2,0,0,3,8,1970,0,47.2658,-122.218,1950,8220,9470,10170,1970,31,31
4,2.5,2310,6320,2,0,0,3,8,2310,0,47.3287,-122.167,1850,6181,8630,8031,2310,22,22
4,2.5,2470,35073,2,0,0,3,9,2470,0,47.3064,-122.108,2990,35259,37543,38249,2470,30,30
5,2.5,2500,13034,1,0,0,3,7,1300,1200,47.3343,-122.194,2440,13300,15534,15740,2500,57,57
3,2.75,3370,13929,2,0,0,3,9,2650,720,47.3411,-122.197,2150,14048,17299,16198,3370,33,33
3,1,1180,32214,1,0,0,3,7,1180,0,47.3313,-122.198,2300,13714,33394,16014,1180,67,67
3,2.25,1680,35127,2,0,0,3,7,1680,0,47.3025,-122.067,1820,35166,36807,36986,1680,32,32
3,1.5,1580,7200,1,0,0,4,7,1080,500,47.2761,-122.152,1580,7470,8780,9050,1580,43,43
4,2.5,2750,6259,2,0,0,3,9,2750,0,47.3304,-122.179,2810,6824,9009,9634,2750,17,17
4,2,1750,7245,1,0,0,4,7,1050,700,47.3164,-122.196,1640,7245,8995,8885,1750,45,45
3,1.75,1320,35100,1,0,0,3,7,1320,0,47.312,-122.129,1660,35100,36420,36760,1320,29,29
3,1.75,1900,8910,2,0,0,4,7,1900,0,47.2769,-122.145,1610,8586,10810,10196,1900,31,31
3,2.5,2250,7294,2,0,0,3,8,2250,0,47.2636,-122.212,2140,7363,9544,9503,2250,25,25
3,2.25,2630,9916,2,0,0,4,9,2630,0,47.3314,-122.202,2470,10810,12546,13280,2630,31,31
5,2.25,2600,8075,1,0,0,4,8,2600,0,47.2961,-122.188,2200,8800,10675,11000,2600,50,50
4,1.5,1890,43560,1,0,0,4,8,1890,0,47.3267,-122.166,2376,5820,45450,8196,1890,45,45
3,1.75,1390,9328,1,0,0,4,7,1390,0,47.2766,-122.146,1550,8374,10718,9924,1390,32,32
4,2.5,3361,5038,2,0,0,3,9,3361,0,47.3269,-122.165,2316,4105,8399,6421,3361,5,5
5,2.5,2100,17825,1,0,0,4,7,1400,700,47.3094,-122.191,2200,14602,19925,16802,2100,45,45
3,2.5,2060,5115,2,0,0,3,9,2060,0,47.3261,-122.163,2648,4500,7175,7148,2060,5,5
3,2.25,1400,31626,1,0,0,2,7,1140,260,47.3029,-122.069,1680,35093,33026,36773,1400,32,32
3,1.75,1720,7587,1,0,0,4,7,1140,580,47.3175,-122.182,1120,7287,9307,8407,1720,38,38
3,2.5,1780,6527,2,0,0,3,8,1780,0,47.2578,-122.217,2040,8840,8307,10880,1780,30,30
4,2.5,1940,7040,2,0,0,3,8,1940,0,47.2632,-122.209,2400,7145,8980,9545,1940,21,21
4,2.5,2430,5959,2,0,0,3,8,2430,0,47.3348,-122.19,2100,5414,8389,7514,2430,17,17
3,1.75,1890,93218,1,0,0,4,7,1890,0,47.2568,-122.07,1690,172062,95108,173752,1890,55,55
3,2.25,1422,3677,2,0,0,3,7,1422,0,47.3204,-122.178,1677,3677,5099,5354,1422,7,7
4,2.5,2490,8290,2,0,0,3,9,2490,0,47.3305,-122.171,2690,7008,10780,9698,2490,20,20
4,1.75,2200,7600,2,0,0,3,8,2200,0,47.3131,-122.191,1910,7600,9800,9510,2200,41,41
2,1.5,1360,1898,2,0,0,3,7,1360,0,47.2852,-122.19,1360,1898,3258,3258,1360,41,41
3,2.25,1820,99752,1,0,0,4,7,1820,0,47.2838,-122.006,1850,117612,101572,119462,1820,50,50
4,3,3110,7231,2,0,0,3,8,3110,0,47.3279,-122.191,2820,7311,10341,10131,3110,22,22
4,2.5,2009,5000,2,0,0,3,8,2009,0,47.2577,-122.198,2009,5182,7009,7191,2009,5,5
4,2.5,2009,4800,2,0,0,3,8,2009,0,47.2586,-122.2,1798,4800,6809,6598,2009,7,7
4,2.5,2490,8124,2,0,0,3,7,2490,0,47.3347,-122.17,2760,6300,10614,9060,2490,18,18
4,3,4060,35621,1,0,0,3,9,2030,2030,47.3059,-122.108,2950,35259,39681,38209,4060,30,30
3,1.75,1420,7920,1,0,0,4,7,1420,0,47.2931,-122.188,1420,7920,9340,9340,1420,57,57
4,2.5,3160,8726,2,0,0,3,9,3160,0,47.2582,-122.223,2500,8648,11886,11148,3160,20,20
3,1.75,1610,9000,1,0,0,4,7,1100,510,47.3187,-122.179,1610,8000,10610,9610,1610,41,41
3,2.5,2270,7917,2,0,0,3,8,2270,0,47.2643,-122.22,2160,7917,10187,10077,2270,33,33
5,2.75,2844,3990,2,0,0,3,8,2844,0,47.3259,-122.167,2273,3900,6834,6173,2844,6,6
4,1.75,2600,18042,1,0,0,4,8,2020,580,47.2969,-122.189,2200,9408,20642,11608,2600,50,50
3,2.5,2360,8093,2,0,0,3,8,2360,0,47.3257,-122.17,1860,6762,10453,8622,2360,24,24
3,3.5,4500,21870,2,0,0,3,10,4500,0,47.3043,-122.159,4670,23058,26370,27728,4500,15,15
3,1,1410,40500,1,0,0,4,7,1410,0,47.3199,-122.1,1570,40500,41910,42070,1410,58,58
4,2.5,3030,180263,2,0,0,3,7,2030,1000,47.2953,-122.097,2600,182509,183293,185109,3030,32,32
3,2,1490,9285,1,0,0,3,8,1490,0,47.3248,-122.169,2040,6681,10775,8721,1490,24,24
4,2.5,2050,7416,2,0,0,3,8,2050,0,47.2658,-122.219,2050,7920,9466,9970,2050,29,29
4,3,2620,35124,2,0,0,3,9,2620,0,47.3067,-122.116,2920,35807,37744,38727,2620,32,32
3,2.5,2420,7423,2,0,0,3,8,2420,0,47.3199,-122.186,2260,7629,9843,9889,2420,29,29
4,2.5,2130,9268,2,0,0,4,8,2130,0,47.262,-122.22,2100,8400,11398,10500,2130,34,34
3,1.75,1720,9125,1,0,0,4,7,1140,580,47.3173,-122.181,1120,7506,10845,8626,1720,38,38
3,2.5,2242,4995,2,0,0,3,8,2242,0,47.2595,-122.202,1798,4942,7237,6740,2242,8,8
3,2.25,2080,9740,2,0,0,3,8,2080,0,47.261,-122.219,2080,8705,11820,10785,2080,31,31
3,1,1490,57381,1,0,0,4,5,1490,0,47.2597,-122.228,1580,101529,58871,103109,1490,87,87
3,2.5,1980,6608,2,0,0,3,8,1980,0,47.2642,-122.213,2150,7495,8588,9645,1980,25,25
4,2,2930,12840,1,0,0,4,8,2930,0,47.2957,-122.187,1960,10920,15770,12880,2930,54,54
4,2.5,2311,4396,2,0,0,3,9,2311,0,47.3276,-122.163,2458,4616,6707,7074,2311,5,5
3,2.5,2517,3900,2,0,0,3,8,2517,0,47.3211,-122.182,2390,7108,6417,9498,2517,5,5
3,1.75,1650,8073,1,0,0,3,7,1100,550,47.3187,-122.182,1280,8073,9723,9353,1650,39,39
4,2.5,2906,5893,2,0,0,3,9,2906,0,47.2599,-122.192,2680,4950,8799,7630,2906,5,5
3,1,1290,189486,1,0,0,4,7,1290,0,47.3356,-122.157,2370,98881,190776,101251,1290,59,59
4,2.25,2340,217014,1,0,0,4,8,2340,0,47.2953,-122.083,2340,107898,219354,110238,2340,37,37
2,0.75,700,16828,1,0,0,4,6,700,0,47.3009,-122.125,2010,29316,17528,31326,700,61,61
5,2.75,2400,8050,2,0,0,3,8,2400,0,47.2635,-122.209,2400,8050,10450,10450,2400,21,21
4,2.25,1677,3600,2,0,0,3,7,1677,0,47.32,-122.178,1677,3600,5277,5277,1677,7,7
3,2.25,1560,35026,1,0,0,3,7,1290,270,47.3023,-122.069,1660,35160,36586,36820,1560,34,34
4,2.25,1970,7200,2,0,0,3,8,1970,0,47.3132,-122.182,1790,7500,9170,9290,1970,40,40
3,2.25,2200,8375,2,0,0,3,8,2200,0,47.2626,-122.218,2200,10002,10575,12202,2200,31,31
3,1.75,1370,14030,1,0,0,4,8,1370,0,47.2969,-122.163,2100,15260,15400,17360,1370,42,42
3,2.5,2240,7500,2,0,0,3,8,2240,0,47.265,-122.22,2190,7506,9740,9696,2240,34,34
2,2.5,2550,216344,2,0,0,3,7,2550,0,47.2584,-122.124,1750,289978,218894,291728,2550,26,26
3,1.75,1330,36537,1,0,0,4,7,1330,0,47.3126,-122.129,1650,35100,37867,36750,1330,30,30
4,2.5,2718,6197,2,0,0,3,8,2718,0,47.3255,-122.164,2667,5000,8915,7667,2718,13,13
3,1,1590,11200,1,0,0,4,7,1590,0,47.2894,-122.188,1560,9750,12790,11310,1590,58,58
4,2.5,2810,10951,2,0,0,3,8,2810,0,47.3249,-122.187,1680,6625,13761,8305,2810,16,16
3,2.5,1450,8977,1,0,0,3,8,1450,0,47.2576,-122.214,2410,8850,10427,11260,1450,29,29
3,1.75,1397,18000,1,0,0,3,7,1397,0,47.3388,-122.166,1950,31294,19397,33244,1397,54,0
3,1,1310,22652,1,0,0,3,7,1310,0,47.2574,-122.072,1600,103672,23962,105272,1310,51,51
3,1.75,2250,26337,1,0,0,3,8,2250,0,47.3032,-122.123,1830,26337,28587,28167,2250,39,39
3,2.5,1630,8346,1,0,0,3,8,1630,0,47.2622,-122.219,2110,8619,9976,10729,1630,29,29
3,1.5,1410,8800,1,0,0,4,7,1410,0,47.2927,-122.183,2180,10108,10210,12288,1410,54,54
4,2.5,2650,6366,2,0,0,3,9,2650,0,47.3325,-122.171,2650,6200,9016,8850,2650,21,21
3,1.75,3020,360241,2,0,0,3,8,3020,0,47.2662,-122.088,1890,209959,363261,211849,3020,27,27
4,2.5,1920,8497,2,0,0,3,8,1920,0,47.2608,-122.209,1940,8436,10417,10376,1920,21,21
3,2.5,2056,3564,2,0,0,3,7,2056,0,47.338,-122.181,2056,3577,5620,5633,2056,5,5
5,3.25,3850,16249,2,0,2,3,9,3030,820,47.3324,-122.168,2640,7393,20099,10033,3850,17,17
4,1.75,2670,189486,2,0,4,3,8,2670,0,47.2585,-122.061,2190,218610,192156,220800,2670,47,47
3,1.75,1100,10125,1,0,0,4,7,1100,0,47.3232,-122.103,1520,10125,11225,11645,1100,50,50
3,2.5,2500,21780,1,0,0,3,8,1770,730,47.3282,-122.198,2670,23400,24280,26070,2500,33,33
4,2.5,2820,39413,2,0,0,4,9,2820,0,47.3064,-122.1,2910,39413,42233,42323,2820,30,30
4,2.75,2200,268329,1,0,0,3,7,1410,790,47.3224,-122.122,2240,58806,270529,61046,2200,30,30
3,3.25,3890,3452,2,0,0,3,12,2890,1000,47.626,-122.323,2860,2199,7342,5059,3890,13,13
3,2.5,950,1110,2,0,0,3,8,950,0,47.6226,-122.319,1230,1215,2060,2445,950,16,16
2,1,1070,2880,1,0,0,3,7,1070,0,47.6261,-122.324,2030,2880,3950,4910,1070,117,117
3,3.25,1490,902,3,0,0,3,8,1220,270,47.6357,-122.324,1550,1092,2392,2642,1490,18,18
5,3,3730,5500,1,0,0,3,7,2160,1570,47.6507,-122.32,1890,5500,9230,7390,3730,92,92
4,2,1590,6750,1,0,0,3,7,1590,0,47.6406,-122.317,2370,4500,8340,6870,1590,68,68
3,1.75,1650,3200,1,0,0,3,8,1650,0,47.6209,-122.317,1500,2400,4850,3900,1650,118,118
3,2.5,1550,1092,3,0,0,3,8,1390,160,47.6355,-122.324,1550,1079,2642,2629,1550,15,15
3,2.5,2200,1970,2,0,0,3,9,1610,590,47.6426,-122.327,1890,3505,4170,5395,2200,11,11
3,2.25,3170,5000,2,0,0,5,10,2230,940,47.6349,-122.318,3170,5400,8170,8570,3170,44,44
3,2.25,1300,907,2,0,0,3,8,1000,300,47.6371,-122.327,1300,1169,2207,2469,1300,13,13
3,3,2400,4000,2,0,0,3,7,1860,540,47.6288,-122.321,1750,3940,6400,5690,2400,114,114
3,2.5,1420,1438,2,0,0,3,9,1280,140,47.6265,-122.323,1490,1439,2858,2929,1420,16,16
3,1.75,1280,2147,1,0,0,4,7,1280,0,47.6362,-122.324,2010,2640,3427,4650,1280,109,109
4,2.25,2630,4000,2,0,0,5,9,1810,820,47.6393,-122.317,2370,4700,6630,7070,2630,110,110
4,2.5,2960,4760,2,0,0,3,8,2160,800,47.6367,-122.318,1600,4760,7720,6360,2960,119,119
2,2.5,1360,2070,2,0,0,3,8,1360,0,47.6423,-122.329,1920,2092,3430,4012,1360,20,20
2,1,1240,5500,1,0,0,3,7,1240,0,47.6461,-122.317,2080,4400,6740,6480,1240,65,65
3,2.5,2570,5000,2,0,0,3,11,2570,0,47.6295,-122.32,1570,5000,7570,6570,2570,35,35
3,3,1420,991,2,0,0,3,8,1040,380,47.6408,-122.327,1500,1301,2411,2801,1420,14,14
4,3,3130,2646,2,0,0,5,9,2290,840,47.6272,-122.316,2920,4500,5776,7420,3130,113,113
2,2.5,1680,1240,2,0,0,3,8,1120,560,47.6372,-122.324,2060,3630,2920,5690,1680,5,5
3,2.5,1480,1485,2,0,0,3,8,1280,200,47.6376,-122.326,1470,1277,2965,2747,1480,12,12
3,1.75,1600,2538,2,0,0,3,7,1600,0,47.6447,-122.327,1660,1750,4138,3410,1600,90,90
3,3.5,1730,1349,3,0,0,3,9,1350,380,47.6224,-122.326,1830,3300,3079,5130,1730,10,10
4,1,1820,4000,2,0,0,3,8,1820,0,47.6259,-122.321,2050,4000,5820,6050,1820,96,96
3,2.25,1290,1182,2,0,0,3,8,1000,290,47.637,-122.327,1300,1169,2472,2469,1290,13,13
2,1,710,1136,2,0,0,4,7,710,0,47.6414,-122.329,1370,1173,1846,2543,710,76,76
4,1.5,1650,2970,1,0,0,3,7,1650,0,47.6233,-122.319,1670,2970,4620,4640,1650,116,116
3,2.5,1995,1483,3,0,0,3,8,1760,235,47.6025,-122.31,1520,1173,3478,2693,1995,14,14
4,3.5,2860,2199,3,0,0,3,10,2860,0,47.6262,-122.323,1990,1378,5059,3368,2860,6,6
2,1.75,1150,2723,1,0,0,4,7,770,380,47.6357,-122.322,1440,4000,3873,5440,1150,96,96
4,1.75,4060,5500,2,0,0,5,9,2660,1400,47.6437,-122.321,3320,5500,9560,8820,4060,95,95
2,1,1110,3500,1,0,0,3,6,970,140,47.6453,-122.327,1884,1778,4610,3662,1110,107,107
3,2.5,2070,13241,1,0,0,5,9,1270,800,47.6415,-122.315,2200,4500,15311,6700,2070,109,109
2,2.5,1990,1756,3,0,0,3,9,1780,210,47.6264,-122.323,1955,1438,3746,3393,1990,14,14
3,3,1384,1287,2,0,0,3,8,1144,240,47.6295,-122.32,1570,1288,2671,2858,1384,13,13
0,0,3064,4764,3,0,2,3,7,3064,0,47.6362,-122.322,2360,4000,7828,6360,3064,29,29
4,3.75,4090,24825,2,0,0,4,11,3400,690,47.6338,-122.319,3910,11500,28915,15410,4090,93,93
3,2.5,1070,1155,2,0,0,3,7,720,350,47.5617,-122.385,1120,2594,2225,3714,1070,14,14
6,3,2890,2370,2,0,0,3,7,2290,600,47.6227,-122.323,2180,2460,5260,4640,2890,113,113
5,3.75,6810,7500,2,0,0,3,13,6110,700,47.6285,-122.322,2660,7500,14310,10160,6810,97,97
3,2.75,1540,1251,2,0,0,3,8,1230,310,47.6298,-122.321,1540,1287,2791,2827,1540,17,17
3,1,1580,3840,2,0,0,3,8,1580,0,47.6192,-122.319,1680,2624,5420,4304,1580,111,111
3,2.25,1750,1572,2,0,0,3,9,1470,280,47.6498,-122.321,2410,3050,3322,5460,1750,14,14
3,3,2060,3200,2,0,0,3,8,2060,0,47.637,-122.324,1760,2669,5260,4429,2060,112,31
5,2,2940,5500,2,0,0,4,9,2340,600,47.6466,-122.321,2940,5500,8440,8440,2940,110,110
2,2.25,1060,1208,2,0,0,3,8,940,120,47.6371,-122.327,1300,1169,2268,2469,1060,14,14
2,1,770,2971,1,0,2,3,7,770,0,47.6358,-122.322,1440,4000,3741,5440,770,96,96
2,2.75,1100,1088,2,0,0,3,7,750,350,47.6405,-122.324,2090,4125,2188,6215,1100,13,13
4,1.75,2040,5000,2,0,0,4,9,2040,0,47.6279,-122.315,3220,5600,7040,8820,2040,98,98
6,2.25,4910,6600,2,0,0,5,10,3580,1330,47.6458,-122.32,3280,5500,11510,8780,4910,109,109
2,2.25,1350,1248,2,0,0,3,7,1180,170,47.6399,-122.32,1760,3360,2598,5120,1350,19,19
3,1.75,1370,1990,3,0,0,3,9,1370,0,47.6434,-122.324,1730,1990,3360,3720,1370,5,5
3,2.5,1990,1891,3,0,0,3,9,1990,0,47.6271,-122.324,1990,3600,3881,5590,1990,7,7
3,3.5,1560,1490,2,0,0,3,8,1240,320,47.6248,-122.319,1560,1662,3050,3222,1560,24,24
3,1.75,1620,1325,2,0,0,3,9,1430,190,47.6498,-122.321,1750,1572,2945,3322,1620,14,14
3,2.5,2450,4400,2,0,0,4,9,1800,650,47.6439,-122.319,2220,5500,6850,7720,2450,97,97
4,1.75,1800,4180,2,0,3,4,8,1800,0,47.6462,-122.318,2180,4620,5980,6800,1800,98,98
4,1,1820,5400,1,0,0,3,8,1820,0,47.6476,-122.318,1820,5400,7220,7220,1820,96,0
2,2.5,1390,1132,2,0,0,3,8,1130,260,47.6228,-122.319,1400,1237,2522,2637,1390,13,13
3,2,2350,6000,1,0,0,4,8,1990,360,47.6476,-122.32,2010,5040,8350,7050,2350,97,97
3,1.75,1920,4000,1,0,0,3,7,1070,850,47.6392,-122.318,2280,4000,5920,6280,1920,69,69
2,2.25,1370,1248,2,0,0,3,7,1200,170,47.6399,-122.32,1800,3360,2618,5160,1370,19,19
3,2.5,2160,8809,1,0,0,3,9,1540,620,47.6994,-122.349,930,5420,10969,6350,2160,5,5
4,2.5,3170,4979,2,0,0,4,7,2570,600,47.6655,-122.34,2060,5000,8149,7060,3170,94,94
2,1,1120,3220,1,0,0,4,7,1120,0,47.6588,-122.344,1440,3220,4340,4660,1120,96,96
3,1.75,1630,1500,3,0,0,3,8,1630,0,47.6536,-122.354,1570,1335,3130,2905,1630,5,5
4,1.75,2040,6348,1,0,0,3,7,1020,1020,47.6964,-122.336,1770,5047,8388,6817,2040,57,57
3,2,2500,4080,1,0,0,5,7,1680,820,47.6813,-122.346,1550,3060,6580,4610,2500,97,97
2,1,1170,6000,1,0,0,4,7,970,200,47.6994,-122.354,2130,6002,7170,8132,1170,78,78
2,2.25,1140,1332,3,0,0,3,8,1140,0,47.6543,-122.356,1140,1267,2472,2407,1140,20,20
2,1,1740,5719,1,0,0,3,8,1740,0,47.6729,-122.335,1980,5000,7459,6980,1740,64,64
2,1.75,1260,5300,1,0,0,4,7,840,420,47.6809,-122.348,1280,3000,6560,4280,1260,68,68
3,1.5,1360,885,3,0,0,3,8,1360,0,47.6961,-122.349,1360,1167,2245,2527,1360,11,11
6,3.75,3010,4360,2,0,0,3,9,2000,1010,47.6873,-122.333,1600,5160,7370,6760,3010,5,5
3,1.75,1410,1197,3,0,0,3,8,1410,0,47.6558,-122.348,1350,2512,2607,3862,1410,7,7
3,2.5,1820,1545,3,0,2,3,8,1640,180,47.6523,-122.346,1440,1290,3365,2730,1820,21,21
4,1.75,1760,3600,1,0,0,5,7,880,880,47.6889,-122.33,1500,5580,5360,7080,1760,93,93
2,1.5,800,1196,2,0,0,3,8,800,0,47.6972,-122.341,1020,1087,1996,2107,800,16,16
3,1,1430,4240,1,0,0,3,7,1430,0,47.6595,-122.337,1660,4240,5670,5900,1430,95,95
2,1.5,1070,1200,2,0,0,3,7,1070,0,47.697,-122.347,1070,1200,2270,2270,1070,20,20
2,1,1510,4080,1,0,0,3,7,1010,500,47.6742,-122.329,1660,4080,5590,5740,1510,96,96
3,1.5,1290,1213,3,0,0,3,8,1290,0,47.6965,-122.34,1360,1227,2503,2587,1290,12,12
2,1.5,1010,948,3,0,0,3,8,1010,0,47.6529,-122.355,1330,1318,1958,2648,1010,20,20
4,1,1510,1501,1,0,0,3,7,1510,0,47.6526,-122.342,1560,1602,3011,3162,1510,113,113
3,1,1220,3000,1,0,0,3,6,1220,0,47.6506,-122.346,1350,3000,4220,4350,1220,118,118
2,1,1070,2754,1,0,0,3,7,830,240,47.6755,-122.331,1760,4080,3824,5840,1070,95,95
4,1.75,2370,5000,1,0,2,3,8,1770,600,47.6779,-122.357,2100,4550,7370,6650,2370,100,100
2,2,1650,6840,1,0,0,5,7,1650,0,47.6512,-122.338,1700,4560,8490,6260,1650,103,103
3,2.25,2110,2850,3,0,0,3,8,2110,0,47.6915,-122.339,1340,5001,4960,6341,2110,18,18
2,1,1200,6278,1,0,0,3,7,1080,120,47.7001,-122.351,1200,6211,7478,7411,1200,77,77
3,1.5,1320,1250,3,0,0,3,8,1320,0,47.6536,-122.341,1560,1694,2570,3254,1320,11,11
3,2.25,1480,1384,3,0,0,3,8,1480,0,47.691,-122.342,1310,1329,2864,2639,1480,11,11
3,2,1270,1323,3,0,0,3,8,1270,0,47.6934,-122.342,1330,1323,2593,2653,1270,13,13
5,2.5,2750,6000,1,0,0,3,8,1750,1000,47.6729,-122.334,1520,4158,8750,5678,2750,115,20
4,2.5,2750,4800,2,0,0,3,9,1960,790,47.6709,-122.337,2400,5300,7550,7700,2750,114,9
2,1,920,4400,1,0,0,3,7,920,0,47.6903,-122.332,1560,4600,5320,6160,920,71,71
2,1,880,5100,1,0,0,4,7,880,0,47.694,-122.346,980,5100,5980,6080,880,78,78
2,1,1470,7137,1,0,0,3,7,1020,450,47.7008,-122.352,1470,7067,8607,8537,1470,78,78
3,2.25,1140,1557,3,0,0,3,8,1140,0,47.6947,-122.342,1140,1245,2697,2385,1140,12,12
3,3.5,3530,3610,2,0,0,3,10,2370,1160,47.6857,-122.339,1780,3610,7140,5390,3530,11,11
5,3.25,3070,5000,2,0,0,3,9,2050,1020,47.6742,-122.356,2070,5000,8070,7070,3070,13,13
3,3.25,1290,1153,3,0,0,3,7,1290,0,47.6904,-122.346,1290,1200,2443,2490,1290,11,11
6,3.75,3810,6150,2,0,0,4,8,3810,0,47.694,-122.34,1830,5125,9960,6955,3810,42,42
2,1.5,1220,5000,1,0,2,4,7,1220,0,47.6624,-122.348,2090,3850,6220,5940,1220,81,81
3,2,1270,1348,3,0,0,3,8,1270,0,47.6929,-122.342,1180,1360,2618,2540,1270,16,16
3,2.25,1480,1026,3,0,0,3,8,1480,0,47.6536,-122.354,1570,1283,2506,2853,1480,5,5
2,1.5,1200,1687,3,0,0,3,8,1200,0,47.6491,-122.334,1240,1296,2887,2536,1200,11,11
3,1,1100,4080,1,0,0,4,7,900,200,47.6872,-122.351,1170,4080,5180,5250,1100,90,90
4,3,2550,3784,1,0,0,4,8,1750,800,47.6559,-122.338,2100,4560,6334,6660,2550,119,119
3,2,1640,4218,1,0,0,4,7,910,730,47.6546,-122.344,1670,4000,5858,5670,1640,78,78
2,1,890,4730,1,0,0,3,7,890,0,47.6876,-122.341,1330,5904,5620,7234,890,78,78
3,3,1560,2091,3,0,0,3,8,1560,0,47.6604,-122.352,1530,2091,3651,3621,1560,13,13
3,1,1510,4178,2,0,0,3,8,1510,0,47.6849,-122.335,2140,4916,5688,7056,1510,117,35
4,2,1910,6960,1,0,0,5,8,1910,0,47.6893,-122.348,1360,3300,8870,4660,1910,78,78
2,1,1140,3750,1,0,0,4,7,1140,0,47.6619,-122.343,1660,4000,4890,5660,1140,94,94
3,3.25,1460,1254,3,0,0,3,8,1460,0,47.6535,-122.353,1400,1255,2714,2655,1460,19,19
2,1,950,3960,1,0,0,3,7,950,0,47.6885,-122.337,1320,4050,4910,5370,950,78,78
3,1.75,1480,2200,2,0,0,3,7,1480,0,47.6969,-122.35,1360,2190,3680,3550,1480,24,24
2,1,960,4080,1,0,0,5,7,960,0,47.6893,-122.349,1300,4080,5040,5380,960,108,108
3,2.5,1770,1714,3,0,0,3,8,1770,0,47.6532,-122.348,1720,3360,3484,5080,1770,7,7
3,2,1340,3000,2,0,0,5,7,1340,0,47.6857,-122.349,1120,3000,4340,4120,1340,114,114
2,3.25,1400,1243,3,0,0,3,8,1400,0,47.6534,-122.353,1400,1335,2643,2735,1400,19,19
2,1,960,6700,1,0,0,3,7,960,0,47.6955,-122.357,1350,6700,7660,8050,960,68,68
2,1.5,1450,2550,1,0,0,3,7,820,630,47.6911,-122.348,1450,5100,4000,6550,1450,35,35
3,2.25,1650,946,3,0,0,3,8,1650,0,47.6536,-122.354,1570,1283,2596,2853,1650,5,5
2,1,1450,3090,2,0,0,3,7,1450,0,47.6853,-122.356,1450,4635,4540,6085,1450,100,27
3,2.25,1240,949,3,0,0,3,8,1240,0,47.6488,-122.334,1310,1140,2189,2450,1240,11,11
5,1.75,2344,4800,1,0,0,4,7,1544,800,47.6537,-122.335,1770,4200,7144,5970,2344,98,98
3,2.25,1420,983,3,0,0,3,8,1420,0,47.6533,-122.346,1530,1280,2403,2810,1420,13,13
3,1.5,2420,5000,2,0,0,4,8,2200,220,47.6744,-122.353,2070,5000,7420,7070,2420,94,94
3,3.25,1410,1350,3,0,0,3,8,1410,0,47.698,-122.34,1410,1253,2760,2663,1410,14,14
4,1.5,1500,3075,2,0,0,5,7,1420,80,47.6893,-122.35,1480,3774,4575,5254,1500,90,90
2,2.5,1260,1347,3,0,0,3,8,1260,0,47.6994,-122.341,1260,1356,2607,2616,1260,14,14
2,1.5,1030,798,3,0,0,3,8,1030,0,47.6975,-122.34,1020,1026,1828,2046,1030,11,11
4,2.5,2610,3277,1,0,0,5,8,1920,690,47.6636,-122.33,1810,3277,5887,5087,2610,97,97
3,3.25,2610,4500,1,0,0,4,9,1660,950,47.6701,-122.339,2110,4500,7110,6610,2610,110,110
4,1,1600,4300,1,0,0,4,7,1600,0,47.6648,-122.343,1610,4300,5900,5910,1600,103,103
1,1,720,5196,1,0,0,3,7,720,0,47.6928,-122.337,1580,5762,5916,7342,720,108,108
2,1.5,1020,1275,3,0,0,3,8,1020,0,47.7003,-122.346,980,1415,2295,2395,1020,11,11
3,3.5,1690,1765,2,0,0,3,8,1370,320,47.6536,-122.34,1690,1694,3455,3384,1690,13,13
3,1.75,1340,5100,1,0,0,3,7,1340,0,47.694,-122.348,1550,5100,6440,6650,1340,66,66
3,1.75,1820,5555,1,0,0,4,7,1030,790,47.6867,-122.352,1420,4000,7375,5420,1820,80,80
3,3,1280,1085,3,0,0,3,8,1280,0,47.6569,-122.346,1300,1310,2365,2610,1280,15,15
4,2.75,2420,4635,1,0,0,5,7,2420,0,47.682,-122.347,1590,3150,7055,4740,2420,114,114
3,2,1600,4510,1,0,0,3,7,990,610,47.6939,-122.34,1580,4561,6110,6141,1600,41,41
1,1,920,5000,1,0,3,4,7,920,0,47.6748,-122.352,1890,5000,5920,6890,920,113,113
2,1.75,1720,3000,1,0,0,5,7,860,860,47.686,-122.351,1360,4500,4720,5860,1720,94,94
2,2.25,1230,989,3,0,0,3,8,1230,0,47.6975,-122.348,1230,1223,2219,2453,1230,12,12
4,1,1590,4280,1,0,0,3,7,1590,0,47.667,-122.335,2230,4280,5870,6510,1590,95,95
3,1.75,1610,3210,1,0,0,5,7,910,700,47.6656,-122.335,1420,3210,4820,4630,1610,91,91
2,1,1180,5100,1,0,0,3,7,1180,0,47.6947,-122.346,980,5100,6280,6080,1180,93,93
3,3.75,2050,6000,2,0,0,5,7,1550,500,47.6873,-122.332,1780,4000,8050,5780,2050,109,109
3,1.5,1580,8841,1,0,0,5,7,1180,400,47.6931,-122.352,1580,7512,10421,9092,1580,96,96
2,1,760,7114,1,0,0,3,6,760,0,47.7005,-122.352,780,7102,7874,7882,760,73,73
2,1,940,3864,1,0,0,4,8,940,0,47.6631,-122.345,1440,3956,4804,5396,940,101,101
3,3,1680,1570,3,0,0,3,8,1680,0,47.6572,-122.346,1640,4800,3250,6440,1680,5,5
2,1,1310,4000,1,0,0,3,6,1310,0,47.6854,-122.329,1550,4000,5310,5550,1310,106,106
3,2,1460,6250,1,0,0,4,7,1460,0,47.6693,-122.333,1690,4750,7710,6440,1460,107,107
4,2,1550,4815,1,0,0,3,7,1550,0,47.667,-122.336,1680,4013,6365,5693,1550,110,110
3,2,1060,651,3,0,0,3,7,1060,0,47.6828,-122.345,1440,1501,1711,2941,1060,12,12
4,2.5,2350,3150,1,0,0,4,8,1690,660,47.6605,-122.335,1750,3150,5500,4900,2350,109,109
2,1,980,3080,1,0,0,3,7,980,0,47.6646,-122.339,1450,3333,4060,4783,980,109,69
4,2,1940,6350,1,0,0,4,7,970,970,47.6948,-122.357,960,6350,8290,7310,1940,68,68
2,2.25,1110,1290,3,0,0,3,8,1110,0,47.6968,-122.34,1360,1251,2400,2611,1110,13,13
3,2.5,1430,2200,1,0,0,4,7,1430,0,47.6601,-122.331,1740,4275,3630,6015,1430,109,109
3,0.75,1420,3060,1,0,0,4,7,860,560,47.6872,-122.346,1350,4000,4480,5350,1420,96,96
3,2.25,1700,1481,3,0,0,3,8,1700,0,47.6598,-122.349,1560,1350,3181,2910,1700,17,17
2,2.5,1380,953,3,0,0,3,9,1380,0,47.6654,-122.355,1430,3400,2333,4830,1380,13,13
3,1,1490,5700,1,0,0,3,7,1490,0,47.6549,-122.331,2290,5700,7190,7990,1490,103,103
3,2,2110,5800,1,0,0,4,7,1990,120,47.6645,-122.342,1620,4300,7910,5920,2110,92,92
3,1.5,1360,2030,3,0,0,3,8,1360,0,47.6961,-122.349,1360,1167,3390,2527,1360,11,11
2,1,1030,4841,1,0,0,3,7,920,110,47.686,-122.341,1530,4944,5871,6474,1030,80,80
3,1,1640,6516,1,0,0,4,7,1440,200,47.6693,-122.339,1770,4000,8156,5770,1640,84,84
2,1,1250,4320,1,0,0,4,7,850,400,47.6549,-122.352,1520,4320,5570,5840,1250,108,108
2,1,1410,5101,1,0,0,3,8,1410,0,47.6872,-122.333,1410,4224,6511,5634,1410,92,92
2,1,800,1200,2,0,0,3,7,800,0,47.6969,-122.347,806,1200,2000,2006,800,20,20
3,1,1640,4000,1,0,0,5,7,1640,0,47.6563,-122.351,2140,4000,5640,6140,1640,110,110
2,1.5,1110,1200,3,0,0,3,8,1110,0,47.6931,-122.342,1110,1363,2310,2473,1110,19,19
3,1.75,1080,3200,1,0,0,4,7,880,200,47.6503,-122.338,1780,5200,4280,6980,1080,93,93
2,1,850,3276,1,0,0,3,6,850,0,47.6742,-122.35,1460,4100,4126,5560,850,109,109
3,1.75,1630,1526,3,0,0,3,8,1630,0,47.6536,-122.354,1570,1274,3156,2844,1630,5,5
2,2.5,1175,1366,2,0,0,3,8,740,435,47.6962,-122.342,1710,1255,2541,2965,1175,14,14
3,2.5,1250,1103,3,0,2,3,8,1250,0,47.6619,-122.352,1250,1188,2353,2438,1250,14,14
3,2,2010,4000,1,0,0,5,7,1210,800,47.6638,-122.329,1770,4000,6010,5770,2010,104,104
3,2.5,1530,1131,3,0,0,3,8,1530,0,47.6993,-122.346,1530,1509,2661,3039,1530,10,10
3,2,2180,5440,1,0,0,5,7,1100,1080,47.657,-122.345,1470,4109,7620,5579,2180,115,115
3,1,1400,5100,1,0,0,3,7,1400,0,47.6677,-122.333,1740,3060,6500,4800,1400,119,119
3,3.25,1980,2850,3,0,0,3,7,1980,0,47.6597,-122.331,1630,4560,4830,6190,1980,32,32
3,2,1660,3600,1,0,0,3,7,1000,660,47.6789,-122.351,1700,4356,5260,6056,1660,80,8
4,3.25,3730,4560,2,0,0,3,9,2760,970,47.6725,-122.33,1800,4560,8290,6360,3730,4,4
3,2.5,1776,1248,3,0,0,3,8,1604,172,47.6539,-122.352,1780,1248,3024,3028,1776,13,13
4,2,2520,6000,1,0,0,3,8,1400,1120,47.6767,-122.35,1580,3720,8520,5300,2520,98,7
3,2.5,1390,1411,3,0,0,3,8,1390,0,47.6485,-122.334,1350,1266,2801,2616,1390,11,11
3,2.5,1990,4040,1,0,0,5,8,1390,600,47.6867,-122.354,1180,3030,6030,4210,1990,93,93
2,2.25,1140,1184,2,0,0,3,8,1010,130,47.659,-122.346,1140,1339,2324,2479,1140,20,20
3,1.75,1260,3328,1,0,0,5,6,700,560,47.6823,-122.349,1380,3536,4588,4916,1260,114,114
3,1,1460,7200,1,0,0,3,7,1260,200,47.6875,-122.336,1430,4650,8660,6080,1460,113,113
2,1,980,3800,1,0,0,3,7,980,0,47.6903,-122.34,1520,5010,4780,6530,980,93,93
5,2.5,2200,4080,1,0,0,5,7,1420,780,47.6872,-122.35,1300,4080,6280,5380,2200,103,103
2,1.75,1460,4800,1,0,0,5,7,850,610,47.6928,-122.339,2050,5592,6260,7642,1460,69,69
2,1.5,950,4625,1,0,0,4,7,950,0,47.6912,-122.34,1440,4625,5575,6065,950,70,70
3,1.75,2460,4240,1,0,0,4,7,1230,1230,47.6593,-122.337,1700,4240,6700,5940,2460,94,94
3,1,1830,3000,1,0,0,3,7,1430,400,47.6619,-122.351,1510,2500,4830,4010,1830,93,93
2,1,910,6282,1,0,0,4,7,910,0,47.6967,-122.354,970,6281,7192,7251,910,80,80
2,1,1170,3000,1,0,0,3,7,1170,0,47.6697,-122.338,1530,4000,4170,5530,1170,109,109
6,3,3300,4218,2,0,0,3,8,2200,1100,47.6557,-122.344,1420,4218,7518,5638,3300,49,49
4,2.5,2230,4372,2,0,0,5,8,1540,690,47.6698,-122.334,2020,4372,6602,6392,2230,84,84
3,3.25,1380,1120,3,0,0,3,8,1380,0,47.6617,-122.349,1310,1405,2500,2715,1380,11,11
4,2,2130,2800,1,0,0,5,7,1070,1060,47.6545,-122.333,1990,3990,4930,5980,2130,97,97
2,3,1650,960,3,0,0,3,8,1350,300,47.6611,-122.346,1650,3000,2610,4650,1650,4,4
3,2.25,1630,1598,3,0,0,3,8,1630,0,47.6904,-122.347,1320,1605,3228,2925,1630,11,11
1,1,390,2000,1,0,0,4,6,390,0,47.6938,-122.347,1340,5100,2390,6440,390,99,99
2,2,1980,6000,1,0,0,5,7,1220,760,47.6809,-122.351,1280,3900,7980,5180,1980,113,113
3,1,1140,4600,1,0,0,3,7,1140,0,47.6897,-122.337,1370,5000,5740,6370,1140,77,77
2,1,750,6350,1,0,0,3,5,750,0,47.6938,-122.356,920,6350,7100,7270,750,99,99
2,2.5,1280,940,2,0,0,3,8,1060,220,47.6904,-122.364,1290,2900,2220,4190,1280,13,13
4,3,2440,3600,1,0,0,5,8,1480,960,47.6853,-122.331,1770,4000,6040,5770,2440,90,90
3,2.5,1210,1420,3,0,0,3,8,1210,0,47.6977,-122.349,1190,1407,2630,2597,1210,11,11
4,2.75,2540,4400,1,0,0,5,7,1630,910,47.6832,-122.343,1560,3920,6940,5480,2540,94,94
6,3,2880,3192,2,0,0,4,8,2180,700,47.6506,-122.332,1870,4533,6072,6403,2880,100,100
3,1,1340,4120,1,0,0,4,7,1040,300,47.6916,-122.352,1270,4635,5460,5905,1340,98,98
2,2.5,1150,1027,3,0,0,3,8,1150,0,47.6534,-122.356,1360,1210,2177,2570,1150,11,11
3,1.75,1380,3225,1,0,0,4,7,940,440,47.6652,-122.338,1250,3750,4605,5000,1380,104,104
4,2,1380,4048,1,0,0,4,7,1380,0,47.6583,-122.344,1440,3956,5428,5396,1380,113,113
2,1.5,1090,4013,1,0,0,3,7,1090,0,47.6652,-122.338,1390,4013,5103,5403,1090,119,119
3,1,940,4200,1,0,0,3,7,940,0,47.6878,-122.35,1380,4080,5140,5460,940,64,64
3,1.75,1370,1921,3,0,0,3,8,1370,0,47.6595,-122.351,1370,4000,3291,5370,1370,12,12
4,2.5,2280,2432,2,0,0,5,8,1520,760,47.6605,-122.355,1690,2099,4712,3789,2280,98,98
4,2,1820,7626,1,0,0,5,7,990,830,47.6878,-122.342,1390,5904,9446,7294,1820,78,78
4,2.5,2800,4000,2,0,0,3,9,2800,0,47.6695,-122.339,1770,4200,6800,5970,2800,8,8
2,1,720,3255,1,0,0,4,6,720,0,47.6823,-122.348,1430,3170,3975,4600,720,114,114
33,1.75,1620,6000,1,0,0,5,7,1040,580,47.6878,-122.331,1330,4700,7620,6030,1620,72,72
3,1.5,1780,4200,1,0,0,4,8,1780,0,47.662,-122.349,1380,3333,5980,4713,1780,103,103
2,1,1190,5200,1,0,0,5,7,1190,0,47.6939,-122.348,1550,5100,6390,6650,1190,107,107
3,3.25,1410,1253,3,0,0,3,8,1410,0,47.6981,-122.34,1410,1253,2663,2663,1410,14,14
2,1.5,870,747,2,0,0,3,8,800,70,47.6967,-122.342,1710,1280,1617,2990,870,15,15
3,4,2080,2250,3,0,4,3,8,2080,0,47.6598,-122.355,2080,2250,4330,4330,2080,22,22
2,1,1270,3200,1,0,0,4,7,960,310,47.6565,-122.348,1410,1320,4470,2730,1270,99,99
3,1.75,1850,2797,1,0,0,3,8,1150,700,47.6871,-122.336,1450,4599,4647,6049,1850,42,42
3,1,1850,5000,1,0,0,3,7,1850,0,47.6727,-122.351,1850,5000,6850,6850,1850,97,97
3,2.25,1540,1005,3,0,0,3,8,1540,0,47.6828,-122.346,1510,1501,2545,3011,1540,11,11
3,2,1560,5130,1,0,0,5,7,1150,410,47.6913,-122.333,1560,4500,6690,6060,1560,104,104
3,2.75,2780,4000,2,0,2,5,8,1960,820,47.6565,-122.355,1490,4800,6780,6290,2780,115,115
2,1,1640,5515,1,0,0,4,7,940,700,47.6912,-122.334,2054,5515,7155,7569,1640,93,93
2,1,990,4000,1,0,0,4,7,990,0,47.6589,-122.341,1560,4000,4990,5560,990,108,108
2,1,830,2820,1,0,0,4,7,830,0,47.689,-122.347,1460,3150,3650,4610,830,99,99
3,2,1550,2401,2,0,0,3,7,1550,0,47.6545,-122.348,1550,3446,3951,4996,1550,23,23
5,3,3350,9450,2,0,0,5,8,2180,1170,47.6705,-122.34,2660,4500,12800,7160,3350,107,34
2,1,920,3780,1,0,0,3,6,920,0,47.6576,-122.348,1570,2640,4700,4210,920,109,109
3,1,800,2296,1,0,0,4,6,800,0,47.6546,-122.356,1480,1472,3096,2952,800,111,111
2,1.5,1010,3060,1,0,0,4,7,1010,0,47.6897,-122.354,1160,4080,4070,5240,1010,101,101
3,2.5,1430,1250,3,0,0,3,7,1430,0,47.6904,-122.342,1360,1269,2680,2629,1430,12,12
4,1,1140,5940,1,0,2,3,7,1140,0,47.6795,-122.354,1630,4000,7080,5630,1140,103,103
6,2.75,2980,5000,1,0,0,3,7,2480,500,47.6684,-122.331,1470,5000,7980,6470,2980,103,103
1,1,1230,3774,1,0,0,4,6,830,400,47.6886,-122.354,1300,3774,5004,5074,1230,95,95
4,3.5,2370,3302,2,0,0,3,8,1610,760,47.684,-122.341,2170,3800,5672,5970,2370,93,1
5,1.5,1940,4800,2,0,0,3,8,1940,0,47.6845,-122.332,1750,4800,6740,6550,1940,114,114
3,2,1990,3990,1,0,0,5,7,1130,860,47.6572,-122.333,1710,4000,5980,5710,1990,107,107
3,2,1460,2610,2,0,0,3,8,1460,0,47.6864,-122.345,1320,3000,4070,4320,1460,32,32
4,1,1540,2452,1,0,0,4,7,1540,0,47.6522,-122.348,1290,3360,3992,4650,1540,113,113
3,3.25,1540,1428,3,0,0,3,9,1540,0,47.6648,-122.353,1660,3300,2968,4960,1540,6,6
3,3.25,1370,1227,3,0,0,3,8,1370,0,47.6964,-122.341,1370,1236,2597,2606,1370,12,12
7,4,3440,8100,2,0,0,3,7,3440,0,47.6981,-122.349,1420,1560,11540,2980,3440,49,49
3,2.75,1210,3600,1,0,2,5,7,1210,0,47.6798,-122.354,1630,3910,4810,5540,1210,109,109
2,1.5,1160,1269,2,0,0,3,7,970,190,47.6608,-122.335,1700,3150,2429,4850,1160,14,14
3,2.5,1400,1312,3,0,0,3,8,1400,0,47.6534,-122.355,1350,1312,2712,2662,1400,12,12
4,4.5,3420,7440,3,0,0,3,9,3420,0,47.6875,-122.33,1360,5580,10860,6940,3420,5,5
3,2.75,1970,2600,2,0,0,3,8,1970,0,47.663,-122.335,1680,3120,4570,4800,1970,95,20
3,3,1430,1249,3,0,0,3,8,1430,0,47.6971,-122.34,1020,1112,2679,2132,1430,16,16
4,3.25,3320,8587,3,0,0,3,11,2950,370,47.691,-122.337,1860,5668,11907,7528,3320,11,11
2,2,1550,2400,1,0,0,4,7,1550,0,47.654,-122.346,1180,1224,3950,2404,1550,119,119
4,2,1690,3250,1,0,0,3,7,1550,140,47.6637,-122.346,1620,3250,4940,4870,1690,118,118
3,2.5,1620,1171,3,0,4,3,8,1470,150,47.6681,-122.355,1620,1505,2791,3125,1620,11,11
2,1.5,1170,1079,3,0,0,3,7,1170,0,47.6607,-122.333,1170,1116,2249,2286,1170,16,16
3,1,1760,3000,1,0,0,1,6,1760,0,47.6598,-122.348,1320,1266,4760,2586,1760,119,119
5,2.75,1800,3780,1,0,0,3,7,1400,400,47.6831,-122.343,1400,3780,5580,5180,1800,93,93
2,2.5,1780,1311,3,0,0,3,8,1350,430,47.6962,-122.34,1390,1227,3091,2617,1780,14,14
3,1,1370,3500,1,0,0,3,7,1370,0,47.6857,-122.348,1590,4500,4870,6090,1370,114,30
3,1,1620,3000,1,0,0,5,7,1620,0,47.6888,-122.347,1420,3060,4620,4480,1620,91,91
2,1,890,6350,1,0,0,3,6,890,0,47.6975,-122.357,1490,6350,7240,7840,890,76,76
4,1,2000,4800,2,0,0,4,7,2000,0,47.6583,-122.351,1260,1452,6800,2712,2000,108,108
3,2,2060,4040,1,0,0,4,8,1120,940,47.6798,-122.352,1500,4000,6100,5500,2060,72,72
4,3.25,1860,4356,2,0,0,3,9,1860,0,47.6785,-122.351,1860,4356,6216,6216,1860,102,10
3,3.25,1340,1151,3,0,0,3,7,1340,0,47.6904,-122.346,1290,1200,2491,2490,1340,11,11
4,2.5,2610,5140,2,0,0,3,8,2610,0,47.6951,-122.346,1190,5101,7750,6291,2610,13,13
1,1,670,1800,1,0,0,5,6,670,0,47.654,-122.35,1330,3360,2470,4690,670,114,114
3,2.25,2170,5001,2,0,0,3,8,2170,0,47.6937,-122.338,1700,6991,7171,8691,2170,5,5
4,1.5,2100,4560,1,0,0,4,8,2100,0,47.6497,-122.336,1930,4560,6660,6490,2100,107,107
3,2,1420,4080,1,0,0,5,8,1420,0,47.6801,-122.348,1220,3060,5500,4280,1420,115,115
2,2.5,1380,951,3,0,0,3,9,1380,0,47.6654,-122.355,1430,3400,2331,4830,1380,13,13
3,2,1340,1384,3,0,0,3,8,1340,0,47.6973,-122.35,1110,1384,2724,2494,1340,11,11
3,1.5,1360,1167,3,0,0,3,8,1360,0,47.6962,-122.349,1360,1167,2527,2527,1360,11,11
2,2.25,1260,1240,3,0,0,3,8,1260,0,47.6531,-122.352,1330,1300,2500,2630,1260,15,15
3,2.25,1190,1022,3,0,0,3,8,1190,0,47.6972,-122.349,1210,1171,2212,2381,1190,21,21
3,1.75,1800,4429,2,0,0,4,7,1800,0,47.6842,-122.357,1310,4429,6229,5739,1800,113,113
2,1.5,960,1000,2,0,0,3,8,920,40,47.6489,-122.335,1200,1297,1960,2497,960,11,11
2,1,1160,5395,1,0,0,3,7,860,300,47.7007,-122.354,1664,5363,6555,7027,1160,79,79
2,1,870,5689,1,0,0,4,7,870,0,47.6988,-122.351,1100,5711,6559,6811,870,71,71
3,1,1430,3455,1,0,0,3,7,980,450,47.6873,-122.336,1450,4599,4885,6049,1430,72,72
2,1,1440,3225,1,0,0,3,7,960,480,47.6653,-122.338,1160,3630,4665,4790,1440,104,104
2,1,970,3300,1,0,0,4,7,970,0,47.6609,-122.343,1060,3600,4270,4660,970,103,103
2,1,1140,3990,1,0,0,3,7,1140,0,47.6554,-122.333,1800,5700,5130,7500,1140,95,95
2,1,820,2723,1,0,0,3,7,820,0,47.6623,-122.339,1370,3850,3543,5220,820,98,98
2,1.75,1760,4400,1,0,0,4,7,880,880,47.65,-122.34,1330,4180,6160,5510,1760,89,89
3,2,1310,2550,1,0,0,3,7,780,530,47.6911,-122.35,1460,5100,3860,6560,1310,33,33
5,3.75,3330,5042,2,0,2,3,9,2470,860,47.6497,-122.339,1780,3990,8372,5770,3330,5,5
2,1.5,1960,6000,1,0,0,3,8,1210,750,47.6849,-122.333,2060,6000,7960,8060,1960,68,68
3,1.5,2040,3960,2,0,2,5,8,2040,0,47.6658,-122.355,1540,3400,6000,4940,2040,91,91
3,2,1410,6030,1,0,0,4,7,1410,0,47.6994,-122.347,1410,6300,7440,7710,1410,89,89
4,1,1680,4021,1,0,0,3,7,1680,0,47.6663,-122.332,1710,4021,5701,5731,1680,98,98
3,3,2340,2970,2,0,0,5,8,2160,180,47.6868,-122.348,1370,4000,5310,5370,2340,94,94
1,1,700,3876,1,0,0,3,6,700,0,47.6886,-122.352,1150,3952,4576,5102,700,109,109
4,2.5,2130,3420,1,0,0,4,7,1730,400,47.649,-122.336,1520,3420,5550,4940,2130,103,103
4,2.75,2490,3840,1,0,0,4,7,1610,880,47.6551,-122.344,1420,4000,6330,5420,2490,97,97
3,2.25,1420,990,3,0,0,3,8,1420,0,47.6801,-122.348,1350,1415,2410,2765,1420,11,11
3,1.75,1350,2325,3,0,0,3,7,1350,0,47.6965,-122.35,1520,1652,3675,3172,1350,20,20
3,2,2210,5000,1,0,2,3,7,1710,500,47.6754,-122.357,1920,5000,7210,6920,2210,110,110
5,1.5,1720,5000,1,0,0,3,8,1720,0,47.6627,-122.355,1720,5000,6720,6720,1720,104,104
2,1.75,1460,1500,2,0,0,3,8,1000,460,47.6853,-122.356,1440,4120,2960,5560,1460,11,11
3,1.5,1160,1031,3,0,0,3,8,1160,0,47.6538,-122.357,1268,1688,2191,2956,1160,11,11
2,2.25,1300,1314,3,0,0,3,8,1300,0,47.6536,-122.356,1300,1312,2614,2612,1300,11,11
3,1.5,1420,4500,1,0,0,3,7,1420,0,47.694,-122.332,1540,6375,5920,7915,1420,60,60
3,1,1500,3399,2,0,0,5,7,1300,200,47.6838,-122.352,1360,3588,4899,4948,1500,93,93
3,2.5,1480,2159,3,0,0,3,8,1480,0,47.6533,-122.341,1480,1554,3639,3034,1480,12,12
3,2,1220,1186,3,0,0,3,8,1220,0,47.6972,-122.341,1280,1251,2406,2531,1220,12,12
2,1,860,4013,1,0,0,3,7,860,0,47.6652,-122.338,1490,4013,4873,5503,860,94,94
2,1,820,3000,1,0,0,4,7,820,0,47.6842,-122.348,1490,3000,3820,4490,820,95,95
2,1,990,3120,1,0,2,5,7,790,200,47.68,-122.353,1930,3120,4110,5050,990,112,112
3,3,1260,1634,3,0,0,3,8,1260,0,47.697,-122.349,1260,1135,2894,2395,1260,21,21
3,1.75,2340,6750,1,0,0,5,7,1620,720,47.6956,-122.335,1410,3388,9090,4798,2340,105,105
2,1.5,1140,1058,3,0,0,3,7,1140,0,47.6608,-122.333,1170,1116,2198,2286,1140,14,14
3,2,1430,3480,1,0,0,3,7,980,450,47.6874,-122.336,1450,4650,4910,6100,1430,72,72
3,1.5,1220,835,1,0,0,4,6,1220,0,47.6981,-122.341,1360,1251,2055,2611,1220,69,69
3,3.5,1650,2262,3,0,0,3,8,1650,0,47.6823,-122.347,1620,3166,3912,4786,1650,9,9
2,1,990,4332,1,0,0,3,7,990,0,47.6528,-122.331,1920,3420,5322,5340,990,110,110
3,2.5,1570,1433,3,0,0,3,8,1570,0,47.6858,-122.336,1570,2652,3003,4222,1570,9,9
2,1,970,4284,1,0,0,3,7,970,0,47.6667,-122.333,2050,4284,5254,6334,970,114,114
4,2,1660,4800,1,0,0,3,7,1660,0,47.6556,-122.345,1660,4800,6460,6460,1660,97,97
3,3.25,1460,1367,3,0,0,3,8,1460,0,47.6485,-122.334,1310,1191,2827,2501,1460,11,11
2,1.75,1250,2890,1,0,0,4,7,790,460,47.6795,-122.353,1500,3225,4140,4725,1250,99,99
3,1.5,1140,1069,3,0,0,3,8,1140,0,47.6907,-122.342,1230,1276,2209,2506,1140,14,14
3,3.5,4360,6240,2,0,3,3,10,2960,1400,47.6791,-122.354,1920,3910,10600,5830,4360,11,11
2,2,1250,3360,1,0,0,3,7,1250,0,47.6526,-122.349,1250,3360,4610,4610,1250,62,62
3,1.5,2260,5300,1,0,0,3,7,1200,1060,47.6756,-122.348,1950,5000,7560,6950,2260,79,79
3,1,1270,3840,1,0,0,3,7,1270,0,47.6896,-122.357,1270,4175,5110,5445,1270,93,93
3,2.5,1540,1256,3,0,0,3,8,1540,0,47.6498,-122.346,1500,1350,2796,2850,1540,15,15
2,1.75,2120,6350,1,0,0,4,6,1440,680,47.6974,-122.356,1590,6350,8470,7940,2120,95,95
3,1,1530,2400,1,0,0,4,7,890,640,47.6543,-122.354,1240,2400,3930,3640,1530,91,91
2,1.5,690,1058,2,0,0,3,7,690,0,47.6951,-122.343,690,1058,1748,1748,690,14,14
6,4.5,2750,4400,2,0,0,3,8,1770,980,47.6883,-122.335,1860,4400,7150,6260,2750,32,32
3,2.5,1300,1331,3,0,0,3,8,1300,0,47.6607,-122.352,1450,5270,2631,6720,1300,12,12
4,1.5,1790,3952,1,0,0,4,8,1790,0,47.689,-122.352,1200,3876,5742,5076,1790,87,87
3,1.75,1560,3000,1,0,0,4,6,770,790,47.6846,-122.345,1390,3000,4560,4390,1560,101,101
2,2.5,1430,923,3,0,0,3,8,1410,20,47.6683,-122.355,1620,1505,2353,3125,1430,11,11
3,2.5,1420,1269,3,0,0,3,7,1420,0,47.6904,-122.342,1420,1300,2689,2720,1420,12,12
3,3.25,1410,1246,3,0,0,3,8,1410,0,47.6981,-122.34,1410,1253,2656,2663,1410,14,14
2,1,700,5829,1,0,0,3,6,700,0,47.6958,-122.357,1160,6700,6529,7860,700,74,74
2,1.75,1170,2400,1,0,0,4,7,740,430,47.6653,-122.333,1570,3919,3570,5489,1170,116,116
4,3,3310,4500,2,0,0,5,9,2910,400,47.6594,-122.345,1440,3750,7810,5190,3310,119,119
2,1,1240,5000,1,0,0,3,7,1000,240,47.6634,-122.351,1480,3500,6240,4980,1240,99,99
3,1.75,1350,4000,1,0,0,4,7,1350,0,47.6581,-122.354,1880,4000,5350,5880,1350,94,94
3,3.25,1300,1325,2,0,0,3,8,1080,220,47.6584,-122.346,1290,1323,2625,2613,1300,14,14
2,1,980,3350,1,0,0,4,7,980,0,47.6858,-122.352,1260,4000,4330,5260,980,94,94
4,3.5,3460,3997,2,0,0,3,10,2560,900,47.6718,-122.329,1860,4000,7457,5860,3460,15,15
2,1,1070,3000,1,0,0,4,7,870,200,47.6828,-122.353,1890,3300,4070,5190,1070,93,93
3,2,1340,2720,1,0,0,3,7,1340,0,47.6518,-122.335,2030,4590,4060,6620,1340,106,106
3,2,2070,4200,1,0,0,4,7,1670,400,47.6624,-122.333,1490,4560,6270,6050,2070,113,113
4,2,2190,4560,2,0,0,5,8,2190,0,47.662,-122.329,2190,4560,6750,6750,2190,109,109
2,1,1070,5000,1,0,0,3,7,1070,0,47.6631,-122.337,1400,4000,6070,5400,1070,95,95
2,1,1170,2800,1,0,0,4,5,1170,0,47.6574,-122.345,1660,4996,3970,6656,1170,114,114
2,1,960,3235,1,0,0,4,7,960,0,47.661,-122.344,1290,2069,4195,3359,960,103,103
4,2.75,2950,4560,2,0,0,5,7,1810,1140,47.6525,-122.333,2000,4560,7510,6560,2950,107,107
2,1,1220,4000,1,0,0,4,6,1220,0,47.6801,-122.354,1580,4000,5220,5580,1220,111,111
4,1,1980,4560,1,0,0,3,7,1980,0,47.6606,-122.331,1810,3245,6540,5055,1980,99,99
2,1.5,1090,1183,3,0,0,3,8,1090,0,47.6974,-122.349,1110,1384,2273,2494,1090,11,11
3,1,1280,3900,1,0,0,4,7,1280,0,47.6545,-122.336,2020,4560,5180,6580,1280,98,98
4,3,2390,4000,1,0,0,5,8,1460,930,47.6857,-122.331,1670,4000,6390,5670,2390,88,88
4,1,1780,4000,1,0,0,3,7,1780,0,47.6624,-122.354,1750,4000,5780,5750,1780,97,97
4,2,2230,4635,1,0,0,5,7,1510,720,47.682,-122.349,1520,4635,6865,6155,2230,111,111
4,2.5,2700,4590,2,0,0,3,8,2700,0,47.6734,-122.329,2080,3570,7290,5650,2700,17,17
3,1.75,2430,4524,1,0,0,4,7,1830,600,47.674,-122.35,1610,4100,6954,5710,2430,95,95
4,2,1890,4500,1,0,0,3,7,1490,400,47.6684,-122.356,1640,4010,6390,5650,1890,112,22
5,2,2050,3000,1,0,0,3,7,1470,580,47.6864,-122.352,1560,4500,5050,6060,2050,107,31
4,3.5,3290,5559,1,0,0,3,8,2290,1000,47.6788,-122.346,1790,6000,8849,7790,3290,113,11
3,2.25,1550,1469,3,0,0,3,8,1550,0,47.6911,-122.341,1520,1465,3019,2985,1550,15,15
2,1.5,680,772,2,0,0,3,7,680,0,47.695,-122.343,690,1059,1452,1749,680,14,14
3,1.75,1760,4125,1,0,3,4,7,1760,0,47.6748,-122.352,1760,4000,5885,5760,1760,92,92
4,1,1350,9000,1,0,0,4,7,1350,0,47.6953,-122.332,1940,8000,10350,9940,1350,55,55
3,2.25,1860,1558,3,0,0,3,8,1860,0,47.7006,-122.339,1760,2456,3418,4216,1860,5,5
3,2.75,2280,4280,1,0,0,5,7,1280,1000,47.6685,-122.335,1650,4280,6560,5930,2280,102,102
4,1,1080,6095,1,0,0,4,6,1080,0,47.6962,-122.346,1200,5060,7175,6260,1080,95,95
4,2.75,2660,4500,1,0,0,5,8,1860,800,47.6864,-122.347,1830,4000,7160,5830,2660,110,110
3,2.25,1390,1484,3,0,0,3,8,1390,0,47.6912,-122.343,1250,1087,2874,2337,1390,12,12
4,1,1210,3760,1,0,0,3,6,1210,0,47.6872,-122.344,1540,3800,4970,5340,1210,119,119
3,2,1780,5720,1,0,0,5,7,980,800,47.6794,-122.351,1620,5050,7500,6670,1780,94,94
3,2.5,1240,1115,3,0,0,3,8,1240,0,47.6985,-122.34,1410,1355,2355,2765,1240,16,16
4,3.75,3490,5625,2,0,0,3,9,2610,880,47.6685,-122.332,1940,5000,9115,6940,3490,5,5
3,2.25,1420,1309,3,0,0,3,8,1420,0,47.6534,-122.346,1500,1282,2729,2782,1420,13,13
2,1,1060,3040,1,0,0,3,7,860,200,47.6725,-122.329,1470,3814,4100,5284,1060,95,95
3,2,1580,5289,1,0,0,3,7,870,710,47.6881,-122.342,1310,5535,6869,6845,1580,79,79
5,3.5,2320,4960,2,0,0,5,7,1720,600,47.6763,-122.352,1700,4960,7280,6660,2320,93,93
2,2,1510,4000,1,0,0,4,7,1010,500,47.6582,-122.345,1920,4000,5510,5920,1510,119,119
3,2.25,2140,3000,2,0,0,3,9,2140,0,47.6767,-122.351,1430,4712,5140,6142,2140,114,8
3,2.5,1460,1319,3,0,0,3,8,1460,0,47.698,-122.349,1430,1530,2779,2960,1460,17,17
2,1,880,3000,1,0,0,5,7,880,0,47.6868,-122.349,1300,3000,3880,4300,880,92,92
2,2.25,1530,981,3,0,0,3,8,1480,50,47.6533,-122.346,1530,1282,2511,2812,1530,13,13
4,1.5,1790,3420,1,0,0,4,7,1020,770,47.6489,-122.337,1680,3420,5210,5100,1790,96,96
2,1.5,1400,5810,2,0,0,3,7,1400,0,47.6843,-122.341,1470,3920,7210,5390,1400,79,79
3,1,1310,5000,1,0,0,3,7,1310,0,47.6624,-122.347,1530,4800,6310,6330,1310,113,113
3,1.75,1480,2211,2,0,0,3,7,1480,0,47.6966,-122.35,1480,2197,3691,3677,1480,24,24
3,2.5,2440,7419,1,0,0,3,7,1520,920,47.6857,-122.334,2440,4880,9859,7320,2440,58,58
3,2,1420,4080,1,0,0,3,7,1420,0,47.6872,-122.349,1420,4590,5500,6010,1420,114,1
2,1,1010,3400,1,0,0,3,7,1010,0,47.6711,-122.329,1800,3600,4410,5400,1010,98,98
3,1.75,2080,3000,1,0,0,4,7,1040,1040,47.6853,-122.35,1000,3193,5080,4193,2080,94,94
3,1,1150,3000,1,0,0,5,6,1150,0,47.6867,-122.345,1460,3200,4150,4660,1150,113,113
6,3,3110,5000,1,0,0,5,7,1810,1300,47.6631,-122.348,1600,4000,8110,5600,3110,98,98
4,3,2200,4466,2,0,0,3,7,2200,0,47.7005,-122.339,1780,2250,6666,4030,2200,51,51
3,1,1370,3000,1,0,0,3,7,1370,0,47.6619,-122.351,1510,2151,4370,3661,1370,95,95
6,2.75,4460,6952,2,0,2,4,10,3460,1000,47.6626,-122.269,2750,4769,11412,7519,4460,89,89
3,1.75,1540,4800,1,0,0,4,6,770,770,47.67,-122.284,1510,4080,6340,5590,1540,94,94
3,2.75,2780,4815,3,0,2,3,10,2780,0,47.6569,-122.286,2820,5000,7595,7820,2780,45,45
5,1,1280,3876,1,0,0,3,7,1280,0,47.6605,-122.324,1420,3825,5156,5245,1280,96,96
5,3,2830,7500,2,0,0,3,9,2460,370,47.6579,-122.277,2900,5000,10330,7900,2830,96,96
4,2.5,3070,4000,2,0,0,4,8,2070,1000,47.659,-122.281,2560,4000,7070,6560,3070,79,79
2,1.75,1600,5795,1,0,0,3,8,1600,0,47.6709,-122.276,2310,6301,7395,8611,1600,79,79
4,1.75,1640,1480,1,0,0,4,7,820,820,47.6684,-122.314,1420,2342,3120,3762,1640,107,107
3,1,1340,4000,1,0,0,4,7,1340,0,47.6652,-122.288,1510,4000,5340,5510,1340,92,92
2,2.25,1160,954,2,0,0,3,8,960,200,47.6647,-122.284,1160,1327,2114,2487,1160,5,5
4,2.75,3220,4392,1,0,0,4,9,2320,900,47.6713,-122.276,2310,5795,7612,8105,3220,88,88
2,1,890,5000,1,0,0,3,7,890,0,47.6666,-122.279,1680,5000,5890,6680,890,76,76
3,1,1710,6195,1,0,0,3,7,1410,300,47.6706,-122.265,1610,6195,7905,7805,1710,73,73
2,1,1120,4000,1,0,0,3,7,1120,0,47.6567,-122.327,1620,4000,5120,5620,1120,93,93
3,1,1370,4000,2,0,0,4,8,1370,0,47.6711,-122.324,1370,4000,5370,5370,1370,101,101
3,3.25,1220,1281,2,0,0,3,8,930,290,47.67,-122.317,1303,3810,2501,5113,1220,5,5
4,1.75,2040,2750,1,0,0,4,6,1260,780,47.6698,-122.3,1940,3750,4790,5690,2040,93,93
4,2.5,5300,26211,2,1,2,2,10,4570,730,47.661,-122.269,3890,19281,31511,23171,5300,96,96
4,2.75,2280,3200,1,0,0,5,8,1520,760,47.6709,-122.282,1970,4687,5480,6657,2280,88,88
3,2.5,2710,13120,1,0,0,3,10,2710,0,47.6718,-122.256,3130,13566,15830,16696,2710,60,60
5,1.75,2290,4320,2,0,0,3,7,1980,310,47.664,-122.31,2870,4320,6610,7190,2290,91,91
3,2.25,1264,1536,2,0,0,3,8,1264,0,47.6694,-122.279,1264,2067,2800,3331,1264,16,16
2,2.25,1890,5400,2,0,0,5,8,1610,280,47.6688,-122.31,2820,4860,7290,7680,1890,114,114
4,1.75,2120,4000,1,0,0,4,8,1920,200,47.6601,-122.275,2300,4000,6120,6300,2120,90,90
3,1.75,1640,3400,1,0,0,4,7,930,710,47.6694,-122.3,1380,3750,5040,5130,1640,93,93
3,2.25,1270,1406,2,0,0,3,8,1060,210,47.6647,-122.284,1160,1327,2676,2487,1270,5,5
3,1,1030,4958,1,0,0,5,7,1030,0,47.6647,-122.277,2230,6987,5988,9217,1030,67,67
4,1.75,1930,3876,1,0,0,5,7,1450,480,47.6604,-122.324,1280,3825,5806,5105,1930,95,95
4,2,1760,5307,1,0,0,4,7,1170,590,47.6714,-122.28,1850,6600,7067,8450,1760,71,71
3,2.5,2570,5000,1,0,0,4,8,1480,1090,47.6578,-122.285,2420,5484,7570,7904,2570,79,79
2,1,1060,3036,1,0,0,4,6,1060,0,47.6578,-122.324,1730,5535,4096,7265,1060,76,76
2,1,1390,5544,1,0,0,3,7,930,460,47.6696,-122.267,1710,6200,6934,7910,1390,72,72
2,1,1420,5332,1,0,0,3,8,1070,350,47.6694,-122.275,2400,5406,6752,7806,1420,66,66
3,2.75,1710,9448,1,0,0,3,7,1010,700,47.6693,-122.267,1960,8951,11158,10911,1710,72,72
3,1.75,1320,2500,1,0,0,3,7,870,450,47.6681,-122.305,1580,2750,3820,4330,1320,101,101
3,1.75,1590,2500,1,0,0,4,7,1190,400,47.6668,-122.299,1420,3800,4090,5220,1590,111,111
3,2.25,2390,4590,2,0,0,3,8,2090,300,47.6615,-122.276,2280,5179,6980,7459,2390,78,16
2,1.75,1090,4590,1,0,0,4,7,790,300,47.6677,-122.324,1390,4080,5680,5470,1090,104,104
3,1.75,1410,4080,1,0,0,4,7,1410,0,47.6695,-122.32,1820,4080,5490,5900,1410,92,92
2,1.75,1300,4000,2,0,0,3,7,1300,0,47.6687,-122.288,1350,4013,5300,5363,1300,71,71
3,1,1340,4284,1,0,0,3,7,1080,260,47.6633,-122.324,1960,4080,5624,6040,1340,109,109
3,1.75,2720,4720,1,0,0,4,7,1580,1140,47.6691,-122.29,1660,4640,7440,6300,2720,94,94
5,1.75,1570,3000,2,0,0,4,7,1570,0,47.6677,-122.316,1610,3000,4570,4610,1570,111,111
5,2.25,2060,4800,2,0,0,3,8,2060,0,47.66,-122.282,1740,4800,6860,6540,2060,112,112
4,1.5,1910,5000,1,0,0,3,7,1610,300,47.6597,-122.29,2170,5000,6910,7170,1910,107,107
4,1.75,1450,3750,1,0,0,4,7,950,500,47.6706,-122.3,1850,4000,5200,5850,1450,94,94
5,3.5,3510,4798,2,0,0,3,10,2700,810,47.669,-122.282,1460,1684,8308,3144,3510,11,11
4,1.75,1840,4280,1,0,0,4,7,920,920,47.6681,-122.32,1660,4280,6120,5940,1840,101,101
4,3.25,3160,5000,2,0,0,5,9,2360,800,47.6597,-122.274,2220,4000,8160,6220,3160,54,54
2,1.5,1640,4080,1,0,0,5,7,1540,100,47.6624,-122.325,1880,4080,5720,5960,1640,103,103
3,2.75,2050,3320,1,0,0,4,7,1580,470,47.6719,-122.301,1760,4150,5370,5910,2050,92,92
4,1.75,2330,4000,2,0,0,5,8,1300,1030,47.666,-122.289,2040,4000,6330,6040,2330,95,95
4,3.5,3840,4000,2,0,0,3,8,2640,1200,47.6642,-122.291,1620,4000,7840,5620,3840,18,18
3,1,990,6000,1,0,0,3,6,990,0,47.6718,-122.267,1250,6000,6990,7250,990,76,76
3,1.75,1370,3300,2,0,0,5,7,1370,0,47.6714,-122.32,1560,3927,4670,5487,1370,92,92
4,2,1890,5188,1,0,0,4,7,1670,220,47.6633,-122.287,1800,4848,7078,6648,1890,79,79
5,2.75,2910,9480,1,0,0,3,8,2910,0,47.6552,-122.278,2940,6600,12390,9540,2910,80,80
3,2.5,2160,6000,1,0,0,4,8,1880,280,47.6582,-122.28,2300,6000,8160,8300,2160,80,80
3,2.5,1280,1889,3,0,0,3,8,1280,0,47.6619,-122.324,1450,1889,3169,3339,1280,10,10
3,1.5,1340,6000,1,0,1,3,9,1340,0,47.66,-122.282,2600,6000,7340,8600,1340,92,92
3,3.25,3400,5979,2,0,0,4,9,2290,1110,47.6585,-122.273,3090,6435,9379,9525,3400,82,82
5,2,1900,5470,1,0,0,3,7,1180,720,47.6666,-122.303,1300,3250,7370,4550,1900,89,49
5,2,2280,5400,1,0,0,4,7,1340,940,47.6674,-122.279,1770,5000,7680,6770,2280,72,72
2,1.75,1140,936,2,0,0,3,8,940,200,47.6647,-122.284,1160,1327,2076,2487,1140,5,5
4,3,3710,20000,2,0,2,5,10,2760,950,47.6696,-122.261,3970,20000,23710,23970,3710,83,83
3,2,2168,4000,1,0,0,3,8,2168,0,47.6561,-122.325,1770,4000,6168,5770,2168,112,112
10,3,2920,3745,2,0,0,4,7,1860,1060,47.6635,-122.32,1810,3745,6665,5555,2920,106,106
3,2.25,2440,9200,1,0,1,4,8,2440,0,47.6629,-122.269,2750,6211,11640,8961,2440,69,69
3,1.75,3400,8965,1,0,2,5,9,1820,1580,47.6569,-122.273,3200,8500,12365,11700,3400,62,62
3,3.25,4030,6300,2,0,0,3,10,3630,400,47.6664,-122.276,1660,6300,10330,7960,4030,13,13
8,2.5,2280,3000,1,0,0,3,7,1210,1070,47.6675,-122.316,1610,3000,5280,4610,2280,108,108
2,1.5,1480,3120,1,0,0,3,7,930,550,47.6684,-122.323,1000,3780,4600,4780,1480,105,7
2,2.5,1450,1281,2,0,0,3,8,1220,230,47.665,-122.285,1440,1281,2731,2721,1450,13,13
4,2,1540,5000,1,0,0,4,7,1540,0,47.6713,-122.3,1790,4000,6540,5790,1540,106,106
3,2.5,1840,3035,1,0,0,3,7,920,920,47.6557,-122.327,1780,4000,4875,5780,1840,93,93
4,3.25,3230,5000,1,0,0,4,7,1750,1480,47.6702,-122.3,1730,4000,8230,5730,3230,103,103
3,1.75,1650,1180,3,0,0,3,8,1650,0,47.6638,-122.319,1650,1960,2830,3610,1650,5,5
3,2.75,1900,6400,1,0,0,5,7,1410,490,47.6697,-122.281,1350,6400,8300,7750,1900,77,77
2,1.75,1240,4120,1,0,0,4,7,890,350,47.6689,-122.314,1640,3740,5360,5380,1240,113,113
4,2.5,2660,3672,2,0,0,5,8,1800,860,47.6609,-122.324,1510,3825,6332,5335,2660,109,109
3,2.25,3290,5000,2,0,0,3,9,2730,560,47.6582,-122.28,2340,4000,8290,6340,3290,80,80
2,1,1090,5265,1,0,0,4,7,1090,0,47.6638,-122.292,2080,4000,6355,6080,1090,72,72
9,3,2820,4480,2,0,0,3,7,1880,940,47.6654,-122.307,2460,4400,7300,6860,2820,101,101
4,3.5,3260,5000,2,0,0,5,9,2630,630,47.6598,-122.273,2600,5000,8260,7600,3260,82,82
4,1.5,1550,3000,1,0,0,3,7,1350,200,47.6604,-122.324,1710,5535,4550,7245,1550,101,101
3,2.5,1270,1062,2,0,0,3,8,1060,210,47.6568,-122.321,1260,1112,2332,2372,1270,11,11
4,2,1720,4000,1,0,0,3,7,1420,300,47.6651,-122.285,1350,1281,5720,2631,1720,69,69
3,1.5,1940,3570,2,0,0,4,8,1740,200,47.6618,-122.325,1580,3570,5510,5150,1940,103,103
6,1.75,2180,4000,1,0,0,4,7,1380,800,47.6643,-122.29,1720,4000,6180,5720,2180,93,93
4,2.5,2920,4000,1,0,0,5,8,1910,1010,47.6578,-122.28,2470,4000,6920,6470,2920,110,110
5,2.75,2160,4000,1,0,0,5,7,1530,630,47.667,-122.289,2040,4000,6160,6040,2160,92,92
4,2.75,2100,4480,1,0,0,4,7,1780,320,47.6691,-122.294,2050,4480,6580,6530,2100,91,91
3,2,1460,2800,1,0,0,4,7,730,730,47.67,-122.295,1780,4560,4260,6340,1460,98,98
4,3.25,3890,25470,2,1,3,5,10,3030,860,47.6608,-122.269,4140,19281,29360,23421,3890,96,96
3,2.5,3490,9362,1,0,3,5,9,1770,1720,47.6605,-122.27,3640,7425,12852,11065,3490,59,59
2,1,1010,5000,1,0,0,4,6,1010,0,47.6692,-122.297,1460,5000,6010,6460,1010,111,111
5,3.25,5570,9600,2,0,0,5,9,3860,1710,47.6708,-122.262,3170,10400,15170,13570,5570,67,67
2,1.75,1390,4160,1,0,0,5,6,790,600,47.6681,-122.324,1090,4160,5550,5250,1390,103,103
5,2,2600,3750,1,0,0,4,6,1400,1200,47.6691,-122.299,1700,3750,6350,5450,2600,105,105
4,2.25,3530,5500,2,0,0,3,8,2860,670,47.6618,-122.273,2840,5500,9030,8340,3530,79,79
3,1,1120,6600,1,0,0,3,7,1120,0,47.6712,-122.267,1300,6600,7720,7900,1120,76,76
6,4.75,5480,19401,1,1,4,5,11,3910,1570,47.6515,-122.277,3510,15810,24881,19320,5480,83,83
2,1,890,3060,1,0,0,3,7,770,120,47.6663,-122.326,1760,4080,3950,5840,890,109,109
3,1,1500,6800,1,0,0,3,7,1500,0,47.6706,-122.268,1500,6800,8300,8300,1500,76,76
2,1,1860,3400,1,0,0,3,7,1010,850,47.6714,-122.329,1540,3997,5260,5537,1860,99,99
2,1.75,1390,5025,1,0,0,4,8,1390,0,47.6701,-122.288,2160,5000,6415,7160,1390,91,91
5,3.25,3350,4000,2,0,0,4,8,2510,840,47.6645,-122.291,1620,4000,7350,5620,3350,22,22
5,3.25,2920,6960,2,0,1,3,9,2120,800,47.6712,-122.272,2470,6735,9880,9205,2920,66,7
3,1.5,1540,3570,1,0,0,5,7,1490,50,47.6692,-122.325,1620,4080,5110,5700,1540,89,89
5,2.75,2590,6120,2,0,0,3,8,2590,0,47.6667,-122.327,1390,3060,8710,4450,2590,110,110
3,2.25,1720,4000,1,0,0,4,7,1450,270,47.6683,-122.286,1410,4000,5720,5410,1720,98,98
4,3,2490,4325,1,0,0,3,8,1690,800,47.6628,-122.326,1960,4284,6815,6244,2490,97,12
3,3,2940,4622,2,0,0,4,9,2230,710,47.6641,-122.293,1580,4000,7562,5580,2940,31,31
4,3.5,3930,6120,2,0,0,3,10,3310,620,47.6646,-122.28,3390,6120,10050,9510,3930,12,12
3,3.25,2640,4080,2,0,0,3,9,1840,800,47.6636,-122.326,1990,4080,6720,6070,2640,107,14
4,2.5,3000,7500,2,0,0,3,9,3000,0,47.6571,-122.277,2580,5000,10500,7580,3000,82,20
4,2.5,3030,6820,2,0,0,3,9,2530,500,47.6695,-122.266,2070,6820,9850,8890,3030,72,14
4,1.75,2320,3825,1,0,0,5,8,1820,500,47.6659,-122.327,1940,3825,6145,5765,2320,93,93
9,4.5,3650,5000,2,0,0,3,8,2530,1120,47.6604,-122.289,2510,5000,8650,7510,3650,104,4
4,3,2760,4905,2,0,1,4,9,1840,920,47.6591,-122.27,3200,5424,7665,8624,2760,81,81
4,3.5,2800,6750,2,0,0,3,9,1890,910,47.669,-122.275,2370,6120,9550,8490,2800,68,12
4,2.5,2830,5000,2,0,0,3,9,2830,0,47.6597,-122.29,1950,5000,7830,6950,2830,24,24
4,2.5,2570,4480,1,0,0,4,8,1580,990,47.6701,-122.291,2070,4480,7050,6550,2570,92,92
2,1,920,4000,1,0,0,4,7,920,0,47.6711,-122.328,1300,4000,4920,5300,920,113,113
4,1,1260,4080,1,0,0,4,7,1260,0,47.6644,-122.324,1340,4080,5340,5420,1260,108,108
3,4,1390,1569,2,0,0,3,9,1150,240,47.671,-122.269,1620,1855,2959,3475,1390,13,13
3,1.75,1650,1180,3,0,0,3,8,1650,0,47.6636,-122.319,1720,1960,2830,3680,1650,5,5
3,1.5,1470,4480,1,0,0,4,7,1130,340,47.6693,-122.291,2120,4480,5950,6600,1470,101,101
3,1,1510,5000,1,0,0,3,7,1510,0,47.6708,-122.297,1680,4000,6510,5680,1510,110,110
3,2.5,1280,1845,3,0,0,3,8,1280,0,47.662,-122.324,1450,1889,3125,3339,1280,10,10
3,1.5,1390,5040,1,0,0,3,7,1090,300,47.6611,-122.282,1910,4800,6430,6710,1390,72,72
3,1.75,2040,4000,2,0,0,5,7,1360,680,47.6675,-122.289,1610,4000,6040,5610,2040,95,95
4,3.75,3300,4545,1,0,4,3,10,2600,700,47.6561,-122.274,3300,5000,7845,8300,3300,93,15
4,3.25,3960,16224,2,0,2,3,12,3100,860,47.6701,-122.259,3960,15050,20184,19010,3960,81,81
2,1,1470,6398,1,0,0,4,7,970,500,47.6716,-122.279,1950,6398,7868,8348,1470,78,78
4,2.5,3240,10800,1,0,0,3,10,2260,980,47.6709,-122.262,3490,10800,14040,14290,3240,73,73
3,2.25,1640,1023,3,0,0,3,8,1640,0,47.6636,-122.319,1720,1960,2663,3680,1640,5,5
2,1.75,1660,6000,1,0,0,3,7,1160,500,47.6624,-122.291,1660,4000,7660,5660,1660,77,77
2,1.75,1240,3000,1,0,0,3,7,1240,0,47.6689,-122.326,1800,4080,4240,5880,1240,113,113
2,1.75,1010,4000,1,0,0,5,7,1010,0,47.6665,-122.287,1470,4000,5010,5470,1010,100,100
3,2.5,2090,6000,1,0,0,4,9,2090,0,47.6567,-122.281,2730,6000,8090,8730,2090,91,91
2,1,850,2700,1,0,0,5,6,850,0,47.6684,-122.316,1630,3000,3550,4630,850,95,95
3,2.75,2380,5572,2,0,4,3,9,1930,450,47.6626,-122.271,3370,5500,7952,8870,2380,80,80
4,2,2100,4500,1,0,0,5,7,1060,1040,47.6699,-122.317,1920,3900,6600,5820,2100,95,95
3,2,2520,3959,1,0,0,5,8,1270,1250,47.6693,-122.289,1660,3959,6479,5619,2520,88,88
3,2.25,1270,1566,2,0,0,3,8,1060,210,47.6647,-122.284,1160,1327,2836,2487,1270,5,5
3,1,1590,4080,1,0,0,3,7,1590,0,47.662,-122.326,1570,4080,5670,5650,1590,97,97
4,2.75,3680,5000,2,0,3,3,9,2480,1200,47.6599,-122.269,3200,5000,8680,8200,3680,83,83
4,3.25,3760,10920,1,0,0,5,9,2400,1360,47.6687,-122.264,3430,11050,14680,14480,3760,69,69
3,1.75,1720,3825,1,0,0,3,7,1720,0,47.666,-122.327,2000,3825,5545,5825,1720,94,94
2,2.25,1040,1377,2,0,0,3,8,1040,0,47.6692,-122.279,1264,1892,2417,3156,1040,16,16
5,2.25,2730,6000,1,0,0,3,8,2130,600,47.6571,-122.281,2730,6000,8730,8730,2730,92,92
4,3.25,2420,4000,1,0,0,5,9,1870,550,47.6567,-122.325,1810,4000,6420,5810,2420,108,108
4,1.75,1510,5500,1,0,0,3,7,1510,0,47.535,-122.359,1320,6431,7010,7751,1510,99,99
3,1,1980,6450,1,0,0,4,6,1120,860,47.5291,-122.356,1180,5160,8430,6340,1980,69,69
2,2.5,1630,1368,2,0,0,3,7,1280,350,47.5489,-122.363,1590,2306,2998,3896,1630,10,10
4,2.5,1890,6156,1,0,0,3,7,980,910,47.551,-122.356,1590,6954,8046,8544,1890,39,39
2,1,710,5120,1,0,0,3,6,710,0,47.5224,-122.357,1150,1252,5830,2402,710,101,101
2,1,720,4000,1,0,0,3,6,720,0,47.5346,-122.353,1630,4000,4720,5630,720,101,101
3,1.5,1240,5000,1,0,2,3,7,1240,0,47.5659,-122.36,1050,5000,6240,6050,1240,55,55
4,1.75,2100,7135,1,0,0,4,7,1050,1050,47.5353,-122.349,1730,4000,9235,5730,2100,64,64
3,1,1120,10701,1,0,0,3,7,1120,0,47.5544,-122.358,1130,6350,11821,7480,1120,65,65
3,1,1410,5120,1,0,0,3,6,1210,200,47.5238,-122.355,1330,5120,6530,6450,1410,94,94
3,2.5,1780,6771,1,0,0,3,7,1230,550,47.5237,-122.353,1780,6771,8551,8551,1780,29,29
3,2.5,2210,5750,2,0,0,3,7,1710,500,47.5525,-122.366,1350,5750,7960,7100,2210,105,15
2,2.25,1550,2285,2,0,0,3,8,1550,0,47.5398,-122.369,1550,2135,3835,3685,1550,12,12
3,1.5,910,5120,1,0,0,3,6,910,0,47.5238,-122.356,1410,5132,6030,6542,910,46,46
2,2.5,1160,2174,2,0,0,3,7,1160,0,47.5264,-122.366,1380,1919,3334,3299,1160,21,21
5,3,2320,8400,1,0,0,3,7,1510,810,47.557,-122.365,1200,4800,10720,6000,2320,56,56
3,3.25,1450,1387,2,0,0,3,8,1180,270,47.5556,-122.362,1450,1198,2837,2648,1450,6,6
3,2.25,1490,974,2,0,0,3,7,1220,270,47.5567,-122.363,1490,1283,2464,2773,1490,10,10
2,1,920,7688,1,0,0,3,6,920,0,47.5281,-122.362,1040,7440,8608,8480,920,64,64
4,1,2300,7680,1,0,0,3,7,1270,1030,47.524,-122.359,1840,5120,9980,6960,2300,60,60
5,2.5,2170,2752,2,0,0,3,8,2170,0,47.5167,-122.347,1800,2752,4922,4552,2170,5,5
3,2.5,1770,5146,2,0,0,3,7,1770,0,47.5263,-122.356,1230,5160,6916,6390,1770,27,27
4,2.75,1920,7102,1,0,0,3,7,1130,790,47.539,-122.356,1830,6440,9022,8270,1920,27,27
3,1.5,1060,7488,1,0,0,5,7,1060,0,47.5549,-122.356,1300,6780,8548,8080,1060,42,42
3,1,1230,4380,1,0,0,3,6,1230,0,47.5352,-122.361,1525,6026,5610,7551,1230,72,72
4,2.5,2150,5100,1,0,0,3,7,1290,860,47.5338,-122.36,1920,5100,7250,7020,2150,28,28
3,1,1210,8505,1,0,0,3,7,1210,0,47.5389,-122.353,1430,8505,9715,9935,1210,61,61
4,2.5,1600,6765,1,0,0,3,7,830,770,47.5469,-122.365,1600,8942,8365,10542,1600,72,3
3,2,1550,8509,1,0,0,3,7,1150,400,47.5299,-122.344,1840,7620,10059,9460,1550,60,60
4,1.75,2150,8555,1,0,2,4,7,1460,690,47.5344,-122.345,1480,7405,10705,8885,2150,37,37
3,2.5,1440,1068,2,0,0,3,8,1160,280,47.5393,-122.361,1580,1483,2508,3063,1440,13,13
3,2.25,1440,5150,2,0,0,3,7,1440,0,47.5456,-122.356,1530,5238,6590,6768,1440,22,22
5,3,2150,6117,1,0,0,3,7,1370,780,47.538,-122.356,1990,6064,8267,8054,2150,16,16
2,1,750,4515,1,0,0,3,6,750,0,47.5198,-122.351,1020,5000,5265,6020,750,77,77
5,4,1680,7268,1,0,0,3,8,1370,310,47.5571,-122.356,2040,8259,8948,10299,1680,11,11
5,3.25,2910,5027,2,0,0,3,8,2040,870,47.5543,-122.359,2910,5027,7937,7937,2910,6,6
3,1,1660,7440,1,0,0,3,7,1270,390,47.5242,-122.362,1540,7440,9100,8980,1660,62,62
3,1,1980,8505,1,0,0,3,7,1030,950,47.538,-122.353,1830,8505,10485,10335,1980,54,54
2,0.75,720,5040,1,0,0,3,4,720,0,47.5323,-122.347,1290,4120,5760,5410,720,70,70
2,1.75,930,7080,1,0,0,3,6,930,0,47.5224,-122.36,1100,7680,8010,8780,930,96,8
2,1,660,5000,1,0,0,3,6,660,0,47.5664,-122.364,1000,5000,5660,6000,660,104,104
2,1,630,4200,1,0,0,3,6,630,0,47.5329,-122.348,970,4200,4830,5170,630,89,89
3,2.5,1480,1590,2,0,0,3,8,1150,330,47.5302,-122.362,1480,5761,3070,7241,1480,9,9
3,1.75,1960,8136,1,0,0,3,7,980,980,47.5208,-122.364,1070,7480,10096,8550,1960,71,71
3,1.5,2140,47743,1,0,0,3,9,2140,0,47.5402,-122.365,1060,6016,49883,7076,2140,41,41
5,2.75,1690,4000,1,0,0,5,7,970,720,47.5312,-122.354,1240,4000,5690,5240,1690,76,76
3,2.5,1320,1683,2,0,0,3,8,1270,50,47.5357,-122.365,1320,2206,3003,3526,1320,15,15
2,1.5,830,1020,2,0,0,3,7,830,0,47.5604,-122.363,830,1379,1850,2209,830,13,13
3,1,1200,6615,1,0,0,4,7,1200,0,47.5168,-122.351,1230,6615,7815,7845,1200,65,65
3,2.25,1350,1234,2,0,0,3,7,1160,190,47.5565,-122.363,1420,1234,2584,2654,1350,12,12
4,3.25,1790,2460,2,0,0,4,7,1100,690,47.534,-122.346,1260,4040,4250,5300,1790,19,19
2,1,810,6827,1,0,0,3,6,810,0,47.5495,-122.357,990,6827,7637,7817,810,75,75
3,1,1290,4720,1,0,0,3,6,790,500,47.5186,-122.358,1110,4720,6010,5830,1290,71,71
4,2,1640,5014,1,0,0,4,7,930,710,47.5545,-122.356,1600,5452,6654,7052,1640,37,37
1,1,620,8261,1,0,0,3,5,620,0,47.5138,-122.364,1180,8244,8881,9424,620,80,80
2,1.5,800,2119,2,0,0,3,7,800,0,47.554,-122.362,1020,4800,2919,5820,800,11,11
4,2.75,2680,16934,1,0,0,4,7,1340,1340,47.542,-122.364,1240,7000,19614,8240,2680,61,61
3,3.25,1480,1192,2,0,0,3,8,1180,300,47.5556,-122.363,1330,1094,2672,2424,1480,6,6
2,2.5,1570,2399,2,0,0,3,7,1180,390,47.5488,-122.364,1590,2306,3969,3896,1570,10,10
2,1.5,1190,801,3,0,0,3,8,1190,0,47.5212,-122.358,1190,810,1991,2000,1190,9,9
2,1.5,1120,1312,2,0,0,3,7,1000,120,47.534,-122.364,1560,1314,2432,2874,1120,15,15
3,2,1520,4000,1,0,0,5,6,800,720,47.531,-122.351,1430,4000,5520,5430,1520,76,76
3,2.5,1020,2040,2,0,0,3,7,720,300,47.5294,-122.361,1060,1478,3060,2538,1020,15,15
3,1,1090,6435,1,0,0,4,7,1090,0,47.5334,-122.365,1340,6435,7525,7775,1090,64,64
3,3.25,1530,1602,2,0,0,3,8,1140,390,47.5555,-122.362,1450,1198,3132,2648,1530,6,6
2,1,1200,4880,1,0,0,3,6,980,220,47.5276,-122.346,1040,4880,6080,5920,1200,76,76
2,2,840,14564,1,0,0,5,6,840,0,47.5499,-122.36,1430,7920,15404,9350,840,77,77
5,3,2420,7740,1,0,0,5,7,1360,1060,47.536,-122.358,1840,6780,10160,8620,2420,90,45
4,1.75,1320,4800,1,0,0,4,7,870,450,47.5534,-122.365,940,4800,6120,5740,1320,89,89
3,1.5,1210,5240,1,0,0,4,7,610,600,47.5524,-122.356,1560,5240,6450,6800,1210,36,36
2,1,1000,10320,1,0,0,3,6,1000,0,47.527,-122.356,1100,5160,11320,6260,1000,76,76
2,1,1380,5000,1,0,2,3,5,1380,0,47.5708,-122.359,1500,5000,6380,6500,1380,114,114
2,1,770,6450,1,0,0,4,6,770,0,47.531,-122.358,780,6063,7220,6843,770,71,71
2,2.25,1420,1246,2,0,0,3,8,1420,0,47.5394,-122.368,1420,1826,2666,3246,1420,12,12
3,1,1150,11802,1,0,0,4,7,1150,0,47.5624,-122.361,1880,6082,12952,7962,1150,87,56
2,1.5,720,4346,1,0,0,4,6,720,0,47.5225,-122.351,790,4346,5066,5136,720,77,77
3,2.5,1690,1200,2,0,0,3,8,1410,280,47.5389,-122.367,1690,1760,2890,3450,1690,6,6
3,1.5,910,5120,1,0,0,3,6,910,0,47.5238,-122.356,1410,5132,6030,6542,910,46,46
5,3,3040,6604,2,0,0,3,9,3040,0,47.548,-122.356,1650,6825,9644,8475,3040,14,14
3,1.5,970,5488,1,0,0,3,7,970,0,47.5366,-122.359,1040,5488,6458,6528,970,43,43
3,1.75,1170,4000,1,0,0,3,6,720,450,47.5306,-122.354,1130,4000,5170,5130,1170,76,1
4,2.75,1890,5240,1,0,0,3,7,980,910,47.5528,-122.356,1600,5240,7130,6840,1890,38,38
2,1,1210,9400,1,0,0,2,6,1210,0,47.5342,-122.36,1580,6026,10610,7606,1210,70,70
3,1,1650,6400,1,0,0,4,7,980,670,47.52,-122.365,1230,6400,8050,7630,1650,65,65
3,1.5,1380,7200,1,0,0,3,7,1080,300,47.5292,-122.348,1220,7200,8580,8420,1380,71,71
3,1.5,1060,6954,1,0,0,4,6,1060,0,47.5497,-122.355,1560,6372,8014,7932,1060,36,36
1,1,550,16345,1,0,0,3,4,550,0,47.5181,-122.339,1100,9240,16895,10340,550,74,74
3,1.75,1560,5760,1,0,0,5,6,780,780,47.5272,-122.359,1320,7680,7320,9000,1560,92,92
3,1,1020,7874,1,0,0,3,7,1020,0,47.5175,-122.346,1290,7320,8894,8610,1020,63,63
3,2.5,1450,5008,1,0,0,3,7,840,610,47.5435,-122.357,2120,5019,6458,7139,1450,12,12
3,1,1080,21043,1,0,0,3,6,1080,0,47.5515,-122.357,1380,7620,22123,9000,1080,77,77
2,1.5,1270,1282,2,0,0,3,8,1000,270,47.5581,-122.363,1270,1325,2552,2595,1270,13,13
5,3.25,3030,7410,2,0,0,3,8,2150,880,47.553,-122.354,2020,7410,10440,9430,3030,5,5
5,2.5,1760,10200,1,0,0,3,6,1760,0,47.5271,-122.351,1370,7620,11960,8990,1760,94,94
5,2.75,1790,5000,1,0,0,4,7,1060,730,47.5655,-122.363,1400,5000,6790,6400,1790,104,104
3,2.5,2510,5320,2,0,0,3,8,2510,0,47.5374,-122.357,1820,5736,7830,7556,2510,14,14
6,1,1370,5080,1,0,0,3,6,1120,250,47.5238,-122.35,1020,5080,6450,6100,1370,88,88
3,2.5,3110,6000,1,0,2,3,8,1560,1550,47.5331,-122.353,2060,6000,9110,8060,3110,52,52
3,1.75,1550,4057,1,0,0,3,6,830,720,47.5291,-122.351,1100,4116,5607,5216,1550,74,74
6,4,3120,4240,2,0,2,4,7,2090,1030,47.5305,-122.353,1460,4240,7360,5700,3120,26,26
4,2.75,1920,4400,1,0,0,4,6,960,960,47.5532,-122.365,1040,4400,6320,5440,1920,113,113
4,1,1770,7345,1,0,0,3,7,1770,0,47.5393,-122.351,1580,7345,9115,8925,1770,53,53
2,2.5,1590,2656,2,0,0,3,7,1220,370,47.5489,-122.364,1590,2306,4246,3896,1590,10,10
3,2.25,1490,1294,2,0,0,3,7,1220,270,47.5569,-122.363,1490,1283,2784,2773,1490,9,9
4,1,1400,9384,1,0,0,4,6,1400,0,47.5166,-122.361,1600,8432,10784,10032,1400,71,71
1,1,700,2500,1,0,0,4,7,700,0,47.5662,-122.364,1340,5000,3200,6340,700,112,112
3,1.75,1300,4127,1,0,0,4,6,650,650,47.5353,-122.352,1420,4000,5427,5420,1300,101,61
3,1.5,1060,6954,1,0,0,4,6,1060,0,47.5498,-122.355,1560,6954,8014,8514,1060,36,36
2,1,950,6350,1,0,0,3,7,950,0,47.528,-122.352,1080,7620,7300,8700,950,68,68
3,1,1060,7920,1,0,0,4,7,1060,0,47.5649,-122.358,1060,7457,8980,8517,1060,51,51
4,3,1960,5160,1,0,0,3,7,1170,790,47.5313,-122.36,1960,5160,7120,7120,1960,18,18
3,1,1020,5950,1,0,0,3,6,880,140,47.5436,-122.357,1800,5950,6970,7750,1020,69,69
2,1,1100,4010,1,0,0,5,6,1100,0,47.5296,-122.351,980,4501,5110,5481,1100,99,99
2,1,670,4640,1,0,0,3,6,670,0,47.53,-122.351,870,4501,5310,5371,670,76,76
3,2.5,1270,2509,2,0,0,3,8,1270,0,47.5357,-122.365,1420,2206,3779,3626,1270,15,15
3,2.25,1580,920,3,0,0,3,8,1580,0,47.5578,-122.363,1250,1150,2500,2400,1580,4,4
3,1.75,1150,10240,1,0,0,3,6,1030,120,47.5222,-122.357,1270,2566,11390,3836,1150,101,101
3,1.75,1690,5080,1,0,0,3,7,1190,500,47.5312,-122.348,1300,5080,6770,6380,1690,43,43
5,1.75,1830,7986,1,0,0,4,7,1060,770,47.5208,-122.35,1410,7260,9816,8670,1830,57,57
3,2.5,1690,1760,2,0,0,3,8,1410,280,47.5387,-122.367,1740,1760,3450,3500,1690,5,5
3,3.25,1480,983,2,0,0,3,8,1180,300,47.5555,-122.363,1330,1062,2463,2392,1480,6,6
4,1.5,1840,7076,1,0,0,3,7,1840,0,47.5185,-122.345,1510,7320,8916,8830,1840,62,62
3,1.5,850,2500,1,0,0,3,7,850,0,47.5677,-122.36,850,5000,3350,5850,850,33,33
4,1,1820,5500,1,0,0,3,6,1820,0,47.5185,-122.363,1140,5500,7320,6640,1820,72,72
4,2,1730,5500,1,0,0,5,7,1010,720,47.5304,-122.353,1080,4900,7230,5980,1730,76,76
1,1,600,3720,1,0,0,3,6,600,0,47.5558,-122.363,1480,4800,4320,6280,600,99,99
2,1,880,6345,1,0,0,3,7,880,0,47.5341,-122.358,1440,6345,7225,7785,880,100,100
3,2.75,2300,5090,2,0,0,3,8,1700,600,47.545,-122.36,1530,9100,7390,10630,2300,12,12
3,2.5,1020,2217,2,0,0,3,7,720,300,47.5343,-122.348,1060,1524,3237,2584,1020,15,15
3,2,1160,1174,2,0,0,3,7,790,370,47.5225,-122.357,1160,994,2334,2154,1160,12,12
2,1.5,720,5120,1,0,0,3,6,720,0,47.5218,-122.357,1150,2566,5840,3716,720,65,65
3,1,1140,5000,1,0,0,3,7,1140,0,47.5535,-122.362,1140,5000,6140,6140,1140,59,59
3,2.5,1410,1325,2,0,0,3,7,1180,230,47.5582,-122.363,1270,1282,2735,2552,1410,12,12
4,1,1530,8890,1,0,0,3,7,980,550,47.5308,-122.35,1100,5203,10420,6303,1530,94,94
4,1.75,2360,7620,1,0,0,4,7,1180,1180,47.5278,-122.345,1910,7620,9980,9530,2360,64,64
3,1.75,1410,1988,2,0,0,3,8,1410,0,47.5171,-122.347,1410,1899,3398,3309,1410,5,5
2,2.25,1550,2079,2,0,0,3,8,1550,0,47.54,-122.368,1420,1977,3629,3397,1550,11,11
4,1.75,2220,4760,1,0,0,3,7,1320,900,47.5215,-122.348,940,4760,6980,5700,2220,101,101
4,3.5,2380,5809,2,0,0,4,7,1750,630,47.5536,-122.359,1620,5775,8189,7395,2380,24,24
2,1,670,4720,1,0,0,4,6,670,0,47.5243,-122.358,1480,4720,5390,6200,670,71,71
2,1,820,4320,1,0,0,3,5,820,0,47.514,-122.359,780,7424,5140,8204,820,82,82
5,2.75,2110,5120,2,0,0,3,7,1870,240,47.5294,-122.357,1580,5120,7230,6700,2110,72,32
3,2.5,1350,1189,2,0,0,3,7,1080,270,47.5218,-122.358,1300,1182,2539,2482,1350,12,12
3,1,1600,5952,1,0,0,4,7,1150,450,47.5292,-122.362,1460,6200,7552,7660,1600,55,55
3,1.75,1630,4000,1,0,0,3,7,1100,530,47.5351,-122.353,1300,4000,5630,5300,1630,51,51
5,2.5,2170,2752,2,0,0,3,8,2170,0,47.5165,-122.346,1800,2752,4922,4552,2170,5,5
3,1.75,1410,2052,2,0,0,3,8,1410,0,47.5171,-122.347,1410,1988,3462,3398,1410,5,5
3,1,1480,5670,1,0,0,3,6,780,700,47.5175,-122.36,760,5040,7150,5800,1480,75,75
2,1,1010,7740,1,0,0,3,6,890,120,47.5323,-122.355,1030,6000,8750,7030,1010,95,95
3,2,1380,5198,1,0,0,4,7,1380,0,47.5514,-122.357,1320,6827,6578,8147,1380,37,37
3,2.25,1260,915,2,0,0,3,8,1020,240,47.555,-122.363,1260,1056,2175,2316,1260,12,12
2,1,720,5160,1,0,0,3,6,720,0,47.5274,-122.357,990,5160,5880,6150,720,70,70
3,2,1230,1340,2,0,0,3,7,1020,210,47.526,-122.361,1260,1312,2570,2572,1230,16,16
3,1.75,1830,7600,2,0,0,3,7,1490,340,47.5317,-122.351,1300,4000,9430,5300,1830,72,72
2,1,750,5217,1,0,0,4,6,750,0,47.5188,-122.353,760,4440,5967,5200,750,76,76
4,1.5,2500,9448,1,0,0,4,7,1250,1250,47.5212,-122.339,1640,9490,11948,11130,2500,53,53
3,1,1210,9525,1,0,0,3,7,1210,0,47.5274,-122.345,1680,7620,10735,9300,1210,64,64
2,1,860,7204,1,0,0,3,7,860,0,47.5361,-122.351,1200,7500,8064,8700,860,101,101
2,1,900,5160,1,0,0,3,6,900,0,47.525,-122.356,900,5160,6060,6060,900,67,67
3,1.75,1010,5355,1,0,0,3,6,1010,0,47.5202,-122.351,750,4515,6365,5265,1010,69,69
2,2,1070,649,2,0,0,3,9,720,350,47.5213,-122.357,1070,928,1719,1998,1070,11,11
2,1,880,4000,1,0,0,4,6,880,0,47.5331,-122.352,1430,4000,4880,5430,880,103,103
1,1,620,8261,1,0,0,3,5,620,0,47.5138,-122.364,1180,8244,8881,9424,620,80,80
2,1,720,5040,1,0,0,3,6,720,0,47.5267,-122.36,1357,5120,5760,6477,720,64,64
1,1,1020,7920,1,0,0,3,7,1020,0,47.5385,-122.355,1000,7168,8940,8168,1020,72,31
5,2.75,1540,4000,1,0,0,3,7,1140,400,47.533,-122.354,1630,4000,5540,5630,1540,29,29
4,1.5,1960,5000,1,0,0,3,7,980,980,47.5688,-122.363,1300,5000,6960,6300,1960,107,107
4,2.5,2340,3784,2,0,0,3,8,2340,0,47.535,-122.348,1730,4000,6124,5730,2340,11,11
3,1,950,4760,1,0,0,3,6,950,0,47.5236,-122.348,1080,4760,5710,5840,950,90,90
3,1,930,5160,1,0,0,5,6,930,0,47.5256,-122.357,1060,5160,6090,6220,930,100,100
3,2.5,1690,1200,2,0,0,3,8,1410,280,47.5388,-122.367,1740,1664,2890,3404,1690,5,5
2,2,1070,635,2,0,0,3,9,720,350,47.5212,-122.357,1070,928,1705,1998,1070,11,11
2,1,910,4662,1,0,0,5,6,910,0,47.5232,-122.354,890,6050,5572,6940,910,77,77
3,1,1270,4000,1,0,0,3,7,1120,150,47.5293,-122.354,1220,4600,5270,5820,1270,65,65
2,1,970,13700,1,0,0,3,6,970,0,47.515,-122.362,1570,10880,14670,12450,970,70,70
4,2.5,2350,3904,2,0,0,3,7,2350,0,47.5305,-122.351,1120,4000,6254,5120,2350,20,20
3,1,1210,7175,1,0,0,3,7,1210,0,47.5339,-122.356,1640,5850,8385,7490,1210,101,101
6,1,1370,5080,1,0,0,3,6,1120,250,47.5238,-122.35,1020,5080,6450,6100,1370,88,88
4,1,1200,6000,1,0,0,3,6,1200,0,47.5307,-122.352,950,4000,7200,4950,1200,96,96
2,1,710,4240,1,0,0,4,6,710,0,47.5226,-122.351,850,5200,4950,6050,710,77,77
5,3.75,2380,7268,1,0,0,3,8,1430,950,47.5571,-122.357,2040,10810,9648,12850,2380,11,11
3,2.5,1970,4120,1,0,0,3,6,1230,740,47.5328,-122.346,1470,4080,6090,5550,1970,92,92
2,1,1129,3840,1,0,0,3,7,1129,0,47.5313,-122.351,1300,3880,4969,5180,1129,66,66
2,1,830,4045,1,0,0,3,6,830,0,47.5293,-122.351,1100,4116,4875,5216,830,76,76
3,2.5,1610,1356,2,0,0,3,8,1240,370,47.5257,-122.361,1270,1314,2966,2584,1610,12,12
3,2.5,2430,7049,2,0,0,3,8,2430,0,47.5399,-122.352,1770,7049,9479,8819,2430,12,12
5,3.5,3560,5008,2,0,0,3,8,2810,750,47.5542,-122.359,2910,5026,8568,7936,3560,6,6
3,1.75,1900,5000,1,0,0,4,7,950,950,47.5677,-122.363,1420,5000,6900,6420,1900,94,94
3,2.25,1050,572,2,0,0,3,7,740,310,47.5549,-122.363,1260,1062,1622,2322,1050,13,13
2,2.5,1320,1957,1,0,0,3,8,660,660,47.5364,-122.365,1420,2198,3277,3618,1320,15,15
3,1.75,1290,4000,1,0,0,3,6,1170,120,47.5309,-122.354,1140,4000,5290,5140,1290,76,76
3,1,1300,20812,1,0,0,3,6,1300,0,47.5435,-122.359,1210,17340,22112,18550,1300,92,92
4,1.75,1670,9472,1,0,0,3,7,1100,570,47.5299,-122.357,1080,5195,11142,6275,1670,59,59
4,2.5,1840,1562,2,0,0,3,7,1400,440,47.5345,-122.364,1840,1766,3402,3606,1840,15,15
2,1,1140,5500,1,0,0,3,6,1140,0,47.5187,-122.363,1110,5500,6640,6610,1140,72,72
2,1,750,6480,1,0,0,3,6,750,0,47.5195,-122.35,1050,6390,7230,7440,750,76,76
4,2,2470,5080,1,0,0,3,6,1970,500,47.5308,-122.348,1060,5080,7550,6140,2470,71,26
11,3,3000,4960,2,0,0,3,7,2400,600,47.556,-122.363,1420,4960,7960,6380,3000,101,15
5,3.25,2500,7620,1,0,3,3,7,1250,1250,47.5298,-122.344,2020,7620,10120,9640,2500,57,57
4,1,1430,3600,1,0,0,3,6,980,450,47.5343,-122.355,1170,4000,5030,5170,1430,72,72
5,1.75,1550,6986,1,0,0,3,7,1030,520,47.5503,-122.356,1550,6986,8536,8536,1550,41,41
4,1.75,1440,6144,1,0,0,5,6,720,720,47.5257,-122.357,960,5160,7584,6120,1440,72,72
3,3.25,3870,11000,2,0,2,3,9,2970,900,47.5545,-122.354,2970,11000,14870,13970,3870,28,28
3,1.5,1720,7110,1,0,0,3,8,1720,0,47.5417,-122.355,1730,6840,8830,8570,1720,64,64
3,1.75,2340,5668,1,0,0,4,6,1200,1140,47.5588,-122.364,860,4800,8008,5660,2340,78,78
3,1,1200,4592,1,0,0,3,6,800,400,47.519,-122.352,940,4440,5792,5380,1200,69,69
3,2.75,1730,4131,2,0,2,3,7,1480,250,47.5327,-122.346,1570,4120,5861,5690,1730,44,44
2,2.25,1550,1827,2,0,0,3,8,1550,0,47.5394,-122.368,1420,1826,3377,3246,1550,11,11
1,1,810,5000,1,0,1,3,7,590,220,47.5696,-122.36,1920,5000,5810,6920,810,83,83
1,1,560,4120,1,0,0,3,4,560,0,47.5335,-122.348,980,4120,4680,5100,560,72,72
5,3,1880,5000,1,0,0,3,7,1100,780,47.5453,-122.363,1640,5000,6880,6640,1880,22,22
2,1.5,1310,1264,2,0,0,3,8,1120,190,47.5772,-122.409,1330,1265,2574,2595,1310,13,13
3,2.5,1980,1873,2,0,0,3,7,1470,510,47.6659,-122.369,1500,1873,3853,3373,1980,23,23
5,2.75,1800,4500,2,0,0,4,7,1680,120,47.6648,-122.358,1730,4500,6300,6230,1800,80,80
2,2.25,1290,1334,3,0,0,3,8,1290,0,47.6719,-122.382,1350,1334,2624,2684,1290,12,12
2,1.5,1210,1232,3,0,0,3,8,1210,0,47.6712,-122.39,1330,1174,2442,2504,1210,12,12
3,2,1750,4990,1,0,0,3,7,950,800,47.6667,-122.361,1700,5000,6740,6700,1750,103,103
2,1.75,2210,9374,1,0,3,4,8,1560,650,47.6634,-122.359,2140,5640,11584,7780,2210,68,68
2,1,1060,3588,1,0,0,4,7,960,100,47.6721,-122.395,1570,3741,4648,5311,1060,93,93
3,3.25,1370,1194,3,0,0,3,8,1370,0,47.6704,-122.391,1320,1217,2564,2537,1370,14,14
2,1,1010,5000,1,0,0,2,7,1010,0,47.6715,-122.365,1410,5000,6010,6410,1010,95,95
2,2.5,1450,1213,2,0,0,3,9,1110,340,47.6692,-122.372,1620,1456,2663,3076,1450,4,4
3,2.25,1240,1250,3,0,0,3,8,1240,0,47.6748,-122.377,1470,1250,2490,2720,1240,5,5
3,1.75,1410,5000,1,0,0,4,7,810,600,47.6727,-122.395,1760,5000,6410,6760,1410,96,96
3,1.75,1650,5000,1,0,0,4,8,1650,0,47.6743,-122.371,1630,5000,6650,6630,1650,119,119
2,1.75,1070,1276,3,0,0,3,8,1070,0,47.6719,-122.39,1290,2057,2346,3347,1070,13,13
5,3.5,2160,2323,3,0,0,3,9,2160,0,47.6726,-122.39,1750,4650,4483,6400,2160,12,12
2,1,1840,3300,1,0,0,4,6,1130,710,47.6757,-122.362,1320,4000,5140,5320,1840,109,109
3,1,1460,6198,1,0,0,4,7,1460,0,47.6626,-122.361,2280,5160,7658,7440,1460,103,103
3,2.25,1280,1187,2,0,0,3,8,1080,200,47.6651,-122.368,1280,1681,2467,2961,1280,11,11
3,1.75,1340,3900,2,0,0,5,7,1340,0,47.6711,-122.379,1470,1611,5240,3081,1340,119,119
1,1,730,3000,1,0,0,3,7,730,0,47.6741,-122.396,1520,5000,3730,6520,730,108,108
2,2.5,1430,1201,3,0,0,3,8,1430,0,47.6707,-122.381,1430,1249,2631,2679,1430,10,10
3,1.5,1380,4290,1,0,0,3,7,1080,300,47.674,-122.379,1510,3900,5670,5410,1380,64,64
2,1,870,7975,1,0,2,3,7,870,0,47.6698,-122.361,1080,5722,8845,6802,870,73,73
2,1,1050,5000,1,0,0,5,7,1050,0,47.6699,-122.369,1340,5000,6050,6340,1050,112,112
2,1.5,1010,1968,1,0,0,5,5,1010,0,47.6757,-122.385,1760,4200,2978,5960,1010,113,113
5,3,2370,6000,1,0,2,3,8,1340,1030,47.6645,-122.358,1350,4500,8370,5850,2370,93,11
3,2.5,1040,1032,3,0,0,3,7,1040,0,47.6673,-122.377,1290,1275,2072,2565,1040,12,12
4,1.75,1820,6137,1,0,3,4,7,1690,130,47.6681,-122.36,2130,5100,7957,7230,1820,108,108
2,1.5,1400,5000,1,0,0,4,7,1150,250,47.6681,-122.362,1530,4200,6400,5730,1400,115,115
2,2.25,1170,1313,3,0,0,3,8,1170,0,47.6712,-122.378,1310,1304,2483,2614,1170,12,12
2,1,760,3000,1,0,0,3,6,760,0,47.6633,-122.357,1630,3600,3760,5230,760,97,97
2,1,730,2600,1,0,0,4,6,730,0,47.6751,-122.379,1480,3900,3330,5380,730,101,101
2,2,1400,1512,2,0,0,3,8,940,460,47.6719,-122.392,1400,3500,2912,4900,1400,13,13
1,0.75,740,1284,1,0,0,4,6,740,0,47.6741,-122.406,1430,3988,2024,5418,740,91,91
3,1.75,1470,5000,1,0,0,5,7,1470,0,47.6755,-122.369,1530,5000,6470,6530,1470,119,119
3,3,1380,1081,3,0,0,3,8,1380,0,47.6692,-122.39,1390,1140,2461,2530,1380,14,14
3,2.5,1890,3880,1,0,0,4,8,1460,430,47.6642,-122.362,1010,3880,5770,4890,1890,104,104
2,2,1360,1860,1,0,0,4,7,680,680,47.6727,-122.396,1440,5000,3220,6440,1360,94,94
2,2.25,1290,1334,3,0,0,3,8,1290,0,47.6719,-122.382,1350,1334,2624,2684,1290,12,12
2,2.25,1360,1336,3,0,0,3,8,1360,0,47.6714,-122.392,1280,1295,2696,2575,1360,11,11
3,2.25,1280,1517,2,0,0,3,8,1080,200,47.6651,-122.368,1280,1681,2797,2961,1280,11,11
3,1.5,1260,3135,1,0,0,4,7,780,480,47.6693,-122.371,1540,3025,4395,4565,1260,75,75
3,1.75,1550,5000,1,0,0,3,7,1250,300,47.6722,-122.372,1110,5000,6550,6110,1550,108,3
3,3.25,1430,1276,3,0,0,3,8,1430,0,47.6712,-122.38,1430,1243,2706,2673,1430,12,12
3,2,1250,1306,3,0,0,3,7,1250,0,47.6705,-122.39,1320,1250,2556,2570,1250,18,18
3,2.5,1650,1838,2,0,0,4,7,1270,380,47.6666,-122.367,1550,1558,3488,3108,1650,28,28
2,1,1000,4956,1,0,2,4,7,1000,0,47.6753,-122.36,1830,4959,5956,6789,1000,103,103
4,3.5,2140,2278,3,0,0,3,9,2140,0,47.6734,-122.38,1540,2285,4418,3825,2140,14,14
3,3.25,1370,1194,3,0,0,3,8,1370,0,47.6718,-122.388,1800,2678,2564,4478,1370,15,15
4,1.75,1880,3880,1,0,0,4,7,1090,790,47.6635,-122.362,1390,3880,5760,5270,1880,75,75
3,1.5,1380,4290,1,0,0,3,7,1080,300,47.674,-122.379,1510,3900,5670,5410,1380,64,64
4,2,1640,5000,2,0,0,3,7,1640,0,47.6662,-122.365,1240,5000,6640,6240,1640,112,31
4,3,1550,3350,1,0,0,3,7,860,690,47.6583,-122.362,1310,5000,4900,6310,1550,101,0
2,3,1570,1281,3,0,0,3,8,1570,0,47.6741,-122.384,1570,2500,2851,4070,1570,5,5
2,1.75,840,3340,1,0,0,3,6,700,140,47.6692,-122.359,1700,3980,4180,5680,840,107,107
5,2.75,1940,5000,2,0,0,5,7,1940,0,47.6704,-122.362,1940,4230,6940,6170,1940,68,68
3,3.25,4340,4947,2,0,3,3,11,3060,1280,47.6709,-122.406,1680,5250,9287,6930,4340,26,26
3,2,1260,2500,1,0,0,4,7,750,510,47.6748,-122.371,1710,5000,3760,6710,1260,32,32
3,2,1500,2500,2,0,0,3,8,1500,0,47.6748,-122.385,1550,5000,4000,6550,1500,17,17
3,2.75,1370,1193,3,0,0,3,8,1370,0,47.67,-122.392,1320,1180,2563,2500,1370,16,16
3,1.75,1810,3000,1,0,0,4,7,1810,0,47.6599,-122.363,1140,3000,4810,4140,1810,116,116
2,2.5,1140,1182,3,0,0,3,8,1140,0,47.6713,-122.383,1290,1189,2322,2479,1140,12,12
4,2,1940,5000,1,0,0,4,7,980,960,47.6719,-122.369,1940,5000,6940,6940,1940,109,109
6,2.75,3400,5000,2,0,2,3,8,2860,540,47.6728,-122.362,1800,5000,8400,6800,3400,42,42
2,1,1230,1820,2,0,0,4,7,830,400,47.6684,-122.401,1660,3056,3050,4716,1230,71,71
3,2.25,1280,1520,2,0,0,3,8,1080,200,47.6651,-122.368,1280,1681,2800,2961,1280,11,11
2,2.5,1140,1181,3,0,0,3,8,1140,0,47.6713,-122.383,1220,1189,2321,2409,1140,12,12
4,2.75,2080,4000,1,0,0,3,8,2080,0,47.6737,-122.358,1730,5000,6080,6730,2080,107,14
3,2.5,2330,1987,2,0,4,3,9,1410,920,47.6735,-122.405,2640,5250,4317,7890,2330,15,15
6,2.75,2730,5000,1,0,0,3,8,1780,950,47.6751,-122.38,2090,5000,7730,7090,2730,57,57
1,1.5,760,779,3,0,0,3,8,760,0,47.6715,-122.382,1290,1189,1539,2479,760,13,13
4,2,1770,5000,2,0,0,4,7,1770,0,47.6748,-122.386,1550,5000,6770,6550,1770,113,113
4,2,2090,4000,1,0,0,3,7,1480,610,47.6751,-122.379,1510,5000,6090,6510,2090,68,68
4,1,1440,7100,1,0,0,3,7,1440,0,47.6725,-122.396,1490,5000,8540,6490,1440,113,113
2,1,800,2280,1,0,0,5,6,800,0,47.6588,-122.362,1310,4200,3080,5510,800,73,73
4,3,1540,4140,1,0,0,5,7,1540,0,47.6728,-122.396,1460,5000,5680,6460,1540,117,117
3,2.5,1260,1102,3,0,0,3,8,1260,0,47.675,-122.387,1320,2500,2362,3820,1260,12,12
3,2.25,1270,1213,2,0,0,3,8,1040,230,47.6736,-122.375,1410,1265,2483,2675,1270,14,14
3,1.75,2100,3264,1,0,0,5,7,1350,750,47.6702,-122.364,1720,3750,5364,5470,2100,107,107
3,2.5,1450,1053,2,0,0,3,8,940,510,47.6754,-122.374,1410,1080,2503,2490,1450,11,11
2,2.5,1780,2493,3,0,0,3,8,1780,0,47.6704,-122.358,2050,4400,4273,6450,1780,38,38
3,2,1380,2500,1,0,0,3,7,750,630,47.6753,-122.363,1630,3800,3880,5430,1380,33,33
3,1,1500,4100,1,0,0,3,7,1370,130,47.6689,-122.367,1500,4100,5600,5600,1500,93,93
3,1.75,1710,5000,1,0,0,4,7,1110,600,47.6689,-122.37,920,5000,6710,5920,1710,75,75
3,1.75,1630,1404,2,0,0,3,8,1020,610,47.6646,-122.367,1420,1670,3034,3090,1630,5,5
2,1,1000,4000,1,0,0,3,6,1000,0,47.6742,-122.396,1490,5000,5000,6490,1000,109,109
3,3.25,1510,1850,2,0,2,3,8,1230,280,47.6683,-122.362,1540,1840,3360,3380,1510,18,18
4,1,1410,3376,1,0,0,5,7,1410,0,47.6606,-122.365,1040,3600,4786,4640,1410,108,108
2,2,1270,5000,1,0,0,3,6,1270,0,47.6729,-122.363,2190,5000,6270,7190,1270,75,75
3,2.5,1150,1193,2,0,0,3,8,1020,130,47.6684,-122.365,1450,1640,2343,3090,1150,13,13
2,1.5,1280,1256,2,0,0,3,8,1200,80,47.6741,-122.375,1390,1256,2536,2646,1280,21,21
4,1.75,1470,4236,1,0,0,4,7,1470,0,47.6692,-122.399,1480,5400,5706,6880,1470,73,73
2,2,1370,1878,3,0,0,3,8,1370,0,47.6721,-122.387,1280,1878,3248,3158,1370,15,15
2,1,800,4850,1,0,0,4,7,800,0,47.6639,-122.364,1150,4365,5650,5515,800,75,75
2,1.5,1630,3780,1,0,0,4,7,890,740,47.6711,-122.403,1770,6400,5410,8170,1630,79,79
4,1.5,1580,5000,1,0,0,3,7,1390,190,47.6735,-122.393,1580,5000,6580,6580,1580,74,74
3,2,1520,5000,1,0,0,3,7,1140,380,47.6733,-122.389,1530,4650,6520,6180,1520,74,74
2,1,620,2475,1,0,0,5,6,620,0,47.6655,-122.371,1290,2475,3095,3765,620,108,108
3,3,1760,2114,2,0,0,3,7,1400,360,47.6666,-122.37,1300,1500,3874,2800,1760,11,11
3,1.75,1140,3395,1,0,0,5,7,620,520,47.6712,-122.393,1480,3500,4535,4980,1140,94,94
2,1,800,3330,1,0,0,3,7,800,0,47.6566,-122.358,1300,4320,4130,5620,800,101,101
2,1,910,5000,1,0,0,3,7,910,0,47.6733,-122.37,1050,5000,5910,6050,910,95,95
2,1,880,3300,1,0,0,4,7,880,0,47.6566,-122.36,1960,5500,4180,7460,880,110,110
2,2.5,1320,1157,2,0,0,3,8,990,330,47.6689,-122.363,1550,1519,2477,3069,1320,5,5
3,2.5,1510,1493,3,0,0,3,8,1510,0,47.669,-122.402,1530,1357,3003,2887,1510,5,5
3,2,1940,5820,1,0,0,5,7,1150,790,47.6638,-122.362,990,3880,7760,4870,1940,75,75
3,1.75,1310,5000,2,0,0,4,7,1310,0,47.6722,-122.379,1270,4750,6310,6020,1310,118,118
3,2.5,1460,1238,2,0,0,3,8,1200,260,47.6719,-122.374,1280,1257,2698,2537,1460,11,11
3,1,1210,3328,1,0,0,4,7,1210,0,47.6729,-122.363,1640,3333,4538,4973,1210,95,95
4,2,2360,6000,2,0,0,4,8,2360,0,47.6702,-122.362,1730,4700,8360,6430,2360,115,115
5,2,1900,5000,1,0,2,3,8,1720,180,47.6735,-122.362,1770,5000,6900,6770,1900,62,62
3,1,1360,3737,1,0,0,4,6,1360,0,47.6751,-122.362,1820,4500,5097,6320,1360,109,109
4,3,2370,3836,2,0,0,3,9,1750,620,47.6718,-122.394,1690,4698,6206,6388,2370,50,6
5,4.5,4340,5722,3,0,4,3,10,4340,0,47.6715,-122.406,1770,5250,10062,7020,4340,9,9
2,1,860,2599,1,0,0,4,6,860,0,47.675,-122.379,1300,3900,3459,5200,860,118,118
2,3.5,2560,5000,1,0,0,4,6,1280,1280,47.6681,-122.368,1390,4000,7560,5390,2560,75,75
3,3,1880,2200,2,0,0,3,8,1520,360,47.6666,-122.367,1500,1426,4080,2926,1880,12,12
3,2.5,1270,1180,3,0,0,3,8,1270,0,47.6697,-122.392,1320,1180,2450,2500,1270,18,18
3,1.5,1720,8100,2,0,0,3,8,1720,0,47.6746,-122.4,2210,8100,9820,10310,1720,112,112
4,1,1720,4011,1,0,0,4,7,1720,0,47.6719,-122.396,1580,3784,5731,5364,1720,115,115
3,2.5,1480,1531,3,0,0,3,8,1480,0,47.669,-122.402,1530,1321,3011,2851,1480,5,5
5,2.75,1990,3750,1,0,0,4,7,1990,0,47.6733,-122.358,1820,5000,5740,6820,1990,106,106
4,2.5,1950,2617,1,0,0,4,7,1250,700,47.6696,-122.372,1520,1438,4567,2958,1950,109,109
2,1.5,1130,746,2,0,0,3,8,1030,100,47.6684,-122.363,1520,1519,1876,3039,1130,10,10
3,1.75,1120,4000,1,0,0,4,7,870,250,47.6684,-122.368,1470,4000,5120,5470,1120,103,103
2,1.5,1170,1250,3,0,0,3,8,1170,0,47.6719,-122.38,1310,1308,2420,2618,1170,19,19
2,2.25,1290,1137,3,0,0,3,8,1290,0,47.6718,-122.382,1290,1332,2427,2622,1290,12,12
2,2.5,1320,1329,2,0,0,3,8,1180,140,47.6728,-122.374,1490,5000,2649,6490,1320,12,12
4,2.75,2720,3840,2,0,0,3,8,1790,930,47.6624,-122.361,1360,3880,6560,5240,2720,99,6
3,2.5,1580,1321,2,0,2,3,8,1080,500,47.6688,-122.402,1530,1357,2901,2887,1580,5,5
2,2.5,1260,1131,3,0,0,3,8,1260,0,47.6715,-122.384,1490,2500,2391,3990,1260,13,13
3,1,1010,5000,1,0,0,3,7,1010,0,47.675,-122.394,1680,5000,6010,6680,1010,67,67
2,1,910,4635,1,0,0,4,6,910,0,47.675,-122.393,1740,5000,5545,6740,910,114,114
3,2.5,1790,2375,3,0,0,3,8,1790,0,47.6726,-122.38,1450,2400,4165,3850,1790,12,12
2,1,1080,3420,1,0,0,4,7,780,300,47.6715,-122.393,1380,3656,4500,5036,1080,97,97
4,2.75,2410,6000,1,0,0,5,8,1410,1000,47.6707,-122.399,1760,6000,8410,7760,2410,69,69
3,3,1820,4300,1,0,0,4,8,1620,200,47.6711,-122.364,1440,4300,6120,5740,1820,105,32
5,2.75,2870,4461,1,0,0,3,7,1650,1220,47.675,-122.39,1890,4196,7331,6086,2870,43,43
3,2.25,1230,1097,3,0,0,3,8,1230,0,47.6697,-122.372,1420,1437,2327,2857,1230,10,10
6,3.75,3160,5000,2,0,0,3,8,3160,0,47.6748,-122.384,1740,5000,8160,6740,3160,30,30
2,1,1420,3100,1,0,0,3,7,820,600,47.6737,-122.365,1420,3915,4520,5335,1420,95,95
3,2,1820,4080,2,0,2,3,8,1820,0,47.6735,-122.401,2160,5400,5900,7560,1820,82,27
3,2,1940,4500,1,0,3,3,7,1090,850,47.6659,-122.359,1700,4500,6440,6200,1940,93,93
2,1,1890,4700,1,0,0,4,7,1030,860,47.6747,-122.391,2150,4700,6590,6850,1890,91,91
4,1.75,1880,4175,1,0,0,3,7,1090,790,47.6646,-122.364,1700,3758,6055,5458,1880,75,75
4,2.5,2100,3125,2,0,2,3,7,1400,700,47.6634,-122.358,2060,5040,5225,7100,2100,112,21
3,3.25,1530,1612,3,0,0,3,8,1530,0,47.6706,-122.378,1530,1611,3142,3141,1530,13,13
2,1,810,3880,1,0,0,3,7,810,0,47.6631,-122.365,900,4365,4690,5265,810,67,67
2,1,960,5000,1,0,0,4,7,960,0,47.6755,-122.367,1330,5000,5960,6330,960,119,119
4,1,1350,3333,1,0,0,3,7,1350,0,47.6727,-122.397,1530,5000,4683,6530,1350,107,107
2,1,540,2500,1,0,0,3,5,540,0,47.6729,-122.383,1290,5000,3040,6290,540,114,114
3,1,1600,5000,1,0,0,3,7,1110,490,47.655,-122.358,1380,5000,6600,6380,1600,72,72
5,2,1810,4850,1,0,0,3,7,1810,0,47.67,-122.394,1360,4850,6660,6210,1810,119,119
3,1.5,1840,5000,1,0,0,5,7,1340,500,47.6652,-122.362,1840,5000,6840,6840,1840,104,104
5,1.75,1890,5000,1,0,0,3,7,1090,800,47.6711,-122.372,1610,5000,6890,6610,1890,113,113
3,1.75,2090,6258,1,0,0,3,7,1390,700,47.5503,-122.301,1790,5793,8348,7583,2090,63,63
3,2,1190,7840,1,0,0,4,6,1190,0,47.5531,-122.312,1460,3240,9030,4700,1190,101,101
4,2,1510,4235,1,0,0,3,7,1510,0,47.546,-122.293,1510,4268,5745,5778,1510,64,64
3,1.75,1840,4030,1,0,0,5,7,1050,790,47.5549,-122.311,1840,5040,5870,6880,1840,94,94
5,2.5,2720,8120,1,0,0,3,7,1360,1360,47.557,-122.308,2020,8120,10840,10140,2720,49,49
2,1.75,1620,3640,1,0,0,3,7,900,720,47.543,-122.299,1590,5538,5260,7128,1620,90,90
3,2.25,2020,2750,2,0,0,3,8,1680,340,47.5633,-122.297,1720,1546,4770,3266,2020,11,11
4,3.25,2670,5001,1,0,0,3,9,1640,1030,47.5666,-122.293,1610,5001,7671,6611,2670,6,6
3,1.5,2120,6290,1,0,0,4,8,1220,900,47.5658,-122.318,1620,5400,8410,7020,2120,70,70
3,1.75,1840,5101,1,0,0,5,7,1040,800,47.5585,-122.317,1340,5000,6941,6340,1840,67,67
2,1.75,1650,4000,1,0,0,4,7,950,700,47.5622,-122.319,1060,4110,5650,5170,1650,72,72
2,1,1100,6000,1,0,0,4,6,1100,0,47.5275,-122.323,1280,6000,7100,7280,1100,119,119
4,3.75,2220,3797,1,0,0,4,6,1330,890,47.5574,-122.315,1490,4340,6017,5830,2220,102,102
1,0.75,420,6720,1,0,0,3,5,420,0,47.552,-122.311,1420,6720,7140,8140,420,97,97
3,1.5,1030,6969,1,0,0,4,6,1030,0,47.5492,-122.3,1420,6000,7999,7420,1030,98,98
3,1.75,1200,4500,1,0,0,5,7,1200,0,47.5553,-122.316,1340,4500,5700,5840,1200,113,113
5,2.5,2760,6000,2,0,0,3,8,2760,0,47.5289,-122.321,1360,6000,8760,7360,2760,13,13
2,1,1000,4776,1,0,0,4,6,1000,0,47.5619,-122.315,1500,4800,5776,6300,1000,77,77
2,1,760,4000,1,0,0,3,6,760,0,47.5462,-122.32,1130,4000,4760,5130,760,109,109
4,1,1400,6739,1,0,0,3,7,1000,400,47.5402,-122.298,1500,6380,8139,7880,1400,65,65
2,1,1170,5043,1,0,0,3,6,880,290,47.5492,-122.302,1430,5692,6213,7122,1170,70,70
4,2.75,2500,5100,1,0,0,4,7,1420,1080,47.523,-122.332,1430,5100,7600,6530,2500,112,112
3,1.5,1870,9000,1,0,0,3,7,1120,750,47.5224,-122.318,1850,6000,10870,7850,1870,96,96
2,1,670,4500,1,0,0,3,5,670,0,47.5271,-122.326,1210,4500,5170,5710,670,114,114
5,1.75,2460,6846,1,0,0,5,7,1340,1120,47.5445,-122.321,1410,4800,9306,6210,2460,108,108
3,1.75,1430,4850,1,0,0,3,7,930,500,47.5472,-122.303,1430,4850,6280,6280,1430,41,41
3,2.5,1600,1936,2,0,0,3,7,1600,0,47.5629,-122.297,1600,1936,3536,3536,1600,12,12
2,1,1320,9967,1,0,0,3,6,940,380,47.5693,-122.296,1970,7587,11287,9557,1320,100,100
4,2.75,2470,7200,1,0,0,5,7,1350,1120,47.5631,-122.317,1500,6000,9670,7500,2470,79,79
3,1,1190,6250,1,0,0,3,7,990,200,47.5658,-122.292,1760,6434,7440,8194,1190,65,65
2,1.75,1270,1685,2,0,0,3,8,1270,0,47.5646,-122.295,1270,1843,2955,3113,1270,7,7
3,1.75,1270,4815,1,0,0,3,6,980,290,47.5495,-122.31,1270,6431,6085,7701,1270,97,97
3,2.5,2100,5060,2,0,0,3,7,2100,0,47.563,-122.298,1520,2468,7160,3988,2100,13,13
4,2,1750,5202,1,0,1,4,6,1070,680,47.5677,-122.317,2090,5400,6952,7490,1750,77,77
3,1.75,1130,7500,1,0,0,4,7,1130,0,47.5254,-122.318,1240,6000,8630,7240,1130,111,111
4,1.5,1420,6720,1,0,0,3,7,1420,0,47.5518,-122.311,1560,5600,8140,7160,1420,94,94
2,1,750,6720,1,0,0,3,6,750,0,47.552,-122.31,920,6720,7470,7640,750,103,103
3,2.5,1800,3253,2,0,0,3,7,1800,0,47.5401,-122.292,1800,3081,5053,4881,1800,18,18
3,1,1100,6000,1,0,0,2,6,1100,0,47.5279,-122.318,960,5880,7100,6840,1100,93,93
2,1,840,4200,1,0,0,3,5,840,0,47.5292,-122.316,830,5000,5040,5830,840,81,81
4,1.5,3520,4933,1,0,0,4,8,2270,1250,47.5655,-122.315,1710,5400,8453,7110,3520,90,90
3,2.25,1590,3056,2,0,0,3,7,1590,0,47.5432,-122.293,1540,2890,4646,4430,1590,18,18
4,1.75,1780,5000,1,0,0,5,7,890,890,47.5329,-122.292,1860,5000,6780,6860,1780,116,116
3,2.5,1460,3044,2,0,0,3,7,1460,0,47.544,-122.296,1490,3044,4504,4534,1460,19,19
4,3,2860,5724,1,0,0,3,7,1730,1130,47.5427,-122.302,2340,7200,8584,9540,2860,36,36
2,1,750,4000,1,0,0,2,6,750,0,47.54,-122.32,1160,4000,4750,5160,750,86,86
4,1,2410,6975,1,0,0,3,7,1510,900,47.5692,-122.295,1880,6255,9385,8135,2410,62,62
2,2.25,1490,6770,1,0,0,3,8,1490,0,47.5577,-122.297,1820,7875,8260,9695,1490,93,93
4,1,1530,5684,1,0,0,3,7,1130,400,47.5507,-122.298,1540,6095,7214,7635,1530,62,62
6,3,2510,5310,1,0,0,4,7,1460,1050,47.5533,-122.304,1390,5407,7820,6797,2510,75,75
3,3.5,1900,4805,2,0,0,3,8,1560,340,47.5686,-122.315,1360,4800,6705,6160,1900,20,20
3,1.75,1400,6000,1,0,0,4,7,700,700,47.5283,-122.321,1030,6000,7400,7030,1400,100,100
4,2,1450,5456,1,0,0,5,7,1450,0,47.5442,-122.297,980,6100,6906,7080,1450,68,68
3,2.5,1700,3575,2,0,0,3,7,1700,0,47.5418,-122.295,1590,3380,5275,4970,1700,19,19
2,1,950,7954,1,0,0,4,7,950,0,47.557,-122.306,1180,6828,8904,8008,950,78,78
2,1,920,5850,1,0,0,4,6,920,0,47.5441,-122.304,1640,5476,6770,7116,920,119,119
5,3.25,2360,3873,2,0,0,3,8,1990,370,47.5635,-122.299,1720,3071,6233,4791,2360,13,13
4,2.5,2240,5624,1,0,0,3,7,1520,720,47.5574,-122.308,2240,7495,7864,9735,2240,58,58
3,3.25,2220,8227,1,0,0,5,8,1770,450,47.5665,-122.316,1750,4800,10447,6550,2220,90,90
5,1.75,1550,5225,1,0,0,4,7,1550,0,47.554,-122.306,1220,5225,6775,6445,1550,78,78
3,3.5,1790,1682,2,0,0,3,7,1480,310,47.542,-122.321,1150,4000,3472,5150,1790,13,13
3,2.5,1530,2890,2,0,0,3,7,1530,0,47.5434,-122.293,1540,2890,4420,4430,1530,18,18
3,2,1330,6000,1,0,0,4,7,630,700,47.5255,-122.327,1140,6000,7330,7140,1330,119,119
3,1.75,1300,958,2,0,0,3,7,840,460,47.5677,-122.314,1340,1254,2258,2594,1300,8,8
2,1,760,4000,1,0,0,4,6,760,0,47.5466,-122.304,1640,4500,4760,6140,760,69,69
3,1,1630,5000,1,0,0,3,7,930,700,47.5497,-122.295,1630,5480,6630,7110,1630,65,65
3,2.25,3020,6000,3,0,2,3,8,1980,1040,47.5249,-122.319,1150,6000,9020,7150,3020,25,25
2,1,770,2191,1,0,0,3,6,770,0,47.5512,-122.323,940,5000,2961,5940,770,82,82
3,1.75,2660,5511,1,0,0,3,8,1330,1330,47.5575,-122.3,2030,6111,8171,8141,2660,71,71
2,1,1010,7500,1,0,0,3,7,1010,0,47.5283,-122.32,1220,6000,8510,7220,1010,78,78
3,2.5,1880,5290,1,0,0,3,8,1250,630,47.5401,-122.3,2030,5092,7170,7122,1880,45,45
4,2,2310,5004,1,0,0,3,7,1430,880,47.5471,-122.298,1630,5060,7314,6690,2310,25,25
3,1,2010,6000,1,0,0,3,7,1210,800,47.5515,-122.298,2460,6000,8010,8460,2010,52,52
5,3,2020,5917,1,0,0,3,7,1220,800,47.5482,-122.294,2130,5529,7937,7659,2020,26,26
2,1.75,1740,5100,1,0,0,3,6,580,1160,47.5211,-122.33,1440,5100,6840,6540,1740,104,104
2,1,700,7457,1,0,0,3,6,700,0,47.5348,-122.295,1500,7130,8157,8630,700,76,76
5,2,2190,8316,1,0,0,3,7,1390,800,47.5488,-122.298,2010,8316,10506,10326,2190,58,58
3,1.5,2030,8880,1,0,0,3,7,1330,700,47.5586,-122.311,2140,5592,10910,7732,2030,56,56
3,1.5,2480,5280,1,0,0,5,7,1620,860,47.5575,-122.303,2090,4800,7760,6890,2480,72,72
2,1,1800,5182,1,0,0,3,6,900,900,47.5508,-122.3,1570,5876,6982,7446,1800,77,77
3,2.5,1520,2550,2,0,0,3,7,1520,0,47.5245,-122.33,1460,2550,4070,4010,1520,14,14
4,3.5,3820,17745,2,0,2,3,8,2440,1380,47.557,-122.295,2520,9640,21565,12160,3820,64,64
1,1,780,4000,1,0,0,3,5,780,0,47.5424,-122.321,1150,4000,4780,5150,780,114,114
4,2,1210,4250,1,0,0,4,7,1210,0,47.5275,-122.321,1210,6000,5460,7210,1210,78,78
2,2.5,1240,1546,2,0,0,3,7,1240,0,47.5634,-122.298,1520,2468,2786,3988,1240,12,12
1,1,800,2480,1,0,0,4,6,800,0,47.5581,-122.316,1490,4650,3280,6140,800,100,100
3,1.75,2110,4800,1,0,0,3,8,1210,900,47.567,-122.318,1660,4800,6910,6460,2110,63,63
4,2.5,2540,5001,2,0,0,3,9,2540,0,47.5423,-122.302,2360,6834,7541,9194,2540,14,14
4,3,1800,2500,2,0,0,3,7,1800,0,47.5333,-122.294,1830,6900,4300,8730,1800,19,19
3,2.5,1410,1332,2,0,0,3,7,960,450,47.5683,-122.314,1410,1343,2742,2753,1410,5,5
3,1,1250,6250,1,0,0,2,7,1030,220,47.5292,-122.323,1130,6250,7500,7380,1250,70,70
3,1,1100,5100,1,0,0,4,7,1100,0,47.5231,-122.332,1450,5100,6200,6550,1100,106,106
3,2,2020,7260,1,0,0,3,7,1180,840,47.5496,-122.311,1400,5950,9280,7350,2020,93,93
3,1,1320,5750,1,0,0,3,7,1320,0,47.5288,-122.325,1010,5700,7070,6710,1320,106,106
5,3,2270,5001,1,0,0,3,7,1360,910,47.5539,-122.3,1950,5500,7271,7450,2270,30,30
3,2.5,1530,2890,2,0,0,3,7,1530,0,47.5434,-122.293,1540,2890,4420,4430,1530,18,18
3,2.5,1650,4929,2,0,0,3,7,1520,130,47.5634,-122.298,1520,2287,6579,3807,1650,12,12
2,1,1020,7920,1,0,0,3,6,1020,0,47.5558,-122.31,1530,6900,8940,8430,1020,80,80
3,2.75,2220,5000,2,0,0,3,7,2220,0,47.5515,-122.324,960,5000,7220,5960,2220,26,26
2,2,2010,3797,1,0,0,3,7,1450,560,47.5596,-122.315,1660,4650,5807,6310,2010,97,10
2,1,1080,2674,1,0,0,4,6,720,360,47.5595,-122.317,1250,5000,3754,6250,1080,100,100
5,3,2560,5445,1,0,0,4,7,1760,800,47.5502,-122.311,1080,5445,8005,6525,2560,92,92
4,3.5,2440,3052,2,0,0,3,8,1940,500,47.555,-122.309,2390,4600,5492,6990,2440,13,13
3,1.75,1690,1468,2,0,0,3,8,1380,310,47.563,-122.297,1690,1936,3158,3626,1690,11,11
3,1.75,1140,1165,2,0,0,3,8,1140,0,47.5638,-122.295,1150,1552,2305,2702,1140,5,5
3,2,1720,5525,1,0,2,5,7,960,760,47.559,-122.298,1760,5525,7245,7285,1720,78,78
2,1,840,4000,1,0,0,3,6,840,0,47.5531,-122.307,1100,4000,4840,5100,840,77,77
2,1,1070,7386,1,0,0,3,6,1070,0,47.5434,-122.298,1330,6351,8456,7681,1070,70,70
3,1.5,1390,1882,2,0,0,3,7,1390,0,47.5667,-122.297,1490,2175,3272,3665,1390,5,5
3,2.5,1800,2516,2,0,0,3,7,1800,0,47.5401,-122.293,1800,2562,4316,4362,1800,18,18
4,1.75,2430,5481,1,0,0,3,8,1430,1000,47.5569,-122.298,2050,5508,7911,7558,2430,66,66
3,2.75,2030,6840,1,0,0,3,7,1210,820,47.5413,-122.299,1910,6365,8870,8275,2030,40,40
3,2,1410,4303,1,0,0,4,7,1410,0,47.5541,-122.317,1660,4326,5713,5986,1410,119,119
2,2,1090,934,3,0,0,3,8,1090,0,47.6341,-122.342,1090,1376,2024,2466,1090,11,11
3,1,1370,5250,1,0,0,3,7,1070,300,47.6421,-122.348,2410,4200,6620,6610,1370,80,80
3,1,1500,2555,2,0,2,3,7,1500,0,47.627,-122.353,1820,2555,4055,4375,1500,109,109
2,2,1830,3600,1,0,0,4,7,1230,600,47.6359,-122.351,2020,3600,5430,5620,1830,93,93
3,2,1560,3200,1,0,0,3,7,1560,0,47.6398,-122.356,1240,3600,4760,4840,1560,109,7
4,3.75,3520,3944,1,0,0,5,8,2200,1320,47.6424,-122.348,2310,4725,7464,7035,3520,106,106
2,1,1450,7098,1,0,4,3,7,1450,0,47.63,-122.349,2390,6098,8548,8488,1450,95,95
3,2.5,1980,2975,3,0,2,3,8,1980,0,47.6294,-122.344,1980,3144,4955,5124,1980,26,26
5,2.5,2810,6000,2,0,0,3,9,2810,0,47.6367,-122.35,2240,4800,8810,7040,2810,112,112
3,3.25,1510,2064,2,0,0,3,8,1220,290,47.6398,-122.345,1670,2594,3574,4264,1510,11,11
3,1.5,1410,3600,1,0,0,3,7,1410,0,47.6402,-122.357,1370,3600,5010,4970,1410,113,113
4,2.5,3240,3600,2,0,0,3,9,2060,1180,47.6405,-122.356,1820,3600,6840,5420,3240,11,11
3,1.5,1660,3190,1,0,0,3,7,1660,0,47.6368,-122.351,2200,3240,4850,5440,1660,100,100
3,1,1110,6000,1,0,0,3,7,1110,0,47.6461,-122.357,1460,6000,7110,7460,1110,115,115
3,2,1880,3000,1,0,0,4,8,1040,840,47.6418,-122.351,1790,3000,4880,4790,1880,88,88
3,3.25,3530,4920,2,0,0,3,9,2660,870,47.641,-122.357,1900,4200,8450,6100,3530,4,4
3,3,3180,2758,2,0,2,3,11,2240,940,47.6377,-122.342,2420,2758,5938,5178,3180,11,11
3,2.5,1300,1590,2,0,0,3,8,1100,200,47.6384,-122.343,1070,1223,2890,2293,1300,5,5
2,1,1130,2640,1,0,0,4,8,1130,0,47.6438,-122.357,1680,3200,3770,4880,1130,92,92
3,2.5,2000,1950,3,0,0,3,8,2000,0,47.6476,-122.356,1560,1340,3950,2900,2000,14,14
3,2,1140,6000,1,0,0,3,7,1140,0,47.637,-122.355,1260,4000,7140,5260,1140,110,110
5,2.5,1660,4000,1,0,0,5,8,1660,0,47.6452,-122.352,1210,4000,5660,5210,1660,90,90
3,1,2230,3200,2,0,2,3,8,1630,600,47.6334,-122.356,2280,5400,5430,7680,2230,101,101
4,1.75,2410,6000,1,0,0,3,8,2410,0,47.6369,-122.355,1280,4000,8410,5280,2410,108,108
3,3.25,2420,1923,2,0,2,3,10,1840,580,47.637,-122.341,1840,2890,4343,4730,2420,13,13
4,2.75,2250,5700,1,0,0,3,8,1200,1050,47.6406,-122.344,1720,3850,7950,5570,2250,68,68
4,1.75,1880,3720,1,0,0,4,7,1880,0,47.6431,-122.356,2090,4095,5600,6185,1880,95,95
2,1,970,3400,1,0,0,3,7,970,0,47.6444,-122.357,1180,3600,4370,4780,970,95,95
4,1,1150,2560,1,0,0,3,7,1150,0,47.6368,-122.355,1890,3000,3710,4890,1150,110,110
3,1.75,2190,3800,1,0,2,4,8,2190,0,47.643,-122.355,2190,3880,5990,6070,2190,96,96
4,1.75,2000,6000,1,0,3,5,7,1000,1000,47.6428,-122.348,2610,4377,8000,6987,2000,63,63
3,2.75,2170,2738,1,0,0,4,9,1550,620,47.6389,-122.349,1170,1062,4908,2232,2170,89,89
2,2,1490,713,3,0,0,3,9,1490,0,47.6356,-122.346,1490,1110,2203,2600,1490,5,5
3,1.5,1570,1050,2,0,0,3,8,1570,0,47.6358,-122.356,2070,3600,2620,5670,1570,104,104
7,4.5,6210,8856,2,0,2,5,11,4760,1450,47.6307,-122.354,2940,5400,15066,8340,6210,109,109
3,1,1180,3400,1,0,0,3,8,1180,0,47.6376,-122.353,1440,3400,4580,4840,1180,112,112
3,2.75,2260,4000,2,0,0,4,8,1540,720,47.6435,-122.353,2120,4000,6260,6120,2260,63,63
3,3.5,1650,1577,2,0,0,3,7,1100,550,47.6302,-122.344,1580,1280,3227,2860,1650,7,7
3,2.5,2460,6600,1,0,0,4,8,1560,900,47.6364,-122.351,2090,3400,9060,5490,2460,90,90
4,3,1670,2642,2,0,0,3,8,1350,320,47.6397,-122.345,1670,2594,4312,4264,1670,11,11
3,1,1520,2500,1,0,0,3,8,1520,0,47.6347,-122.352,1880,3600,4020,5480,1520,107,107
2,1,1100,4000,1,0,0,3,7,1100,0,47.6388,-122.35,1590,4000,5100,5590,1100,113,113
4,3.25,3100,3900,2,0,2,5,9,2090,1010,47.6385,-122.348,2110,3900,7000,6010,3100,96,96
3,1.75,2610,6360,2,0,2,3,8,2130,480,47.6287,-122.351,3010,6000,8970,9010,2610,95,95
2,1.75,1560,1750,1,0,0,4,6,780,780,47.6347,-122.355,1850,3600,3310,5450,1560,115,115
3,2.5,1260,889,3,0,0,3,8,1260,0,47.6277,-122.345,1340,1324,2149,2664,1260,11,11
3,2.5,2490,4000,2,0,0,5,8,1670,820,47.6403,-122.35,2310,4000,6490,6310,2490,101,101
3,2.5,2040,6000,1,0,0,3,8,1840,200,47.6334,-122.35,1820,4920,8040,6740,2040,68,68
3,1.5,2680,4775,2,0,2,5,8,1880,800,47.6333,-122.347,2280,5947,7455,8227,2680,106,106
4,3.25,3770,4103,2,0,0,5,9,2710,1060,47.641,-122.349,2560,4160,7873,6720,3770,94,94
3,1.75,1840,2310,1,0,2,4,8,1140,700,47.6462,-122.351,1670,4000,4150,5670,1840,105,105
4,3,2240,6000,1,0,0,4,8,1270,970,47.6369,-122.35,2240,4250,8240,6490,2240,105,105
3,2.5,1500,1119,3,0,2,3,7,1110,390,47.6327,-122.346,1500,1057,2619,2557,1500,11,11
2,2,1450,989,3,0,0,3,9,1450,0,47.6354,-122.346,1490,1240,2439,2730,1450,5,5
5,2,3370,5000,1,0,0,4,7,2140,1230,47.6373,-122.35,1920,3200,8370,5120,3370,112,112
4,2,1410,4480,1,0,0,3,8,1410,0,47.6385,-122.344,1240,3400,5890,4640,1410,92,92
6,1,1730,2760,1,0,0,3,7,1250,480,47.6342,-122.353,1630,3200,4490,4830,1730,101,101
3,3.25,1690,1473,2,0,0,3,8,1380,310,47.6397,-122.345,1670,2594,3163,4264,1690,11,11
1,1,630,1362,1,0,0,3,7,630,0,47.6342,-122.342,1090,1376,1992,2466,630,76,76
2,1.5,1030,4500,1,0,0,3,7,830,200,47.6455,-122.352,1250,4000,5530,5250,1030,95,95
3,1.5,1200,890,2,0,0,3,8,1030,170,47.6384,-122.342,1230,2120,2090,3350,1200,11,11
3,2,1810,2159,1,0,0,3,7,1010,800,47.6273,-122.345,1810,2159,3969,3969,1810,97,97
3,3.5,1480,1077,2,0,0,3,7,1300,180,47.5421,-122.322,1140,2003,2557,3143,1480,12,12
4,2.25,1950,5950,1,0,0,3,8,1330,620,47.639,-122.347,2600,5593,7900,8193,1950,72,72
3,2.25,2390,2750,2,0,0,5,8,1580,810,47.6339,-122.354,2200,5160,5140,7360,2390,94,94
3,3.25,3140,5445,2,0,3,4,10,2240,900,47.6406,-122.347,2950,5250,8585,8200,3140,106,106
2,1,1150,4400,1,0,0,4,7,1150,0,47.6226,-122.292,1240,4400,5550,5640,1150,114,114
3,2.75,2480,3240,1,0,0,3,9,1890,590,47.6399,-122.311,2160,3240,5720,5400,2480,90,90
3,1.5,2560,4000,1,0,0,5,8,1660,900,47.6384,-122.279,2560,4000,6560,6560,2560,92,92
3,3.5,3490,4000,2,0,0,3,9,2570,920,47.6385,-122.281,1880,4000,7490,5880,3490,10,10
5,4.5,3732,4426,2,0,0,3,10,2932,800,47.6189,-122.288,2950,4000,8158,6950,3732,18,18
4,3.5,3400,3850,2,0,0,3,10,2790,610,47.6258,-122.302,2030,4000,7250,6030,3400,11,11
2,2.5,1230,1391,2,0,0,3,8,870,360,47.6192,-122.301,1240,1350,2621,2590,1230,15,15
3,2.5,1580,1161,2,0,0,3,8,1010,570,47.6206,-122.299,1680,1177,2741,2857,1580,11,11
4,3.5,3440,3800,3,0,0,3,9,3440,0,47.6408,-122.307,1760,3800,7240,5560,3440,5,5
4,2.25,1890,5940,1,0,1,3,9,1470,420,47.6316,-122.303,2430,5940,7830,8370,1890,56,56
2,2,1460,1085,2,0,0,3,8,950,510,47.6205,-122.299,1580,1202,2545,2782,1460,5,5
2,1.75,2140,5000,1,0,0,3,7,1000,1140,47.6284,-122.291,2250,4000,7140,6250,2140,89,23
5,1.5,3050,2992,1,0,0,4,8,1920,1130,47.621,-122.302,1200,1209,6042,2409,3050,88,88
4,1.5,2040,6900,2,0,0,3,9,2040,0,47.6188,-122.285,3150,8220,8940,11370,2040,116,116
3,1.75,2650,5512,2,0,0,3,9,2250,400,47.6265,-122.295,1440,5100,8162,6540,2650,35,35
8,3.5,4440,6480,2,0,3,5,10,3140,1300,47.631,-122.303,4440,8640,10920,13080,4440,60,60
2,2.25,1230,932,2,0,0,3,8,1020,210,47.6192,-122.301,1230,1064,2162,2294,1230,15,15
2,1,790,4000,1,0,2,3,7,790,0,47.6248,-122.301,1700,4200,4790,5900,790,111,111
4,3.5,3480,4000,2,0,0,3,9,2460,1020,47.6356,-122.281,2620,4000,7480,6620,3480,4,4
4,4,5780,7173,2,0,0,3,11,4130,1650,47.6374,-122.288,3930,7994,12953,11924,5780,11,11
4,2.5,1700,4418,2,0,0,3,8,1700,0,47.6434,-122.3,2090,4174,6118,6264,1700,88,15
4,3.25,3030,5164,1,0,0,5,9,2700,330,47.6394,-122.299,1890,4415,8194,6305,3030,94,94
4,3.25,2050,5000,2,0,0,4,8,1370,680,47.6235,-122.298,1720,5000,7050,6720,2050,32,32
4,3.5,3680,2242,2,0,0,3,9,2670,1010,47.6192,-122.307,1350,1288,5922,2638,3680,89,7
3,2.25,2610,3357,2,0,0,4,7,1980,630,47.638,-122.306,1940,3357,5967,5297,2610,93,93
3,4.25,2820,7200,2,0,0,4,10,2460,360,47.6298,-122.29,3300,7522,10020,10822,2820,89,89
2,2,1880,5400,1,0,0,3,8,1880,0,47.6238,-122.311,1590,5400,7280,6990,1880,117,117
3,1,1660,4400,1,0,0,3,8,1460,200,47.6362,-122.302,1660,4400,6060,6060,1660,108,108
4,2.25,2870,6000,1,0,0,5,8,1730,1140,47.6362,-122.282,2370,5500,8870,7870,2870,68,68
4,1.5,1810,3400,2,0,0,3,8,1810,0,47.6264,-122.302,1770,3600,5210,5370,1810,93,93
3,1.75,2140,4800,2,0,0,3,8,1690,450,47.6311,-122.312,2440,4800,6940,7240,2140,114,114
4,4.5,3130,5126,3,0,0,3,10,2450,680,47.6239,-122.29,2540,7784,8256,10324,3130,5,5
3,2,1400,1657,2,0,0,3,8,1060,340,47.6196,-122.298,1540,2275,3057,3815,1400,15,15
3,2.5,1620,1377,2,0,0,3,8,1100,520,47.6195,-122.299,1620,1251,2997,2871,1620,10,10
2,1,950,4560,1,0,0,3,7,950,0,47.6288,-122.3,2040,4560,5510,6600,950,94,94
5,3.5,3090,3600,2,0,0,3,9,2060,1030,47.6217,-122.309,2240,3904,6690,6144,3090,19,19
3,3.75,3150,8550,2,0,0,3,10,3150,0,47.6387,-122.284,2510,8550,11700,11060,3150,12,12
4,1.5,1850,3600,2,0,0,3,8,1660,190,47.6376,-122.307,1970,3600,5450,5570,1850,90,90
4,3.25,3020,4000,1,0,0,5,8,1920,1100,47.6395,-122.279,2400,4000,7020,6400,3020,92,92
3,2,2050,3933,1,0,0,3,8,1180,870,47.6436,-122.303,1940,4000,5983,5940,2050,93,13
4,1,1860,4736,1,0,0,1,7,1860,0,47.6251,-122.3,1800,4000,6596,5800,1860,118,118
6,4.5,4800,9097,2,0,0,3,10,3580,1220,47.6259,-122.291,2180,6037,13897,8217,4800,12,12
2,2.5,2210,4440,2,0,0,4,8,1440,770,47.6305,-122.3,1560,4920,6650,6480,2210,88,88
4,2.5,2790,5450,2,0,0,3,10,1930,860,47.6453,-122.303,2320,5450,8240,7770,2790,94,14
3,1.5,2200,2880,2,0,0,5,7,1440,760,47.6308,-122.312,2440,4640,5080,7080,2200,115,115
4,1.5,2650,6900,2,0,0,4,9,2400,250,47.6275,-122.305,2420,6900,9550,9320,2650,110,110
3,4,4200,30120,2,0,2,4,11,3600,600,47.6379,-122.311,2760,12200,34320,14960,4200,86,86
3,2,2090,4077,1,0,0,4,8,1530,560,47.6433,-122.3,2010,4132,6167,6142,2090,88,88
4,2.25,2190,4104,2,0,0,5,8,1410,780,47.6419,-122.306,1990,3860,6294,5850,2190,91,91
3,1.75,2560,4800,1,0,0,3,7,1280,1280,47.6207,-122.295,1620,4800,7360,6420,2560,108,108
4,2.25,2940,5735,1,0,0,3,9,1470,1470,47.6381,-122.304,2230,5659,8675,7889,2940,62,62
4,2.5,3370,8402,1,0,0,5,10,2240,1130,47.6349,-122.29,3190,8700,11772,11890,3370,57,57
3,2.75,3150,5520,1,0,0,4,8,2130,1020,47.6345,-122.302,3160,6200,8670,9360,3150,94,94
4,3.5,3890,3600,2,0,0,3,9,2860,1030,47.6342,-122.282,2460,6050,7490,8510,3890,14,14
4,3,2530,4560,1,0,0,3,7,1540,990,47.6287,-122.3,1640,4560,7090,6200,2530,94,0
4,3,2170,4000,2,0,0,4,9,1610,560,47.6196,-122.292,1670,4000,6170,5670,2170,37,3
4,3.5,5860,7200,2,0,0,5,10,3690,2170,47.6287,-122.287,4150,7200,13060,11350,5860,112,112
2,1,1290,4636,1,0,0,3,7,1290,0,47.6393,-122.301,1940,4635,5926,6575,1290,95,95
4,2,2120,3360,2,0,0,3,9,2120,0,47.6227,-122.31,2090,3600,5480,5690,2120,114,114
4,2.5,3940,4407,2,0,0,4,8,2620,1320,47.6374,-122.299,1790,4407,8347,6197,3940,98,98
4,2.25,2920,6513,2,0,0,4,9,2260,660,47.638,-122.29,4510,9248,9433,13758,2920,82,82
2,1,1280,6000,1,0,0,3,7,1280,0,47.6339,-122.282,2460,4800,7280,7260,1280,54,54
4,2.25,3260,4640,2,0,0,5,9,2360,900,47.6272,-122.312,3240,5800,7900,9040,3260,112,112
2,1,710,4800,1,0,0,2,6,710,0,47.6212,-122.298,1480,1721,5510,3201,710,69,69
5,4.25,4860,9453,1,0,1,5,10,3100,1760,47.6196,-122.286,3150,8557,14313,11707,4860,114,114
3,2.5,2030,1800,3,0,0,3,9,2030,0,47.6199,-122.3,1450,1441,3830,2891,2030,6,6
3,3,4040,7200,1,0,2,4,9,3340,700,47.6288,-122.284,3450,10800,11240,14250,4040,89,89
3,1.5,1940,4000,1,0,0,3,8,1310,630,47.6205,-122.291,1940,4000,5940,5940,1940,104,104
3,4.25,5150,7800,2,0,2,3,11,4170,980,47.6288,-122.282,4270,7800,12950,12070,5150,65,65
2,1,700,3400,1,0,0,3,6,700,0,47.6212,-122.296,1570,4512,4100,6082,700,73,73
3,2,2360,4800,2,0,0,3,9,2360,0,47.6317,-122.312,2260,4800,7160,7060,2360,110,0
4,4.75,4575,24085,2,0,2,5,10,3905,670,47.6263,-122.284,3900,9687,28660,13587,4575,93,93
4,2.5,2230,3600,2,0,0,5,8,1630,600,47.6304,-122.309,2410,4800,5830,7210,2230,113,113
5,1.75,1910,5640,2,0,0,4,9,1910,0,47.6249,-122.311,2050,5400,7550,7450,1910,113,113
3,2.25,1490,1212,2,0,0,3,9,1040,450,47.6226,-122.313,1490,1337,2702,2827,1490,8,8
3,1.75,1600,4400,1,0,0,3,7,1030,570,47.6348,-122.281,2150,4000,6000,6150,1600,78,78
2,1.25,1230,1569,2,0,0,3,9,1050,180,47.6193,-122.304,1100,1230,2799,2330,1230,10,10
4,2.25,2870,6280,1,0,0,4,9,1980,890,47.6329,-122.31,2370,4760,9150,7130,2870,114,114
4,3.25,2850,4800,2,0,0,5,10,2700,150,47.6292,-122.312,2850,4800,7650,7650,2850,114,114
3,1,1180,3600,1,0,0,3,7,1180,0,47.6337,-122.28,1900,3600,4780,5500,1180,93,93
3,2,1840,2825,1,0,0,3,7,1040,800,47.6428,-122.302,1820,3750,4665,5570,1840,99,99
4,2.25,2360,4000,2,0,0,3,9,2360,0,47.6198,-122.289,3040,4400,6360,7440,2360,6,6
3,2.25,2980,7700,1,0,0,3,9,2530,450,47.6336,-122.29,3020,8234,10680,11254,2980,55,55
2,2,1450,2272,1,0,0,4,6,750,700,47.633,-122.282,2170,4370,3722,6540,1450,95,95
3,3.25,3020,6073,2,0,0,4,9,3020,0,47.6332,-122.29,3020,7700,9093,10720,3020,65,65
4,2.75,2250,3433,1,0,0,3,8,1500,750,47.6382,-122.307,1970,3484,5683,5454,2250,92,1
4,2.5,3070,7207,2,0,0,4,10,2670,400,47.6325,-122.29,3190,7523,10277,10713,3070,92,92
3,2.5,1740,2350,2,0,0,3,8,1130,610,47.6207,-122.297,1740,3201,4090,4941,1740,24,24
4,3.5,3950,6240,2,0,0,3,11,3950,0,47.6221,-122.29,2040,6240,10190,8280,3950,4,4
2,1,1550,3200,1,0,0,3,8,1550,0,47.6368,-122.306,1800,3937,4750,5737,1550,92,92
3,1.5,2510,3600,2,0,0,4,8,2510,0,47.6195,-122.313,1740,1885,6110,3625,2510,112,112
4,4.25,4645,7757,2,0,0,3,10,3855,790,47.6248,-122.29,2150,6970,12402,9120,4645,13,13
3,2.5,2560,3600,2,0,0,3,9,2110,450,47.632,-122.279,2690,4800,6160,7490,2560,52,11
6,2.25,2930,4320,2,0,0,3,9,2130,800,47.6295,-122.306,2860,4320,7250,7180,2930,106,106
5,3,2640,3200,2,0,0,4,7,2140,500,47.6188,-122.308,1540,2242,5840,3782,2640,113,113
5,3,2840,6240,2,0,0,5,9,2440,400,47.6285,-122.309,2940,6000,9080,8940,2840,114,114
4,3.75,4490,7623,2,0,0,4,10,3090,1400,47.6315,-122.29,3760,7653,12113,11413,4490,78,78
4,1.5,2430,3600,2,0,0,3,8,2430,0,47.6351,-122.285,2020,4800,6030,6820,2430,39,39
2,2.5,2560,2500,2,0,0,5,8,1690,870,47.6233,-122.3,1890,5000,5060,6890,2560,118,118
3,2.25,1860,1386,3,0,0,3,9,1860,0,47.6368,-122.279,1680,3080,3246,4760,1860,5,5
2,2,1690,4200,2,0,0,3,7,1690,0,47.621,-122.303,1540,4200,5890,5740,1690,113,113
3,1,1210,3720,2,0,0,4,8,1210,0,47.6317,-122.301,1560,6000,4930,7560,1210,89,89
3,1.75,1920,3300,1,0,0,4,8,960,960,47.6239,-122.298,1740,4000,5220,5740,1920,106,106
3,2.75,2340,8828,1,0,0,4,9,2340,0,47.632,-122.289,3480,8526,11168,12006,2340,65,65
3,2.5,2500,7746,2,0,0,4,10,1910,590,47.6393,-122.311,2480,5099,10246,7579,2500,26,26
2,1,1430,3000,1,0,0,3,7,1300,130,47.6415,-122.303,1750,4000,4430,5750,1430,90,90
4,3.5,3280,3800,2,0,0,3,11,2880,400,47.6299,-122.28,2050,3800,7080,5850,3280,8,8
3,1.75,2460,4800,1,0,0,4,7,1230,1230,47.6343,-122.282,2860,4800,7260,7660,2460,81,81
3,2.5,2740,5925,2,0,2,3,10,2740,0,47.6313,-122.303,2740,5948,8665,8688,2740,106,22
4,2,1800,4800,1,0,0,3,7,1800,0,47.6388,-122.302,1950,4800,6600,6750,1800,101,101
5,2,2440,3080,2,0,0,4,8,2440,0,47.6242,-122.306,1640,3077,5520,4717,2440,109,109
5,2.25,4200,5800,2,0,0,4,9,2910,1290,47.6284,-122.312,3060,5800,10000,8860,4200,113,113
3,1,1400,1581,1,0,0,5,8,1400,0,47.6221,-122.314,1860,3861,2981,5721,1400,110,110
5,2.5,2750,5589,1,0,0,5,9,1840,910,47.6364,-122.3,1460,4250,8339,5710,2750,109,109
3,3.25,1720,1330,2,0,0,3,8,1030,690,47.62,-122.309,1720,1520,3050,3240,1720,15,15
2,2.75,1430,1425,2,0,0,3,7,995,435,47.621,-122.298,1500,1749,2855,3249,1430,13,13
4,2.5,2760,5750,2,0,0,3,8,2760,0,47.627,-122.303,2760,5390,8510,8150,2760,26,26
2,1.5,1940,4400,1,0,0,3,7,970,970,47.6371,-122.279,1480,3080,6340,4560,1940,96,96
2,2.5,1360,1349,2,0,0,3,8,1050,310,47.6254,-122.292,1430,4400,2709,5830,1360,22,22
2,2.25,1160,1010,2,0,0,3,8,1000,160,47.6207,-122.301,1200,1170,2170,2370,1160,13,13
8,2.75,2530,4800,2,0,0,4,7,1390,1140,47.6241,-122.305,1540,4800,7330,6340,2530,118,118
2,2,1140,690,2,0,0,3,8,760,380,47.6205,-122.3,1480,1171,1830,2651,1140,5,5
2,2.5,2220,4000,2,0,0,3,9,2220,0,47.6364,-122.28,1870,4000,6220,5870,2220,19,19
3,2,2240,5200,1,0,0,3,7,1630,610,47.6191,-122.296,1470,3775,7440,5245,2240,65,65
7,3,5350,14400,2,0,0,4,10,5020,330,47.6295,-122.285,3050,7469,19750,10519,5350,109,109
3,2,1990,3000,1,0,0,3,7,1230,760,47.6272,-122.29,1600,4080,4990,5680,1990,111,44
4,1.75,2180,4431,1,0,0,3,8,2020,160,47.636,-122.302,1890,4400,6611,6290,2180,107,107
3,2.25,2930,6000,2,0,2,3,11,1920,1010,47.6301,-122.301,1870,5040,8930,6910,2930,19,19
2,1.75,1600,4000,1,0,0,5,7,850,750,47.6408,-122.3,1860,4000,5600,5860,1600,101,101
3,2.25,3360,7108,2,0,0,3,10,2770,590,47.6187,-122.284,3450,8558,10468,12008,3360,114,10
4,2.5,2350,4675,2,0,0,3,9,2150,200,47.6344,-122.305,2240,3848,7025,6088,2350,96,96
3,1.5,990,1343,2,0,0,3,8,840,150,47.6236,-122.306,1350,2521,2333,3871,990,12,12
3,2.5,2280,2296,3,0,0,3,9,1890,390,47.6256,-122.299,1390,4000,4576,5390,2280,6,6
5,3.75,4590,11265,2,0,0,4,11,3450,1140,47.6389,-122.288,3870,8996,15855,12866,4590,92,92
3,1.75,2150,3503,2,0,0,3,8,1870,280,47.6285,-122.303,3920,6402,5653,10322,2150,98,98
4,2.25,4760,8036,2,0,0,5,9,3390,1370,47.6415,-122.285,2950,9323,12796,12273,4760,103,103
3,1,2050,4800,2,0,0,3,8,1950,100,47.6315,-122.311,2220,4800,6850,7020,2050,97,97
3,2.5,1640,1269,3,0,0,3,8,1640,0,47.6197,-122.3,1590,1231,2909,2821,1640,10,10
4,4,4260,11765,2,0,0,3,11,3280,980,47.638,-122.288,4260,10408,16025,14668,4260,80,5
3,2,1530,3400,1,0,0,3,7,990,540,47.6204,-122.296,1880,4212,4930,6092,1530,112,0
4,2,2970,5400,2,0,0,4,9,2970,0,47.6235,-122.309,2500,5040,8370,7540,2970,119,119
4,3,3540,11098,2,0,0,3,10,3000,540,47.634,-122.288,3430,8214,14638,11644,3540,79,79
2,1,1060,4228,1,0,0,3,7,860,200,47.6231,-122.293,1060,4187,5288,5247,1060,113,113
5,2.5,2350,4000,2,0,0,3,9,2350,0,47.6265,-122.296,1840,4000,6350,5840,2350,26,26
4,1.5,2550,5055,2,0,0,4,10,2550,0,47.636,-122.301,1970,4431,7605,6401,2550,109,109
3,1,1380,4000,1,0,0,3,7,1380,0,47.6261,-122.296,1690,4000,5380,5690,1380,109,109
4,2.75,2850,3000,2,0,0,3,9,2530,320,47.6406,-122.304,2083,4500,5850,6583,2850,16,16
2,1,1200,2500,2,0,2,3,7,1090,110,47.6304,-122.301,2690,4800,3700,7490,1200,92,92
3,1,2460,4000,1,0,0,4,7,1370,1090,47.6268,-122.297,1680,4000,6460,5680,2460,101,101
5,3.25,3680,6060,2,0,0,5,9,2630,1050,47.6341,-122.304,3050,5850,9740,8900,3680,94,94
3,2,1540,3600,2,0,0,3,8,1540,0,47.6343,-122.283,2970,3600,5140,6570,1540,119,26
3,2.25,2550,4089,2,0,0,3,9,2550,0,47.6272,-122.297,1680,4089,6639,5769,2550,36,36
5,4.75,5410,13431,2,0,0,4,10,5050,360,47.6306,-122.288,3750,11596,18841,15346,5410,78,78
2,1,1010,3885,1,0,0,4,7,1010,0,47.6224,-122.304,1770,4200,4895,5970,1010,113,24
4,2.5,2460,5000,2,0,0,5,8,1620,840,47.6282,-122.293,2320,5000,7460,7320,2460,81,81
3,1.5,1200,6240,1,0,0,3,8,1030,170,47.6222,-122.287,2810,6240,7440,9050,1200,67,67
3,1,1880,5450,1,0,0,4,8,1880,0,47.6453,-122.302,2580,5450,7330,8030,1880,95,95
3,1.5,1260,9570,1,0,0,3,7,870,390,47.7004,-122.305,1620,7000,10830,8620,1260,78,78
3,2,2390,6888,2,0,1,5,8,2390,0,47.6839,-122.274,2390,7920,9278,10310,2390,80,80
2,1,950,6000,1,0,0,3,7,950,0,47.6897,-122.294,1440,6000,6950,7440,950,77,77
4,2.75,2160,5005,1,0,0,3,7,1430,730,47.6971,-122.302,1770,5326,7165,7096,2160,32,32
3,2.25,3400,10000,2,0,0,3,10,3400,0,47.6846,-122.284,1860,5100,13400,6960,3400,36,36
3,1.75,1980,3300,1,0,0,4,7,1140,840,47.6733,-122.298,1590,5000,5280,6590,1980,93,93
4,2,2710,4750,1,0,0,4,7,1460,1250,47.6756,-122.305,1700,3800,7460,5500,2710,100,100
4,1,1170,4590,1,0,0,4,7,1170,0,47.6804,-122.311,1430,4080,5760,5510,1170,94,94
5,2,1940,6000,1,0,0,5,7,970,970,47.6875,-122.287,1700,6000,7940,7700,1940,74,74
5,2.25,2140,8700,1,0,2,3,8,1220,920,47.6969,-122.31,1720,6670,10840,8390,2140,57,57
4,2.5,1700,6380,1,0,0,4,7,850,850,47.6988,-122.319,1380,6380,8080,7760,1700,79,79
3,2,1980,6000,1,0,0,4,7,1380,600,47.6921,-122.283,1260,6000,7980,7260,1980,61,61
3,1.75,3000,5413,2,0,0,4,8,1900,1100,47.6962,-122.312,1550,5413,8413,6963,3000,56,56
4,2,2140,6360,2,0,0,3,7,1840,300,47.687,-122.286,1690,6360,8500,8050,2140,74,74
3,1,1140,7028,1,0,0,3,8,1140,0,47.6948,-122.322,1350,6923,8168,8273,1140,88,88
4,2.75,3150,7379,1,0,0,4,7,2430,720,47.6968,-122.3,1990,7379,10529,9369,3150,104,104
3,2.25,1360,5111,1,0,0,5,7,1360,0,47.6988,-122.313,1900,5111,6471,7011,1360,85,85
5,3.25,3240,6551,1,0,4,4,9,2500,740,47.6792,-122.273,2740,9300,9791,12040,3240,80,80
3,1,1440,5580,1,0,0,3,7,1440,0,47.6898,-122.326,2010,5580,7020,7590,1440,111,111
2,1,910,7000,1,0,0,3,7,910,0,47.6999,-122.305,1260,7528,7910,8788,910,67,67
3,2,1360,3120,2,0,0,3,7,1360,0,47.6943,-122.307,1360,3120,4480,4480,1360,30,30
5,4,2980,4500,1,0,0,3,7,2070,910,47.6736,-122.323,1560,4225,7480,5785,2980,98,98
4,3,3010,6139,2,0,4,5,8,2560,450,47.6799,-122.268,2100,6798,9149,8898,3010,69,43
3,1.5,1640,2720,1,0,0,3,8,1640,0,47.6869,-122.317,1490,4375,4360,5865,1640,90,90
3,1.5,1270,1413,3,0,0,3,8,1270,0,47.6989,-122.317,1270,1413,2683,2683,1270,12,12
4,2.5,2700,4275,2,0,0,3,9,2700,0,47.6725,-122.327,1810,4500,6975,6310,2700,15,15
3,2,1200,7320,1,0,0,3,7,1200,0,47.6986,-122.286,1750,8220,8520,9970,1200,64,64
5,1.75,2660,10637,1,0,0,5,7,1670,990,47.6945,-122.292,1570,6825,13297,8395,2660,97,97
5,2.75,2460,7830,1,0,0,5,9,1490,970,47.6938,-122.31,2050,7830,10290,9880,2460,64,64
4,1.75,2360,4750,2,0,0,5,7,1660,700,47.6729,-122.293,1810,4750,7110,6560,2360,108,108
2,2,1150,6634,1,0,0,3,7,860,290,47.7001,-122.309,1680,6892,7784,8572,1150,79,79
4,1.75,1890,4500,2,0,0,5,7,1490,400,47.6751,-122.289,1890,5000,6390,6890,1890,82,82
3,1.5,1810,5080,1,0,0,3,7,1030,780,47.6819,-122.287,1780,7620,6890,9400,1810,61,61
2,1,1440,7130,1,0,2,3,7,1210,230,47.6778,-122.267,1970,7130,8570,9100,1440,71,71
2,2,1420,9191,1,0,2,5,7,1420,0,47.6979,-122.32,1420,6816,10611,8236,1420,91,91
4,1,2220,3588,1,0,0,4,7,1470,750,47.6854,-122.308,1740,3588,5808,5328,2220,92,92
5,2.5,1980,10205,1,0,0,4,7,1080,900,47.699,-122.307,1310,5413,12185,6723,1980,90,90
5,1.75,2240,4750,1,0,0,4,7,1120,1120,47.6727,-122.293,1980,4750,6990,6730,2240,99,99
3,2.25,1190,1137,2,0,0,3,7,960,230,47.677,-122.325,1190,1080,2327,2270,1190,20,20
3,2.5,1250,864,3,0,0,3,8,1250,0,47.6978,-122.318,1330,2298,2114,3628,1250,15,15
2,2.25,2550,6000,2,0,0,5,7,1860,690,47.6739,-122.323,2010,4000,8550,6010,2550,117,117
2,1,910,4725,1,0,0,3,7,910,0,47.676,-122.281,1600,5200,5635,6800,910,70,70
4,2.25,2110,6375,1,0,2,4,8,1600,510,47.6819,-122.272,2760,6375,8485,9135,2110,78,78
3,1,1220,8329,1,0,0,3,6,1220,0,47.6982,-122.298,1490,8322,9549,9812,1220,73,73
3,1.75,1160,6120,1,0,0,3,7,1040,120,47.6926,-122.287,1530,6120,7280,7650,1160,78,78
2,1,1140,5720,1,0,0,3,7,850,290,47.6827,-122.298,1410,5832,6860,7242,1140,72,72
3,1,1390,4814,1,0,0,3,6,1390,0,47.6881,-122.32,1730,3990,6204,5720,1390,111,111
2,1,1280,4840,1,0,0,3,7,1200,80,47.6762,-122.299,1860,5500,6120,7360,1280,111,111
3,1,1180,6000,1,0,0,3,7,1180,0,47.6853,-122.286,1680,6000,7180,7680,1180,69,69
3,1,1750,5355,2,0,0,4,7,1750,0,47.6792,-122.31,2240,4590,7105,6830,1750,90,90
2,1,1060,3325,1,0,0,4,6,770,290,47.6896,-122.307,1820,4275,4385,6095,1060,87,87
3,1,1510,6083,1,0,0,4,6,860,650,47.6966,-122.324,1510,5712,7593,7222,1510,79,79
3,1,1010,6120,1,0,0,3,7,860,150,47.6861,-122.296,1930,6120,7130,8050,1010,79,79
3,1,1110,6250,1,0,0,3,7,1110,0,47.6977,-122.292,2010,6944,7360,8954,1110,63,63
4,2,2020,6867,1,0,0,5,8,1010,1010,47.7,-122.292,1250,6842,8887,8092,2020,77,77
2,1.75,1640,3090,1,0,0,4,7,910,730,47.679,-122.319,1510,4120,4730,5630,1640,94,94
5,2.75,2740,5616,1,0,0,5,7,1670,1070,47.6866,-122.317,1600,4592,8356,6192,2740,94,94
2,1,1060,4000,1,0,0,4,7,1060,0,47.6731,-122.315,1770,4000,5060,5770,1060,109,109
3,1.75,1820,5500,1,0,0,4,8,1620,200,47.6737,-122.283,2330,6050,7320,8380,1820,62,62
4,2.5,2820,6120,2,0,0,3,9,2820,0,47.6911,-122.293,1510,6120,8940,7630,2820,5,5
3,2.25,2330,4000,1,0,2,5,7,1520,810,47.6732,-122.29,1870,4000,6330,5870,2330,92,92
4,1,1720,2800,1,0,0,4,7,1200,520,47.6743,-122.299,1530,3500,4520,5030,1720,93,93
5,2.25,2610,4080,2,0,0,5,7,1750,860,47.6757,-122.309,2160,4080,6690,6240,2610,110,110
4,1.75,1940,3060,1,0,0,4,7,1000,940,47.6786,-122.317,1320,3060,5000,4380,1940,108,108
3,1,2030,4080,1,0,0,4,7,1840,190,47.6765,-122.308,2030,4080,6110,6110,2030,111,111
3,1.75,1300,2580,1,0,0,5,7,820,480,47.674,-122.319,1180,2820,3880,4000,1300,100,100
6,1,1530,4305,1,0,0,4,7,1530,0,47.6862,-122.31,1530,3800,5835,5330,1530,98,98
4,3.25,4110,15929,2,1,4,3,12,2720,1390,47.6934,-122.271,2640,15929,20039,18569,4110,18,18
3,1.75,1740,3060,1,0,0,5,8,950,790,47.6816,-122.31,1800,3960,4800,5760,1740,89,0
4,2.5,2600,7200,2,0,0,3,7,2600,0,47.6944,-122.274,1790,6175,9800,7965,2600,57,12
2,1,910,6490,1,0,0,3,7,910,0,47.6892,-122.306,1040,6490,7400,7530,910,77,77
3,1,1050,4160,1,0,0,4,7,1050,0,47.6756,-122.3,1580,3680,5210,5260,1050,94,94
4,1.5,1580,6360,1,0,0,3,7,1290,290,47.6873,-122.286,1690,6360,7940,8050,1580,74,74
5,2.25,2540,3750,1,0,0,4,7,1510,1030,47.6729,-122.299,1780,3750,6290,5530,2540,94,94
3,1.5,1630,2946,1,0,0,4,8,1630,0,47.6865,-122.31,1550,3800,4576,5350,1630,87,87
4,2.5,3100,7250,2,0,0,3,9,3100,0,47.6961,-122.316,1240,6670,10350,7910,3100,9,9
3,3.5,1494,1262,3,0,0,3,8,1494,0,47.6826,-122.324,1494,1264,2756,2758,1494,8,8
4,2.5,4070,7800,3,0,0,4,8,3390,680,47.6838,-122.327,2020,6760,11870,8780,4070,17,17
4,1,1540,5000,1,0,0,4,7,1090,450,47.6754,-122.294,1590,5000,6540,6590,1540,97,97
2,1.5,1190,3400,1,0,0,3,7,990,200,47.6726,-122.32,1410,3150,4590,4560,1190,100,100
3,1,1250,4590,1,0,0,3,6,970,280,47.6757,-122.327,1830,4080,5840,5910,1250,116,116
3,2.5,1502,1400,3,0,0,3,7,1502,0,47.6951,-122.305,1377,1466,2902,2843,1502,14,14
4,1.75,1850,5712,1,0,0,3,7,1850,0,47.6966,-122.324,1510,6038,7562,7548,1850,65,65
3,2.5,2070,4463,1,0,0,5,8,1780,290,47.6853,-122.305,2070,5000,6533,7070,2070,88,88
3,1.75,1880,6360,1,0,0,4,7,1040,840,47.6878,-122.286,1770,6175,8240,7945,1880,74,74
3,2,1463,868,3,0,0,3,7,1463,0,47.6843,-122.317,1484,4320,2331,5804,1463,16,16
5,3.5,2720,7598,2,0,0,3,8,1860,860,47.6931,-122.283,2430,7728,10318,10158,2720,26,26
3,1.75,1700,6500,1,0,0,3,8,1700,0,47.6837,-122.284,1880,6000,8200,7880,1700,52,52
1,1.75,1020,4512,1,0,0,3,7,770,250,47.6724,-122.266,1230,5029,5532,6259,1020,82,82
2,1.75,1060,4182,2,0,0,3,7,1060,0,47.6787,-122.308,1760,4590,5242,6350,1060,42,42
3,2.25,2340,6183,1,0,0,3,7,1210,1130,47.6979,-122.31,1970,6183,8523,8153,2340,90,90
3,1.5,2240,3800,2,0,0,3,8,1370,870,47.6887,-122.307,1690,4275,6040,5965,2240,90,90
4,2,2280,8339,1,0,0,4,7,1220,1060,47.6986,-122.297,1970,8340,10619,10310,2280,65,65
3,1.75,1300,5413,1,0,0,3,7,1300,0,47.6988,-122.32,1590,6380,6713,7970,1300,94,22
2,1,940,5413,1,0,0,3,7,940,0,47.6956,-122.304,1340,5296,6353,6636,940,96,96
4,2.5,2170,5257,2,0,0,3,7,2170,0,47.6999,-122.305,1430,7528,7427,8958,2170,30,30
3,3.25,1550,1444,3,0,0,3,8,1550,0,47.6767,-122.291,1550,1444,2994,2994,1550,13,13
3,1,1000,5100,1,0,0,3,7,860,140,47.6857,-122.293,1000,5100,6100,6100,1000,73,73
3,1,1080,4120,1,0,0,3,7,980,100,47.6771,-122.319,1280,3090,5200,4370,1080,100,100
4,1,1780,5000,1,0,0,3,8,1780,0,47.6761,-122.297,2030,5000,6780,7030,1780,72,72
4,1.75,1950,4200,1,0,0,5,7,1040,910,47.6755,-122.285,1450,5000,6150,6450,1950,68,68
3,2,1850,9570,1,0,0,4,7,950,900,47.697,-122.322,1430,6380,11420,7810,1850,79,79
2,1,1030,5072,1,0,0,3,6,1030,0,47.6962,-122.294,1220,6781,6102,8001,1030,95,56
3,1,910,5212,1,0,0,3,7,910,0,47.6742,-122.284,1520,6300,6122,7820,910,68,68
4,1.75,1560,7200,1,0,0,3,6,860,700,47.7001,-122.279,1420,7200,8760,8620,1560,76,76
3,1.75,1480,4050,1,0,0,3,7,870,610,47.681,-122.304,1350,4500,5530,5850,1480,93,93
4,3.5,2980,3000,2,0,0,3,9,2340,640,47.6768,-122.326,1810,4545,5980,6355,2980,11,11
3,1.5,1630,7475,1,0,1,3,7,1160,470,47.6725,-122.272,2320,7475,9105,9795,1630,79,79
3,1,860,6380,1,0,0,4,7,860,0,47.6942,-122.315,1250,6380,7240,7630,860,92,92
3,1,1050,6002,1,0,0,3,7,840,210,47.6988,-122.316,1180,6003,7052,7183,1050,78,78
4,1.75,2440,11793,1,0,4,3,8,1420,1020,47.6807,-122.267,2500,8028,14233,10528,2440,69,69
2,1,890,6380,1,0,0,3,6,890,0,47.691,-122.303,990,6380,7270,7370,890,68,68
2,2,1270,1372,3,0,0,3,8,1270,0,47.6776,-122.318,1610,3090,2642,4700,1270,19,19
1,1,950,10585,1,0,0,3,6,950,0,47.6968,-122.297,1400,7056,11535,8456,950,90,90
1,1,700,5100,1,0,0,3,7,700,0,47.679,-122.3,1010,5100,5800,6110,700,77,77
2,1,970,2700,1,0,0,4,7,770,200,47.6852,-122.312,1570,3348,3670,4918,970,93,93
4,1,1420,4875,1,0,0,3,7,1420,0,47.6942,-122.321,1110,5413,6295,6523,1420,89,89
6,2.5,3250,12000,1,0,1,3,8,1800,1450,47.6935,-122.28,3490,10320,15250,13810,3250,53,53
2,1,990,5643,1,0,0,3,7,870,120,47.6802,-122.298,1280,5700,6633,6980,990,72,72
4,2.5,2830,5010,2,0,0,3,9,2170,660,47.6952,-122.327,1880,5739,7840,7619,2830,19,19
4,3,2360,6678,1,0,0,3,8,1760,600,47.6919,-122.313,1640,6380,9038,8020,2360,70,70
4,2.75,2290,3060,1,0,0,5,7,1550,740,47.6793,-122.316,1460,3060,5350,4520,2290,91,91
5,2.5,2380,8204,1,0,0,3,8,1540,840,47.7,-122.287,2270,8204,10584,10474,2380,62,62
2,2.25,1470,1101,2,0,0,3,8,1340,130,47.6768,-122.301,1470,1582,2571,3052,1470,14,14
4,2.25,2410,4000,2,0,0,5,8,1650,760,47.6727,-122.316,1820,4000,6410,5820,2410,109,109
3,1.5,1750,5400,1,0,0,4,7,1050,700,47.6799,-122.279,1750,5400,7150,7150,1750,67,67
2,1,1080,4080,1,0,0,3,8,1080,0,47.6899,-122.32,1890,4080,5160,5970,1080,71,71
2,1,740,4275,1,0,0,5,6,740,0,47.688,-122.308,1900,4275,5015,6175,740,95,95
2,1.5,1400,4050,1,0,0,4,8,1400,0,47.6768,-122.269,1900,5940,5450,7840,1400,65,65
3,3,1833,1706,3,0,0,3,9,1833,0,47.6827,-122.325,1466,1455,3539,2921,1833,21,21
3,1.75,1960,4788,1,0,0,4,7,1090,870,47.6746,-122.312,1960,3960,6748,5920,1960,99,99
4,1.75,2700,7625,1,0,0,4,8,1450,1250,47.6838,-122.323,1760,3300,10325,5060,2700,82,82
4,1,1360,6000,1,0,0,3,7,1360,0,47.6854,-122.288,1710,6000,7360,7710,1360,102,102
3,2.5,2550,5100,2,0,0,3,9,2550,0,47.6757,-122.326,1250,4080,7650,5330,2550,5,5
3,1,1510,6083,1,0,0,4,6,860,650,47.6966,-122.324,1510,5712,7593,7222,1510,79,79
3,1.5,1810,5080,1,0,0,3,7,1030,780,47.6819,-122.287,1780,7620,6890,9400,1810,61,61
2,1,930,5368,1,0,0,4,7,930,0,47.6952,-122.275,1770,6000,6298,7770,930,66,66
3,2,2080,4549,1,0,0,5,7,1040,1040,47.6886,-122.309,1620,4549,6629,6169,2080,65,65
2,1,900,2910,1,0,0,5,7,900,0,47.6859,-122.322,1320,2910,3810,4230,900,95,95
3,1.5,1790,6000,1,0,0,4,7,1790,0,47.6754,-122.325,1290,3500,7790,4790,1790,116,116
2,1.75,1880,7208,1,0,0,3,7,940,940,47.6946,-122.328,1880,8051,9088,9931,1880,68,68
4,1.75,1960,6138,1,0,0,4,7,1260,700,47.6968,-122.299,2000,7057,8098,9057,1960,59,59
3,1.75,1540,1044,3,0,0,3,8,1540,0,47.6765,-122.32,1580,3090,2584,4670,1540,5,5
2,1,900,5512,1,0,0,3,7,900,0,47.6877,-122.289,1270,5512,6412,6782,900,72,72
4,1.5,1430,6380,1,0,0,4,7,1130,300,47.6942,-122.319,1570,6380,7810,7950,1430,74,74
2,1.5,1460,5700,1,0,0,3,7,1460,0,47.6838,-122.312,1780,3800,7160,5580,1460,107,107
4,2.5,2330,30122,1,0,1,3,8,1490,840,47.6843,-122.267,2430,6726,32452,9156,2330,68,68
3,1,1230,6000,1,0,0,4,7,780,450,47.6839,-122.281,1570,5000,7230,6570,1230,82,82
4,1,1150,5217,1,0,0,3,7,1150,0,47.6806,-122.287,1220,5217,6367,6437,1150,68,68
3,1,960,5264,1,0,0,3,7,960,0,47.6805,-122.301,1140,5150,6224,6290,960,66,66
4,2.5,1710,5000,1,0,0,3,8,1110,600,47.6772,-122.285,1750,5304,6710,7054,1710,40,40
4,3.5,2170,3672,2,0,0,3,9,2170,0,47.6828,-122.329,1950,3450,5842,5400,2170,114,26
3,1.75,1620,4200,1,0,0,5,7,830,790,47.6743,-122.285,1580,5000,5820,6580,1620,74,74
3,1,2150,8480,1,0,0,3,8,1610,540,47.6996,-122.308,1620,5203,10630,6823,2150,68,68
3,2,1560,4080,2,0,0,3,7,1560,0,47.6892,-122.319,1900,4080,5640,5980,1560,96,32
3,2.25,1610,8296,2,0,0,3,8,1610,0,47.7,-122.297,1610,8288,9906,9898,1610,41,41
2,1,1420,4635,2,0,0,4,7,1420,0,47.68,-122.304,1810,4635,6055,6445,1420,78,41
3,2,1880,3800,1,0,0,5,7,1030,850,47.6841,-122.309,1700,3800,5680,5500,1880,92,92
5,3,2710,4200,2,0,0,3,7,1890,820,47.6754,-122.307,2150,4200,6910,6350,2710,100,0
5,4,2980,4500,1,0,0,3,7,2070,910,47.6736,-122.323,1560,4225,7480,5785,2980,98,98
5,2.75,2790,20824,1,0,0,3,9,1680,1110,47.6948,-122.282,2380,10465,23614,12845,2790,60,60
2,1,800,4342,1,0,0,3,6,670,130,47.6997,-122.316,1210,4343,5142,5553,800,92,92
3,1,930,6572,1,0,0,3,7,930,0,47.6889,-122.301,960,5840,7502,6800,930,67,67
2,1,1420,4305,1,0,0,4,7,920,500,47.6864,-122.311,1420,4305,5725,5725,1420,78,78
3,2.5,3280,10302,1,0,0,3,10,1680,1600,47.6948,-122.286,1550,6300,13582,7850,3280,49,49
4,1.75,2340,5940,1,0,0,3,8,1290,1050,47.6789,-122.281,1930,5940,8280,7870,2340,66,66
2,1,850,2850,1,0,0,4,7,850,0,47.6875,-122.309,1450,4015,3700,5465,850,92,92
2,1,1010,4320,1,0,0,5,7,1010,0,47.6846,-122.317,1680,4320,5330,6000,1010,95,95
2,2.25,1460,1623,2,0,0,3,8,1260,200,47.6764,-122.301,1460,1137,3083,2597,1460,14,14
3,1.75,1600,6120,1,0,0,3,7,1600,0,47.6847,-122.291,1670,4590,7720,6260,1600,95,95
3,1.75,1910,5753,1,0,3,3,8,1110,800,47.6898,-122.327,1630,5580,7663,7210,1910,78,78
2,1,760,6380,1,0,0,3,6,760,0,47.6914,-122.31,1590,6380,7140,7970,760,78,78
3,1.5,1040,1824,1,0,0,3,6,1040,0,47.6793,-122.3,1010,5100,2864,6110,1040,94,94
3,1.5,1900,5000,1,0,0,3,7,1640,260,47.6779,-122.294,2090,5000,6900,7090,1900,93,93
4,2.75,2860,6867,1,0,1,5,7,1560,1300,47.6723,-122.263,2290,5350,9727,7640,2860,73,73
3,1.75,1950,6504,1,0,0,3,8,1530,420,47.6934,-122.328,1660,6552,8454,8212,1950,66,66
4,3,2570,4000,2,0,0,3,8,1750,820,47.6743,-122.313,1970,4000,6570,5970,2570,110,0
3,1,1160,5969,1,0,0,3,7,880,280,47.6844,-122.306,1550,5120,7129,6670,1160,89,89
5,3.75,3700,7920,3,0,4,3,9,2900,800,47.6865,-122.266,2860,6360,11620,9220,3700,36,36
4,2.5,2040,6034,2,0,0,3,7,2040,0,47.6952,-122.323,1380,5986,8074,7366,2040,29,29
5,3,2700,5001,2,0,0,3,10,2700,0,47.6811,-122.288,1610,5191,7701,6801,2700,10,10
2,1,1260,4080,1,0,0,5,7,1260,0,47.687,-122.32,1720,4080,5340,5800,1260,93,93
3,2,1470,1691,2,0,0,3,8,1000,470,47.6743,-122.316,1660,4000,3161,5660,1470,12,12
3,1.75,1480,7475,1,0,0,3,8,1480,0,47.6732,-122.272,2120,7216,8955,9336,1480,76,76
3,1.5,1960,4080,1,0,0,3,7,1960,0,47.6768,-122.31,1880,4080,6040,5960,1960,104,104
2,1,1040,4880,1,0,0,3,7,1040,0,47.6809,-122.311,1500,4590,5920,6090,1040,109,40
4,2.75,2640,4000,2,0,0,5,8,1730,910,47.6727,-122.297,1530,3740,6640,5270,2640,94,94
3,2.25,1540,5338,1,0,0,5,7,770,770,47.6942,-122.304,1680,6525,6878,8205,1540,65,65
2,1.5,1000,1188,3,0,0,3,8,1000,0,47.6823,-122.327,2300,3500,2188,5800,1000,14,14
4,1.75,2260,6600,1,0,0,5,8,1220,1040,47.6753,-122.278,2240,6600,8860,8840,2260,71,71
4,3.25,2110,3000,2,0,0,3,8,2110,0,47.6769,-122.328,1780,4000,5110,5780,2110,18,18
3,2.25,2860,10625,1,0,4,3,10,1920,940,47.6915,-122.273,2860,8075,13485,10935,2860,43,43
2,1,1090,4128,1,0,0,3,7,1090,0,47.696,-122.314,1090,5413,5218,6503,1090,71,71
4,3.5,1460,951,3,0,0,3,8,1460,0,47.6821,-122.326,1430,1282,2411,2712,1460,11,11
4,1.5,2270,6010,1,0,0,3,8,1290,980,47.6743,-122.269,2120,5987,8280,8107,2270,65,65
3,1.75,1630,4275,1,0,3,3,7,1630,0,47.6851,-122.322,1800,4275,5905,6075,1630,111,111
4,2.5,2150,5000,2,0,0,3,8,2150,0,47.6962,-122.314,2030,6380,7150,8410,2150,18,18
2,1,930,3750,1,0,0,4,7,930,0,47.6733,-122.296,1740,4300,4680,6040,930,110,110
2,1,1460,6000,1,0,0,2,7,1260,200,47.7009,-122.317,1580,6380,7460,7960,1460,94,94
3,1,1440,5623,1,0,0,4,6,720,720,47.696,-122.319,1280,5623,7063,6903,1440,97,97
2,1,980,5110,1,0,0,4,7,780,200,47.7002,-122.314,1430,5110,6090,6540,980,80,80
2,1,1030,12350,1,0,0,3,7,1030,0,47.6984,-122.324,1790,6900,13380,8690,1030,77,77
2,1.75,1850,3060,1,0,0,3,7,1060,790,47.6821,-122.308,1850,4080,4910,5930,1850,90,22
4,3,3680,7105,2,0,2,3,10,2890,790,47.6956,-122.311,1580,6815,10785,8395,3680,11,11
2,1,810,4368,1,0,0,3,6,810,0,47.6915,-122.312,1890,5253,5178,7143,810,61,61
4,1.75,1820,6000,1,0,0,3,7,930,890,47.6872,-122.296,1590,6000,7820,7590,1820,77,77
4,1.75,1660,3800,1,0,0,3,7,1660,0,47.6883,-122.314,1660,3767,5460,5427,1660,93,93
3,1,1200,6120,1,0,0,4,7,950,250,47.6929,-122.287,1550,6120,7320,7670,1200,74,74
4,1,1360,5500,1,0,0,3,7,1360,0,47.6878,-122.285,1530,5790,6860,7320,1360,69,69
2,1.75,1680,8367,1,0,0,3,6,840,840,47.6976,-122.288,1830,6720,10047,8550,1680,105,105
4,2.75,2560,6900,1,0,0,3,8,1480,1080,47.686,-122.297,2600,7200,9460,9800,2560,60,60
3,2.5,2690,7000,2,0,0,5,7,1840,850,47.6784,-122.277,1800,6435,9690,8235,2690,76,76
4,2.25,2440,9889,1,0,0,3,7,1540,900,47.6932,-122.3,1710,6284,12329,7994,2440,67,67
3,1.75,1540,6930,1,0,0,3,7,1250,290,47.6782,-122.278,1760,6930,8470,8690,1540,75,75
4,3,3130,5700,1,0,0,3,7,1750,1380,47.6811,-122.283,2080,5700,8830,7780,3130,66,66
2,2,1360,4688,1,0,0,3,7,780,580,47.6874,-122.315,1340,4750,6048,6090,1360,75,75
4,3.25,3860,7199,2,0,1,3,9,2870,990,47.6855,-122.269,2940,9600,11059,12540,3860,14,14
3,2.5,3400,5119,2,0,0,3,8,2300,1100,47.6843,-122.305,1740,5969,8519,7709,3400,5,5
4,3.25,3120,5000,2,0,0,3,9,2370,750,47.69,-122.299,2520,6000,8120,8520,3120,14,14
3,2.25,1670,1396,2,0,0,3,9,1250,420,47.6814,-122.288,1610,5191,3066,6801,1670,4,4
3,1,1670,4080,1,0,0,3,7,1170,500,47.6899,-122.321,1560,4080,5750,5640,1670,52,52
3,2.5,1610,1778,3,0,0,3,7,1610,0,47.6902,-122.306,1120,2187,3388,3307,1610,17,17
4,2,2190,3622,1,0,0,5,8,1990,200,47.6887,-122.312,1450,3082,5812,4532,2190,94,94
3,2,1510,3000,1,0,0,4,7,910,600,47.6804,-122.319,1620,4000,4510,5620,1510,47,47
2,1,1280,5026,1,0,2,4,8,1020,260,47.6938,-122.312,1540,6380,6306,7920,1280,68,68
2,1,740,5100,1,0,0,4,7,740,0,47.6787,-122.301,920,5100,5840,6020,740,72,72
3,1,1020,5410,1,0,0,4,7,880,140,47.6924,-122.31,1580,5376,6430,6956,1020,91,91
4,1.5,2550,4000,1,0,0,4,7,1760,790,47.6811,-122.318,1840,4000,6550,5840,2550,93,93
2,1,930,6380,1,0,0,4,7,930,0,47.6915,-122.321,1180,6380,7310,7560,930,79,79
2,1,1340,6380,1,0,0,3,7,890,450,47.697,-122.313,1380,6380,7720,7760,1340,80,80
2,2,1990,6180,1,0,0,4,7,1010,980,47.6792,-122.303,1470,5150,8170,6620,1990,78,78
3,1.75,1380,4590,1,0,0,2,7,930,450,47.6841,-122.293,1320,4692,5970,6012,1380,69,69
2,2.25,2320,9300,1,0,4,5,9,1920,400,47.681,-122.273,2790,9300,11620,12090,2320,82,82
2,1,1620,6120,1,0,0,3,7,1620,0,47.6731,-122.326,1650,4590,7740,6240,1620,68,68
2,1,1650,5106,1,0,0,3,7,1090,560,47.6992,-122.309,1300,6947,6756,8247,1650,59,59
3,2,1200,5029,1,0,0,3,6,880,320,47.6936,-122.294,1510,5854,6229,7364,1200,82,82
4,2.75,2580,3560,1,0,0,5,7,1710,870,47.6753,-122.304,1980,3800,6140,5780,2580,102,102
4,2.5,3200,7500,1,0,1,5,8,1860,1340,47.6826,-122.274,2500,6500,10700,9000,3200,71,71
2,1.5,1180,1034,2,0,0,3,7,1120,60,47.678,-122.322,1137,1034,2214,2171,1180,18,18
2,1.5,1020,1146,3,0,0,3,7,1020,0,47.6774,-122.325,1138,1156,2166,2294,1020,18,18
5,3,2900,6730,1,0,0,5,8,1830,1070,47.6784,-122.285,2370,6283,9630,8653,2900,42,42
3,2,1820,6324,1,0,0,5,7,910,910,47.6823,-122.27,1850,6440,8144,8290,1820,74,74
4,2.25,1970,7125,1,0,0,3,7,1500,470,47.6725,-122.293,1980,4750,9095,6730,1970,111,111
4,3.5,3590,5335,2,0,2,3,9,3140,450,47.6762,-122.267,2100,6250,8925,8350,3590,13,13
4,2.5,2450,4080,1,0,0,4,8,1490,960,47.6899,-122.319,2000,4080,6530,6080,2450,89,89
2,1,930,3150,1,0,0,5,6,930,0,47.6783,-122.298,1900,5000,4080,6900,930,101,101
3,1.75,1900,9375,1,0,1,4,8,1330,570,47.6821,-122.273,2760,9375,11275,12135,1900,78,78
2,2.25,1430,1210,2,0,0,3,8,1340,90,47.6765,-122.301,1430,1016,2640,2446,1430,14,14
4,2,1700,6375,1,0,0,4,7,850,850,47.6973,-122.295,1470,8360,8075,9830,1700,69,69
4,3.25,3460,7749,2,0,1,3,10,3020,440,47.6849,-122.273,3030,8680,11209,11710,3460,69,16
2,1,1150,5000,1,0,0,4,7,1050,100,47.6846,-122.317,1463,4320,6150,5783,1150,95,95
3,2.25,2090,10733,1,0,0,3,7,1440,650,47.6971,-122.281,1740,8100,12823,9840,2090,61,61
4,1,1600,4500,1,0,0,4,7,1600,0,47.6804,-122.316,1720,4500,6100,6220,1600,93,93
2,1,1120,6380,1,0,0,3,7,1120,0,47.6951,-122.316,1230,6380,7500,7610,1120,77,21
4,2.5,2030,4080,1,0,0,4,8,1730,300,47.6753,-122.311,1980,4080,6110,6060,2030,98,98
2,1,1030,5934,1,0,0,4,7,1030,0,47.6828,-122.287,1420,5588,6964,7008,1030,91,91
3,2.25,2250,5301,2,0,0,4,8,1510,740,47.6741,-122.271,2240,7200,7551,9440,2250,44,44
4,2.5,2560,12760,1,0,0,4,7,1760,800,47.6947,-122.303,1760,6384,15320,8144,2560,70,70
4,2.5,2300,6158,2,0,0,3,9,2300,0,47.6943,-122.299,2170,6434,8458,8604,2300,20,20
4,2,2090,3610,1,0,0,5,7,1790,300,47.6881,-122.313,1660,3767,5700,5427,2090,92,92
4,2.75,3650,6982,2,0,2,4,9,2530,1120,47.6756,-122.275,3140,7894,10632,11034,3650,68,11
3,2.5,3110,6765,2,0,1,4,9,2550,560,47.6886,-122.276,2630,7626,9875,10256,3110,73,73
3,2,2610,6000,1,0,0,5,7,1310,1300,47.675,-122.289,2330,4800,8610,7130,2610,78,78
3,2,1170,6750,1,0,0,5,7,800,370,47.6752,-122.281,1330,6750,7920,8080,1170,72,72
4,1.5,1710,4600,1,0,0,3,7,1710,0,47.6847,-122.318,1740,4455,6310,6195,1710,95,95
3,2,2080,7020,1,0,0,4,7,1040,1040,47.6768,-122.285,1920,7000,9100,8920,2080,68,68
3,1,1030,3000,1,0,0,3,7,830,200,47.6813,-122.317,1830,3000,4030,4830,1030,95,95
4,1.5,1520,5910,1,0,0,3,7,1020,500,47.6904,-122.295,1710,5910,7430,7620,1520,73,73
3,2.25,2210,5742,1,0,0,3,8,1460,750,47.6891,-122.318,1900,4590,7952,6490,2210,68,68
4,2,1560,5220,1,0,0,3,7,1560,0,47.6905,-122.305,1300,5220,6780,6520,1560,60,60
4,1.5,1800,6750,1,0,0,4,7,1800,0,47.6868,-122.285,1420,5900,8550,7320,1800,69,69
4,2.5,2030,10722,1,0,0,3,7,1100,930,47.6955,-122.301,1610,9134,12752,10744,2030,52,52
4,2.5,2800,5900,1,0,0,3,8,1660,1140,47.6809,-122.286,2580,5900,8700,8480,2800,56,56
1,1,620,2380,1,0,0,3,6,620,0,47.6746,-122.326,980,3570,3000,4550,620,119,119
3,1.5,1620,5108,1,0,0,3,7,1620,0,47.6978,-122.316,1380,6130,6728,7510,1620,65,65
4,3,2100,3800,2,0,0,3,8,2100,0,47.6807,-122.291,1320,3800,5900,5120,2100,47,47
3,1.75,2020,4800,1,0,0,4,8,1090,930,47.6726,-122.294,1680,4800,6820,6480,2020,93,93
3,2.25,1450,1387,3,0,0,3,8,1450,0,47.6765,-122.302,1450,1429,2837,2879,1450,19,19
3,1,1100,5700,1,0,0,3,7,1100,0,47.6883,-122.282,1560,6588,6800,8148,1100,69,69
4,2.25,3750,5000,2,0,0,5,8,2440,1310,47.6747,-122.303,2170,4590,8750,6760,3750,95,95
3,1,1280,2580,1,0,0,3,8,1280,0,47.6727,-122.32,1410,3150,3860,4560,1280,109,0
4,1.75,2250,4750,1,0,0,4,7,1420,830,47.6738,-122.292,1930,4750,7000,6680,2250,95,95
4,2.25,2000,3800,2,0,0,3,8,2000,0,47.6852,-122.311,1610,3800,5800,5410,2000,18,18
3,3.25,2460,4182,2,0,0,5,8,2100,360,47.6782,-122.311,2370,4284,6642,6654,2460,109,109
3,2,2710,4500,1,0,0,4,8,1880,830,47.6747,-122.295,2060,4500,7210,6560,2710,90,90
2,1.75,1990,6549,1,0,0,3,7,1170,820,47.7,-122.296,1640,7202,8539,8842,1990,71,71
2,1,1160,5029,1,0,0,3,7,910,250,47.6723,-122.266,1220,5029,6189,6249,1160,79,79
4,1.75,2460,5100,1,0,0,5,7,1450,1010,47.6782,-122.3,1560,5100,7560,6660,2460,110,110
3,1.75,1380,4590,1,0,0,2,7,930,450,47.6841,-122.293,1320,4692,5970,6012,1380,69,69
4,3.5,3130,3900,2,0,0,3,9,2550,580,47.6849,-122.327,1830,3900,7030,5730,3130,11,11
2,1,1270,5100,1,0,0,3,7,1100,170,47.6771,-122.328,1670,3900,6370,5570,1270,119,119
2,1.75,1160,6828,1,0,0,3,7,860,300,47.6937,-122.298,1250,6828,7988,8078,1160,78,78
2,1,1150,5664,1,0,0,3,7,870,280,47.6894,-122.284,1380,5664,6814,7044,1150,71,71
3,1.5,1200,3060,1,0,0,4,7,1060,140,47.679,-122.315,1410,3060,4260,4470,1200,109,109
3,1.5,1270,5112,1,0,0,3,7,1270,0,47.676,-122.288,1580,5080,6382,6660,1270,69,69
3,2,2130,4000,2,0,0,3,7,2130,0,47.6741,-122.323,2010,4000,6130,6010,2130,111,111
4,2,2290,6000,1,0,3,5,7,2290,0,47.6807,-122.318,2000,3150,8290,5150,2290,119,119
4,1,1660,4704,1,0,0,3,7,1260,400,47.6918,-122.32,1360,5413,6364,6773,1660,89,89
3,1,1140,5395,1,0,0,4,7,1010,130,47.6782,-122.306,1700,5376,6535,7076,1140,110,110
3,1.75,2240,10578,2,0,0,5,8,1550,690,47.6954,-122.292,1570,10578,12818,12148,2240,96,96
4,2.25,2880,8882,2,0,0,4,8,2480,400,47.6999,-122.284,2460,9610,11762,12070,2880,54,54
3,2.5,2060,9715,2,0,0,3,8,2060,0,47.6961,-122.316,1240,7072,11775,8312,2060,95,8
2,1,1450,6380,1,0,0,3,7,1450,0,47.6924,-122.321,1240,6380,7830,7620,1450,52,52
4,3.5,3500,4080,2,0,2,3,9,2590,910,47.6834,-122.292,2430,5100,7580,7530,3500,15,15
3,2.5,1610,1728,3,0,0,3,8,1610,0,47.6776,-122.318,1540,3090,3338,4630,1610,19,19
4,2.5,2110,6820,1,0,0,5,7,1530,580,47.6882,-122.306,1420,6431,8930,7851,2110,77,77
4,3,2370,3672,1,0,0,5,7,1650,720,47.678,-122.311,2140,4182,6042,6322,2370,103,103
3,1.75,890,3800,1,0,0,3,7,750,140,47.6803,-122.291,1280,3800,4690,5080,890,93,93
3,2,2870,6360,1,0,1,4,8,1790,1080,47.6813,-122.275,2310,6466,9230,8776,2870,73,73
4,2,1490,4054,1,0,0,5,7,1490,0,47.6744,-122.301,1510,3889,5544,5399,1490,93,93
4,1.5,2230,5109,1,0,0,3,7,1330,900,47.6996,-122.31,1630,5109,7339,6739,2230,101,101
5,3.25,2450,6534,2,0,0,3,8,1770,680,47.688,-122.281,1620,6534,8984,8154,2450,68,0
2,1,890,7200,1,0,0,3,7,740,150,47.6998,-122.278,1290,7200,8090,8490,890,70,70
2,1,1160,6000,1,0,0,4,7,860,300,47.69,-122.292,1330,6000,7160,7330,1160,77,77
3,1,980,6380,1,0,0,3,7,760,220,47.692,-122.308,1390,6380,7360,7770,980,78,78
4,2,1970,3515,1,0,0,5,8,1030,940,47.6873,-122.314,1650,4275,5485,5925,1970,50,50
3,1,1230,6380,1,0,0,3,7,1230,0,47.6947,-122.315,1250,6380,7610,7630,1230,92,92
4,2.5,2240,7540,1,0,0,3,8,1540,700,47.6965,-122.308,1960,7250,9780,9210,2240,57,57
2,1,700,8120,1,0,0,3,7,700,0,47.6962,-122.321,1130,5599,8820,6729,700,92,92
5,3,2620,5477,2,0,0,3,10,2620,0,47.6804,-122.288,1680,5217,8097,6897,2620,10,10
3,1.75,1520,5618,1,0,0,3,7,1170,350,47.68,-122.284,1550,5618,7138,7168,1520,66,66
2,1,1530,4370,1,0,0,3,7,1130,400,47.6888,-122.308,1580,4275,5900,5855,1530,73,73
3,2,1530,5401,1,0,0,4,7,1530,0,47.686,-122.304,1640,5467,6931,7107,1530,82,82
4,2.5,2530,6500,1,0,0,3,8,1720,810,47.6737,-122.284,2150,5280,9030,7430,2530,44,44
3,1,1570,5510,1,0,0,4,7,1070,500,47.6942,-122.319,1770,6380,7080,8150,1570,79,79
4,2.25,2100,2500,3,0,0,3,8,2100,0,47.6726,-122.298,1660,4000,4600,5660,2100,18,18
3,1,1260,7250,1,0,2,3,7,960,300,47.6947,-122.311,1540,7250,8510,8790,1260,79,79
2,1.75,1820,6050,1,0,0,3,7,910,910,47.6928,-122.323,1730,6050,7870,7780,1820,69,69
4,2,2560,7798,1,0,0,4,7,1890,670,47.6914,-122.296,1330,7798,10358,9128,2560,72,72
5,1,1690,3240,1,0,0,3,7,1690,0,47.6746,-122.325,1230,4500,4930,5730,1690,105,105
3,2,2010,7017,2,0,3,3,7,2010,0,47.6828,-122.267,2450,6045,9027,8495,2010,68,26
2,1.5,1660,4000,1,0,0,3,7,1000,660,47.6832,-122.304,1570,5500,5660,7070,1660,69,69
5,3.5,4390,6220,2,0,3,3,9,3170,1220,47.6789,-122.273,2740,6448,10610,9188,4390,6,6
2,1,1110,5413,1,0,0,3,6,890,220,47.6925,-122.32,1300,5413,6523,6713,1110,82,82
3,1.75,1520,6380,1,0,0,3,7,790,730,47.695,-122.304,1520,6235,7900,7755,1520,71,71
3,2.5,1850,1330,2,0,0,3,9,1560,290,47.6831,-122.325,1810,2071,3180,3881,1850,15,15
3,1,1290,6380,1,0,0,3,7,1290,0,47.6951,-122.319,1630,6380,7670,8010,1290,89,89
2,1,962,1992,2,0,0,3,7,962,0,47.6911,-122.313,1130,1992,2954,3122,962,7,7
3,2,1110,8375,1,0,0,5,7,1110,0,47.6978,-122.297,1410,7734,9485,9144,1110,68,68
3,1.75,2080,6609,1,0,0,3,7,1280,800,47.6883,-122.3,1680,6270,8689,7950,2080,69,69
4,2.75,3160,8197,1,0,0,3,8,1580,1580,47.7004,-122.287,2050,8197,11357,10247,3160,57,57
4,1.75,1740,4816,1,0,0,5,7,870,870,47.5758,-122.382,1210,5074,6556,6284,1740,77,77
3,2.5,1840,2875,2,0,0,4,7,1840,0,47.562,-122.393,1240,5750,4715,6990,1840,22,22
4,1.75,2000,3988,1,0,4,4,7,1000,1000,47.5925,-122.391,1690,4144,5988,5834,2000,61,61
4,1.75,1910,6731,1,0,0,4,7,1210,700,47.5693,-122.391,1780,6350,8641,8130,1910,66,66
2,1,2410,5930,2,0,0,3,9,1930,480,47.5657,-122.395,1540,5892,8340,7432,2410,12,12
5,3,2080,6150,1,0,0,3,7,1040,1040,47.5707,-122.394,1420,6150,8230,7570,2080,69,69
3,2.5,2000,6341,1,0,0,5,8,1040,960,47.5639,-122.401,2030,6341,8341,8371,2000,38,38
5,1,2340,4730,2,0,0,3,8,1810,530,47.5895,-122.385,2100,4970,7070,7070,2340,101,101
3,2.75,1670,1350,3,0,0,3,9,1350,320,47.5764,-122.408,1520,4800,3020,6320,1670,5,5
3,2.25,1460,1353,2,0,0,3,8,1050,410,47.5774,-122.412,1690,3776,2813,5466,1460,7,7
3,1.75,1660,4800,1,0,0,3,7,960,700,47.5734,-122.412,1510,4800,6460,6310,1660,78,18
3,2.5,1310,1294,2,0,0,3,8,1180,130,47.5773,-122.409,1330,1265,2604,2595,1310,11,11
4,1.75,2350,6200,1,0,0,4,7,1410,940,47.559,-122.397,1800,6150,8550,7950,2350,73,73
4,2.25,2580,2875,2,0,0,3,9,2580,0,47.5674,-122.392,1290,5750,5455,7040,2580,4,4
2,1,940,4800,1,0,0,4,6,940,0,47.5756,-122.414,980,5900,5740,6880,940,108,59
3,1,1270,6250,1,0,0,3,7,910,360,47.5694,-122.397,2000,6250,7520,8250,1270,64,64
3,2,2140,3600,2,0,0,3,8,1680,460,47.5846,-122.383,2340,5400,5740,7740,2140,108,18
3,2.5,2100,4440,2,0,4,3,7,2100,0,47.5865,-122.397,2100,6000,6540,8100,2100,74,74
1,1,520,5600,1,0,0,3,6,520,0,47.5579,-122.395,1030,5265,6120,6295,520,101,101
4,2.5,3160,4620,1,0,4,3,9,2020,1140,47.5875,-122.382,2790,5308,7780,8098,3160,102,9
3,2.75,1670,1350,3,0,0,3,9,1350,320,47.5763,-122.408,1520,4800,3020,6320,1670,5,5
4,2.75,4120,12500,1,0,4,4,8,2060,2060,47.5914,-122.385,3680,5000,16620,8680,4120,72,72
4,1.75,2190,5060,1,0,0,3,7,1190,1000,47.5846,-122.387,1510,4600,7250,6110,2190,69,69
2,1,1030,5750,1,0,0,5,8,1030,0,47.5861,-122.391,1570,5750,6780,7320,1030,91,91
2,1,840,6720,1,0,0,3,7,840,0,47.5707,-122.396,1250,6720,7560,7970,840,67,67
2,1.5,1590,4500,1,0,0,4,7,920,670,47.5831,-122.392,1900,4450,6090,6350,1590,73,73
3,1,1020,6903,1,0,0,3,7,1020,0,47.571,-122.392,1440,6678,7923,8118,1020,68,68
2,1.5,900,5750,1,0,2,3,7,900,0,47.5623,-122.384,1300,1413,6650,2713,900,79,79
3,1,1870,4984,1,0,0,3,7,1120,750,47.5771,-122.391,1650,5750,6854,7400,1870,64,64
3,2.5,2390,6550,1,0,2,4,8,1440,950,47.5714,-122.408,2010,6550,8940,8560,2390,64,64
3,1,1220,5652,1,0,0,3,6,1220,0,47.5767,-122.408,1490,2467,6872,3957,1220,114,114
3,2,1580,1972,2,0,2,3,8,1180,400,47.5903,-122.386,1500,1908,3552,3408,1580,12,12
2,1.5,1180,1722,2,0,0,3,8,1180,0,47.5626,-122.384,1490,1469,2902,2959,1180,13,13
2,2.5,1340,999,2,0,0,3,8,940,400,47.5655,-122.386,1470,1436,2339,2906,1340,11,11
5,2,2130,4180,1,0,0,5,7,1270,860,47.575,-122.388,1710,4180,6310,5890,2130,93,93
3,2.5,2520,3750,2,0,1,4,9,2520,0,47.5671,-122.404,2250,6200,6270,8450,2520,24,24
4,3,3470,4750,2,0,2,3,9,2370,1100,47.5917,-122.386,2420,4761,8220,7181,3470,5,5
3,1.5,1710,4000,2,0,0,3,8,1710,0,47.5714,-122.385,1910,4000,5710,5910,1710,93,93
4,2.75,2700,6000,2,0,0,4,8,2100,600,47.586,-122.383,2050,5400,8700,7450,2700,109,109
4,1,1340,5800,1,0,2,3,7,1340,0,47.5658,-122.389,1900,5800,7140,7700,1340,105,105
3,2.5,1740,1279,3,0,0,3,8,1740,0,47.5891,-122.387,1740,1280,3019,3020,1740,11,11
3,2.5,1070,1219,2,0,0,3,7,720,350,47.5618,-122.384,1070,1254,2289,2324,1070,15,15
3,2,1510,4560,2,0,0,4,7,1510,0,47.5689,-122.408,1990,5000,6070,6990,1510,110,19
4,2.5,2095,4400,1,0,0,5,8,1295,800,47.5838,-122.39,1980,4400,6495,6380,2095,109,109
2,1,780,2750,1,0,0,4,7,780,0,47.5842,-122.388,1320,4440,3530,5760,780,91,91
3,1,1710,5000,1,0,0,5,7,1140,570,47.5719,-122.385,1670,4000,6710,5670,1710,98,98
2,1.5,1130,1340,2,0,0,3,8,910,220,47.5761,-122.41,1310,1340,2470,2650,1130,11,11
4,3.25,4700,9160,1,0,4,3,11,2520,2180,47.5744,-122.406,2240,8700,13860,10940,4700,14,14
3,1.75,3520,12350,1,0,4,4,8,1530,1990,47.5837,-122.382,2140,7800,15870,9940,3520,59,59
2,1.5,1130,912,2,0,0,3,8,1000,130,47.5638,-122.388,1500,1474,2042,2974,1130,13,13
3,2.5,1740,1280,3,0,2,3,8,1740,0,47.589,-122.387,1740,1308,3020,3048,1740,11,11
4,1,1620,4329,1,0,0,3,7,1620,0,47.5728,-122.388,1220,5520,5949,6740,1620,92,92
5,3.25,4300,9270,2,0,3,3,10,2910,1390,47.5717,-122.409,2780,6610,13570,9390,4300,62,5
4,3.5,3070,4440,2,0,0,3,9,2030,1040,47.5732,-122.411,1780,4800,7510,6580,3070,97,8
2,1,1020,4002,1,0,0,5,7,1020,0,47.5828,-122.395,1780,5000,5022,6780,1020,66,66
3,3.5,1560,2198,2,0,0,3,8,1180,380,47.5812,-122.403,1550,1467,3758,3017,1560,13,13
3,2,1830,3500,1,0,0,5,7,1290,540,47.573,-122.383,1530,4000,5330,5530,1830,110,110
3,1,1320,5000,1,0,0,3,7,1320,0,47.5711,-122.386,1320,4179,6320,5499,1320,107,107
2,1.75,1400,2500,1,0,0,5,7,710,690,47.5628,-122.391,1250,5700,3900,6950,1400,103,103
3,1,1200,7000,2,0,0,1,7,1200,0,47.5883,-122.384,3290,6000,8200,9290,1200,111,111
2,1.5,2700,7225,1,0,4,3,8,1660,1040,47.5892,-122.383,2970,5150,9925,8120,2700,109,7
3,1.75,1360,5850,1,0,0,4,7,1000,360,47.5711,-122.391,1540,5850,7210,7390,1360,81,81
2,2.5,1350,944,2,0,0,3,9,870,480,47.5591,-122.385,1440,1350,2294,2790,1350,15,15
3,2.5,1740,1279,3,0,0,3,8,1740,0,47.589,-122.387,1740,1280,3019,3020,1740,11,11
2,1,890,3271,1,0,0,4,6,890,0,47.5631,-122.381,1190,5175,4161,6365,890,101,101
3,2.5,1470,1571,2,0,0,3,8,1180,290,47.5722,-122.387,1580,4329,3041,5909,1470,12,12
3,2.25,1520,5750,2,0,0,3,8,1400,120,47.5787,-122.388,1420,5650,7270,7070,1520,111,8
2,1,740,4459,1,0,2,3,5,740,0,47.5704,-122.409,1490,4700,5199,6190,740,104,104
3,2.75,2210,7660,1,0,1,4,7,1460,750,47.5619,-122.4,2110,8750,9870,10860,2210,51,51
4,2,2450,5000,2,0,4,5,8,2200,250,47.5619,-122.405,2360,6090,7450,8450,2450,100,100
3,1.5,1800,6250,1,0,0,3,8,1420,380,47.5778,-122.389,1800,5625,8050,7425,1800,72,72
4,2.5,2650,5000,2,0,0,3,8,2650,0,47.5605,-122.396,1110,6250,7650,7360,2650,12,12
3,2.5,1680,934,3,0,0,3,8,1680,0,47.5891,-122.387,1740,1280,2614,3020,1680,11,11
3,2,1940,6440,1,0,2,5,7,970,970,47.5664,-122.389,1730,4640,8380,6370,1940,79,79
3,1,1240,5758,1,0,0,4,6,960,280,47.5675,-122.396,1460,5750,6998,7210,1240,109,109
3,1,1410,5000,1,0,0,3,6,980,430,47.5769,-122.397,1410,5000,6410,6410,1410,94,94
3,2.25,2880,6092,2,0,4,4,8,1920,960,47.5878,-122.381,2880,5308,8972,8188,2880,36,36
4,2.25,2070,1230,3,0,0,3,9,1500,570,47.5775,-122.41,1569,4802,3300,6371,2070,6,6
3,2.75,1250,892,2,0,0,3,8,1040,210,47.5826,-122.387,1250,1296,2142,2546,1250,9,9
3,2.5,1590,1937,2,0,0,3,8,1590,0,47.5903,-122.388,1620,2022,3527,3642,1590,15,15
1,1,670,5750,1,0,0,3,7,670,0,47.5624,-122.394,1170,5750,6420,6920,670,77,4
3,2,1360,5120,1,0,0,4,6,910,450,47.5587,-122.393,1440,5120,6480,6560,1360,95,95
2,1,1300,6731,1,0,0,3,7,1300,0,47.5697,-122.395,1240,6731,8031,7971,1300,69,69
3,1.75,1570,6500,1,0,0,3,7,920,650,47.565,-122.398,1570,5750,8070,7320,1570,71,71
2,1,1050,7500,1,0,3,4,6,1050,0,47.5577,-122.399,2540,13680,8550,16220,1050,109,109
4,2,2110,4140,2,0,0,3,9,1710,400,47.5836,-122.387,1440,4420,6250,5860,2110,94,12
3,2.5,2050,6420,1,0,3,3,8,1730,320,47.5708,-122.405,2370,7620,8470,9990,2050,63,63
3,2.25,1410,905,3,0,0,3,9,1410,0,47.5818,-122.402,1510,1352,2315,2862,1410,5,5
2,1,960,4800,1,0,0,2,6,960,0,47.5752,-122.411,1440,4800,5760,6240,960,107,107
4,1.75,2540,7620,1,0,3,3,8,1320,1220,47.5709,-122.406,2540,8613,10160,11153,2540,71,71
2,1.5,1390,5000,1,0,0,4,8,970,420,47.5673,-122.401,1610,5000,6390,6610,1390,65,65
2,2,1600,5969,1,0,0,4,7,800,800,47.5691,-122.394,1520,5969,7569,7489,1600,69,69
2,1.75,1860,5940,1,0,2,5,8,1020,840,47.5751,-122.407,2130,5940,7800,8070,1860,63,63
3,1.75,1050,6150,1,0,0,4,6,950,100,47.5715,-122.394,1360,6150,7200,7510,1050,91,91
3,3.25,2310,3075,2,0,0,3,8,1730,580,47.5644,-122.383,2310,3075,5385,5385,2310,14,14
3,2.5,1920,7200,2,0,2,3,10,1780,140,47.5709,-122.408,2080,5000,9120,7080,1920,22,22
2,1,1070,6625,1,0,0,3,7,830,240,47.5736,-122.393,1310,6625,7695,7935,1070,69,69
3,1,1040,5060,1,0,0,3,7,1040,0,47.5636,-122.394,890,5060,6100,5950,1040,78,78
3,1.75,1530,6125,1,0,0,3,7,1120,410,47.5687,-122.397,1360,6125,7655,7485,1530,61,61
5,1,1590,5000,1,0,0,3,7,1190,400,47.5752,-122.381,1590,5000,6590,6590,1590,90,90
2,1.75,1280,4000,1,0,0,4,7,730,550,47.5798,-122.383,2250,5382,5280,7632,1280,90,90
4,2.75,3410,7750,1,0,4,5,8,1710,1700,47.5718,-122.406,3080,8525,11160,11605,3410,61,61
3,2.25,1450,1486,2,0,0,3,8,1160,290,47.5694,-122.387,1370,1437,2936,2807,1450,13,13
3,2.5,1740,1236,3,0,2,3,8,1740,0,47.5891,-122.387,1740,1280,2976,3020,1740,11,11
2,1.5,1490,5750,1,0,0,4,7,1190,300,47.5872,-122.39,1590,4025,7240,5615,1490,119,119
3,1.75,1810,5733,1,0,0,4,7,1010,800,47.5709,-122.388,1260,4680,7543,5940,1810,93,93
4,1.5,1330,5750,1,0,2,3,7,1330,0,47.5681,-122.384,1360,5750,7080,7110,1330,104,104
3,3.5,1660,2298,2,0,0,3,8,1260,400,47.5809,-122.403,1500,2198,3958,3698,1660,10,10
3,1.75,1840,4255,1,0,0,3,7,940,900,47.58,-122.392,1600,4255,6095,5855,1840,112,10
3,1.5,1790,8203,1,0,1,3,7,1790,0,47.5768,-122.403,1960,6047,9993,8007,1790,109,109
2,1,1657,5031,2,0,0,3,7,1657,0,47.5699,-122.389,2050,6201,6688,8251,1657,109,109
3,1.75,1300,5120,1,0,0,4,6,1300,0,47.5589,-122.394,1090,5124,6420,6214,1300,94,94
4,2.25,2730,5000,1,0,0,5,7,1460,1270,47.5843,-122.393,2010,5000,7730,7010,2730,64,64
3,1,1820,5750,1,0,0,3,7,1120,700,47.5773,-122.383,1500,5750,7570,7250,1820,101,101
4,2.75,2960,5040,2,0,3,3,9,2210,750,47.5747,-122.408,2270,5500,8000,7770,2960,67,22
3,2.5,1660,1091,3,0,1,3,9,1530,130,47.5818,-122.402,1510,1352,2751,2862,1660,4,4
3,1.5,1330,1265,2,0,0,3,8,1140,190,47.5773,-122.409,1330,1264,2595,2594,1330,11,11
4,1.5,1360,6110,1,0,0,3,7,1010,350,47.5755,-122.396,1520,6110,7470,7630,1360,64,64
3,1,1230,7020,1,0,0,3,7,1090,140,47.5719,-122.39,1390,5850,8250,7240,1230,95,95
2,1.5,1240,3873,1,0,0,4,6,860,380,47.5752,-122.388,1240,4336,5113,5576,1240,110,110
3,2.5,2180,5000,1,0,0,4,8,1240,940,47.5828,-122.396,2000,5000,7180,7000,2180,42,42
2,1,720,5600,1,0,0,4,7,720,0,47.5641,-122.391,1330,5600,6320,6930,720,99,99
2,1.75,1620,4879,1,0,0,3,7,1040,580,47.5703,-122.385,1500,5000,6499,6500,1620,95,3
4,1.75,1920,4862,1,0,0,5,7,1060,860,47.5747,-122.384,1840,4862,6782,6702,1920,100,100
4,2.75,2440,7042,1,0,2,4,7,1640,800,47.5731,-122.408,2170,7900,9482,10070,2440,78,78
3,1.75,1230,1441,2,0,0,3,8,1010,220,47.5626,-122.382,1170,1942,2671,3112,1230,15,15
3,2,1660,3729,1,0,0,5,7,970,690,47.5741,-122.414,1560,3729,5389,5289,1660,97,97
3,3.5,3220,3960,2,0,4,3,10,2760,460,47.5909,-122.384,3080,4444,7180,7524,3220,28,28
4,2.75,3090,16538,3,0,0,4,8,2590,500,47.5803,-122.403,1500,5130,19628,6630,3090,100,27
3,2.5,1810,914,3,0,0,3,8,1380,430,47.5732,-122.387,1810,914,2724,2724,1810,11,11
3,1.75,1240,3600,1,0,0,5,7,1240,0,47.5797,-122.405,1660,3600,4840,5260,1240,93,93
2,2.25,2130,4920,1,0,4,4,7,1530,600,47.573,-122.409,2130,4920,7050,7050,2130,78,78
3,2,2080,5750,1,0,0,5,7,1040,1040,47.5791,-122.392,1710,4830,7830,6540,2080,93,93
4,2.5,2650,4316,1,0,0,3,8,1520,1130,47.5866,-122.389,1690,5625,6966,7315,2650,114,1
4,1,1440,6678,1,0,0,3,7,1040,400,47.571,-122.392,1320,6678,8118,7998,1440,69,69
2,1,1010,4050,1,0,0,3,7,1010,0,47.5838,-122.382,2310,5000,5060,7310,1010,69,69
4,3,2780,5000,1,0,0,5,7,1710,1070,47.5721,-122.381,1150,5000,7780,6150,2780,100,100
2,1,870,5635,1,0,0,3,7,870,0,47.5676,-122.398,1310,5750,6505,7060,870,71,71
2,1.75,1760,2275,1,0,0,3,6,1040,720,47.5803,-122.393,1380,3750,4035,5130,1760,107,107
3,2,1200,2016,1,0,1,4,7,600,600,47.5811,-122.404,1730,4520,3216,6250,1200,88,88
2,2,2090,6000,2,0,1,3,7,2090,0,47.5732,-122.413,1600,5400,8090,7000,2090,101,29
2,2,1030,600,2,0,0,3,8,680,350,47.5788,-122.41,1120,1267,1630,2387,1030,15,15
3,1,2360,5012,1,0,0,3,7,1560,800,47.5705,-122.384,1690,4800,7372,6490,2360,55,55
4,2.25,1720,2300,1,0,0,3,7,860,860,47.5762,-122.412,1720,4680,4020,6400,1720,79,0
3,1,1030,4089,1,0,0,3,7,1030,0,47.574,-122.385,1440,4917,5119,6357,1030,92,92
3,1.75,1520,5500,1,0,0,5,7,1520,0,47.5839,-122.383,2310,5500,7020,7810,1520,83,83
3,3.5,1700,2197,2,0,0,3,8,1260,440,47.5767,-122.41,1360,1418,3897,2778,1700,9,9
3,2.75,2600,5875,1,0,2,5,8,1600,1000,47.5773,-122.406,2260,5492,8475,7752,2600,90,90
3,1,1320,5500,1,0,0,3,7,1320,0,47.5705,-122.398,1480,5250,6820,6730,1320,64,64
3,2.75,3390,7000,1,0,3,4,8,1740,1650,47.5701,-122.408,1770,6500,10390,8270,3390,40,40
2,1.5,1070,1236,2,0,0,3,8,1000,70,47.5619,-122.382,1170,1888,2306,3058,1070,14,14
5,3,3900,5250,1,0,1,5,8,2620,1280,47.5577,-122.389,1950,5700,9150,7650,3900,88,88
4,2.75,2410,5650,1,0,0,5,8,2070,340,47.5651,-122.391,1960,5650,8060,7610,2410,110,110
2,1,970,4800,1,0,0,3,6,970,0,47.5754,-122.414,1180,5900,5770,7080,970,108,74
2,1.75,1400,4720,1,0,0,4,7,820,580,47.5705,-122.392,1330,6786,6120,8116,1400,92,92
3,3.5,1370,1540,2,0,0,3,8,1100,270,47.5638,-122.388,1370,915,2910,2285,1370,13,13
3,2,1510,3750,1,0,0,4,7,1510,0,47.5737,-122.383,1500,5000,5260,6500,1510,91,91
5,1,1420,6250,1,0,0,4,8,1420,0,47.5807,-122.389,1420,6250,7670,7670,1420,93,93
3,2,2170,3978,1,0,0,5,7,1340,830,47.571,-122.391,1350,4680,6148,6030,2170,100,100
3,2.5,2580,7500,2,0,0,3,9,2580,0,47.5577,-122.396,910,6500,10080,7410,2580,28,28
4,3.5,3350,6350,2,0,2,3,8,2610,740,47.5602,-122.39,1820,6350,9700,8170,3350,10,10
3,1.75,2960,12420,1,0,2,4,8,1480,1480,47.5739,-122.406,2700,9106,15380,11806,2960,67,67
3,2.25,1190,1149,2,0,0,3,8,1050,140,47.5818,-122.387,1210,1316,2339,2526,1190,11,11
3,1.75,2240,6050,1,0,0,4,8,1250,990,47.5658,-122.4,1720,6050,8290,7770,2240,69,69
1,1,680,1638,1,0,4,1,6,680,0,47.5832,-122.399,1010,3621,2318,4631,680,109,23
3,2.25,1420,3750,2,0,0,3,7,1420,0,47.5725,-122.383,1430,4664,5170,6094,1420,32,32
3,1,1010,5864,1,0,0,3,7,1010,0,47.5733,-122.381,1290,5000,6874,6290,1010,104,104
2,1,880,6413,1,0,0,3,7,880,0,47.573,-122.395,1360,6413,7293,7773,880,69,69
3,2.5,1260,900,2,0,0,3,7,940,320,47.5621,-122.384,1310,1415,2160,2725,1260,12,12
3,1.75,1660,6250,1,0,0,3,7,830,830,47.5859,-122.385,1660,5750,7910,7410,1660,39,39
4,1,1540,4500,1,0,0,2,7,1540,0,47.587,-122.384,1920,6000,6040,7920,1540,114,114
2,2.5,2000,2500,3,0,1,3,8,1810,190,47.5788,-122.396,1970,5650,4500,7620,2000,25,25
4,2,2160,6300,1,0,1,4,8,2160,0,47.5662,-122.404,1980,5152,8460,7132,2160,91,91
4,2.25,2430,4748,1,0,0,3,8,1630,800,47.5904,-122.389,2430,4748,7178,7178,2430,91,91
3,1,1240,5750,1,0,0,4,6,1240,0,47.564,-122.398,1240,5750,6990,6990,1240,71,71
2,1.5,930,7400,1,0,2,4,7,830,100,47.5691,-122.408,1920,4152,8330,6072,930,110,110
3,1.5,2180,5000,1,0,3,4,8,1090,1090,47.5787,-122.402,2070,5000,7180,7070,2180,78,78
2,1,1100,4750,1,0,0,3,7,1100,0,47.5772,-122.381,1830,4750,5850,6580,1100,73,73
3,2.5,2160,3920,2,0,0,3,9,2160,0,47.5762,-122.415,1500,4920,6080,6420,2160,5,5
3,3,3230,8625,2,0,3,3,10,2220,1010,47.562,-122.404,2330,6022,11855,8352,3230,21,21
3,1,1350,4800,1,0,0,3,7,1350,0,47.5749,-122.412,1360,4800,6150,6160,1350,91,91
3,1.75,1700,6120,1,0,0,3,7,1700,0,47.5807,-122.397,1330,6120,7820,7450,1700,67,67
4,1.75,1980,5850,1,0,1,4,8,1380,600,47.5607,-122.391,1810,5850,7830,7660,1980,59,59
3,2,1650,6150,2,0,0,4,7,1650,0,47.5713,-122.394,1280,6150,7800,7430,1650,93,21
2,1,700,4350,1,0,0,3,6,700,0,47.5577,-122.391,1620,5100,5050,6720,700,76,76
2,1,1320,4520,1,0,1,3,6,1320,0,47.5655,-122.394,1420,4560,5840,5980,1320,107,43
6,4.5,3902,3880,3,0,4,4,9,2782,1120,47.5837,-122.399,1100,3870,7782,4970,3902,42,42
3,2,2520,5980,1,0,0,3,8,1790,730,47.5767,-122.383,1590,5750,8500,7340,2520,62,62
3,1.75,1850,2860,1,0,0,5,8,1210,640,47.5853,-122.39,1660,3120,4710,4780,1850,88,88
3,2,1820,5000,1,0,0,4,8,1720,100,47.5845,-122.395,2220,7200,6820,9420,1820,78,78
3,2.5,1060,1536,2,0,0,3,8,1060,0,47.6907,-122.395,1220,1316,2596,2536,1060,19,19
2,1.25,1240,2150,2,0,0,3,8,1240,0,47.6884,-122.374,1340,5289,3390,6629,1240,5,5
3,2.5,1600,1311,3,0,0,3,8,1600,0,47.6903,-122.394,1390,1321,2911,2711,1600,14,14
2,1,1060,5754,1,0,0,4,6,1060,0,47.6931,-122.372,1460,7200,6814,8660,1060,102,102
3,2,1670,4572,1,0,0,3,8,1670,0,47.6854,-122.373,1480,4890,6242,6370,1670,88,88
2,1,910,5000,1,0,0,4,6,910,0,47.683,-122.374,1480,5000,5910,6480,910,105,105
2,2.5,980,1021,3,0,0,3,8,980,0,47.6844,-122.387,980,1023,2001,2003,980,11,11
3,2.5,1680,2096,2,0,0,3,8,1380,300,47.6904,-122.37,1360,2096,3776,3456,1680,11,11
2,1,1070,4700,1,0,0,5,7,1070,0,47.6887,-122.368,1370,4700,5770,6070,1070,109,109
2,1.5,1160,1118,2,0,0,3,8,1020,140,47.6754,-122.375,1210,1118,2278,2328,1160,12,12
3,1,1270,4268,1,0,0,3,7,1270,0,47.6848,-122.392,1310,4080,5538,5390,1270,98,98
2,1.5,1940,5700,1,0,0,3,7,970,970,47.6881,-122.367,1250,5700,7640,6950,1940,82,82
4,2.25,2530,5200,1,0,1,4,8,1530,1000,47.6985,-122.382,2240,5200,7730,7440,2530,62,62
3,2,1320,1298,3,0,0,3,7,1320,0,47.6959,-122.376,1380,1503,2618,2883,1320,24,24
1,0.75,370,1801,1,0,0,5,5,370,0,47.6778,-122.389,1340,5000,2171,6340,370,96,96
3,1,1800,4005,1,0,0,4,7,1160,640,47.6876,-122.38,1240,4005,5805,5245,1800,90,90
3,1,1120,2300,1,0,0,4,7,820,300,47.6797,-122.384,1430,5100,3420,6530,1120,107,107
4,1.5,1960,4500,1,0,2,3,7,1960,0,47.6797,-122.359,1960,4500,6460,6460,1960,97,97
3,1.75,1620,3360,1,0,0,5,7,980,640,47.6886,-122.361,1400,3840,4980,5240,1620,92,92
3,3.25,1830,1804,3,0,0,3,8,1830,0,47.6945,-122.377,1830,1804,3634,3634,1830,5,5
3,1.75,1180,4080,1,0,0,4,6,760,420,47.6825,-122.391,1490,4080,5260,5570,1180,91,91
3,2.5,1350,2053,3,0,0,3,8,1350,0,47.6758,-122.386,1350,4150,3403,5500,1350,14,14
4,2.5,2000,4700,1,0,0,4,7,1220,780,47.6902,-122.368,1560,4700,6700,6260,2000,75,75
2,1,820,5400,1,0,0,3,6,820,0,47.6976,-122.375,1370,5632,6220,7002,820,79,79
3,3,3700,16857,1,0,0,3,10,2170,1530,47.6956,-122.392,2320,12000,20557,14320,3700,19,19
3,1.5,1580,5000,1,0,0,3,8,1290,290,47.687,-122.386,1570,4500,6580,6070,1580,80,80
1,1,580,1799,1,0,0,3,7,580,0,47.6829,-122.375,1260,4000,2379,5260,580,111,9
2,1,910,3750,1,0,0,3,7,910,0,47.6772,-122.369,1160,4000,4660,5160,910,115,115
2,1.5,1210,1278,2,0,0,3,8,1020,190,47.6756,-122.375,1210,1118,2488,2328,1210,12,12
3,3.25,1600,1289,3,0,0,3,8,1600,0,47.6957,-122.375,1600,1376,2889,2976,1600,21,21
2,1,990,4802,1,0,0,3,7,990,0,47.6876,-122.395,1180,5000,5792,6180,990,72,72
3,1,1580,5000,1,0,0,3,7,1580,0,47.684,-122.386,1280,4000,6580,5280,1580,93,93
5,1,1500,3978,2,0,0,3,7,1500,0,47.6811,-122.383,1350,4080,5478,5430,1500,90,90
4,2.5,2620,14126,1,0,4,4,8,1620,1000,47.6983,-122.397,2620,8905,16746,11525,2620,78,78
3,1.75,1520,8100,1,0,0,5,6,760,760,47.6966,-122.375,1040,8100,9620,9140,1520,74,74
2,1,1480,4080,1,0,0,3,7,1050,430,47.6842,-122.393,1310,4080,5560,5390,1480,70,70
5,1.5,1940,3430,1,0,0,4,6,1220,720,47.6853,-122.362,1830,4120,5370,5950,1940,93,93
3,1.5,1740,4200,1,0,0,4,7,1640,100,47.6782,-122.361,1660,3750,5940,5410,1740,99,99
3,1.5,2040,6750,1,0,0,3,7,1280,760,47.7013,-122.369,1970,6750,8790,8720,2040,69,69
3,1,1500,4500,1,0,0,3,7,1120,380,47.6873,-122.385,1440,4500,6000,5940,1500,81,81
3,1.75,1780,4500,1,0,0,4,7,920,860,47.6827,-122.362,1360,4000,6280,5360,1780,97,97
2,1,1510,4000,1,0,0,3,6,930,580,47.6917,-122.38,1300,4000,5510,5300,1510,95,95
4,2.25,2120,3794,2,0,0,4,7,1420,700,47.6893,-122.359,1420,3840,5914,5260,2120,93,93
2,2,1300,2500,1,0,0,4,7,770,530,47.6831,-122.373,1160,5000,3800,6160,1300,93,93
4,2,1700,2350,1,0,0,3,6,850,850,47.6865,-122.366,1600,4160,4050,5760,1700,93,1
4,2.75,2720,4000,1,0,2,5,8,1840,880,47.6797,-122.359,1600,4000,6720,5600,2720,91,91
2,1,800,4046,1,0,0,3,7,800,0,47.6895,-122.382,1400,4046,4846,5446,800,79,79
4,1.75,1960,4340,1,0,0,5,8,980,980,47.6847,-122.37,1630,4360,6300,5990,1960,107,107
6,1,2330,5000,1,0,0,4,7,2330,0,47.6789,-122.397,1570,5000,7330,6570,2330,99,99
3,1.75,1250,4120,1,0,0,4,7,980,270,47.685,-122.36,1250,4120,5370,5370,1250,94,94
2,1.75,1560,4141,1,0,0,4,7,880,680,47.6863,-122.382,1210,4141,5701,5351,1560,77,77
4,1.75,2330,5000,1,0,0,4,7,1510,820,47.6823,-122.368,1460,5000,7330,6460,2330,90,90
4,1.75,2170,4600,1,0,0,3,7,1270,900,47.6894,-122.384,1750,4000,6770,5750,2170,69,69
2,1,1190,5100,1,0,0,2,7,1190,0,47.6773,-122.382,1920,5100,6290,7020,1190,91,91
2,1,880,4000,1,0,0,3,7,880,0,47.6847,-122.387,1310,4000,4880,5310,880,79,79
3,2.5,1330,2180,3,0,0,3,8,1330,0,47.6987,-122.365,1330,5000,3510,6330,1330,5,5
2,1,1130,3800,1,0,0,4,7,1130,0,47.6862,-122.378,1470,3800,4930,5270,1130,103,103
3,2.5,2600,4750,1,0,0,4,9,1700,900,47.6833,-122.4,2380,4750,7350,7130,2600,68,68
2,1.75,1170,4635,1,0,0,4,6,690,480,47.6842,-122.359,1240,4120,5805,5360,1170,95,95
2,1,1460,4200,1,0,0,4,6,880,580,47.6774,-122.361,1540,4200,5660,5740,1460,105,105
3,3,1460,1180,3,0,0,3,8,1460,0,47.6998,-122.367,1460,1224,2640,2684,1460,13,13
3,2,1490,4800,2,0,0,5,6,1490,0,47.6933,-122.361,1500,4800,6290,6300,1490,71,71
2,1,1030,4400,1,0,0,3,7,1030,0,47.681,-122.361,1400,4200,5430,5600,1030,95,95
5,3.5,3210,4060,2,0,2,3,10,2290,920,47.6801,-122.357,1940,5000,7270,6940,3210,102,11
4,2.5,2440,6651,2,0,0,3,9,2440,0,47.6971,-122.371,1350,7653,9091,9003,2440,5,5
3,2,1690,5100,1,0,0,5,7,1690,0,47.6801,-122.38,1690,5100,6790,6790,1690,112,112
4,2.5,2470,2550,3,0,0,3,8,2470,0,47.6765,-122.389,1270,3060,5020,4330,2470,15,15
2,1,1260,3960,1,0,0,3,6,690,570,47.6899,-122.391,1250,3960,5220,5210,1260,94,94
2,1,890,4590,1,0,0,3,7,890,0,47.6901,-122.362,1310,4590,5480,5900,890,96,96
1,1,1090,5250,1,0,0,3,6,980,110,47.6999,-122.391,2160,5250,6340,7410,1090,92,92
3,2.5,1590,2550,3,0,0,3,7,1590,0,47.6772,-122.393,1260,5100,4140,6360,1590,34,34
2,1,890,5423,1,0,0,3,6,890,0,47.6966,-122.368,1690,5993,6313,7683,890,73,73
3,2.25,2890,5000,3,0,0,3,9,2890,0,47.6983,-122.389,2020,5000,7890,7020,2890,5,5
2,1,1330,3698,1,0,0,3,7,1330,0,47.6866,-122.372,1900,5000,5028,6900,1330,67,67
4,2,3090,8125,2,0,0,5,8,3090,0,47.6851,-122.395,1560,6250,11215,7810,3090,101,101
3,1.75,2280,7800,1,0,3,4,8,1360,920,47.6985,-122.387,2280,5200,10080,7480,2280,78,78
4,2.5,2180,3375,1,0,0,4,7,1420,760,47.6846,-122.361,1560,3375,5555,4935,2180,93,93
2,1,860,5040,1,0,0,3,7,860,0,47.6977,-122.365,1570,5040,5900,6610,860,63,63
2,1,1480,4080,1,0,0,3,7,1050,430,47.6842,-122.393,1310,4080,5560,5390,1480,70,70
4,2.5,2630,4000,3,0,0,3,8,2630,0,47.6915,-122.381,1640,4000,6630,5640,2630,17,17
3,2,1480,3876,1,0,0,5,7,860,620,47.6808,-122.382,1660,3774,5356,5434,1480,91,91
2,2.5,980,1010,3,0,0,3,8,980,0,47.6844,-122.387,980,1023,1990,2003,980,11,11
4,2,2220,3760,1,0,0,4,7,1370,850,47.6876,-122.368,1620,3760,5980,5380,2220,90,90
3,1.75,1480,7560,1,0,0,3,6,1100,380,47.6985,-122.364,1510,7250,9040,8760,1480,99,29
2,2.25,2210,5500,1,0,0,4,8,1410,800,47.697,-122.39,2140,6600,7710,8740,2210,51,51
3,2,2880,5100,1,0,0,4,7,2080,800,47.6805,-122.385,1820,5100,7980,6920,2880,93,93
3,3,1730,2940,3,0,0,3,7,1730,0,47.6911,-122.392,1690,4410,4670,6100,1730,34,34
2,1,910,4600,1,0,0,3,5,910,0,47.6916,-122.362,1020,4600,5510,5620,910,102,102
4,1.75,2000,3750,1,0,0,5,8,1120,880,47.6816,-122.374,1370,5000,5750,6370,2000,69,69
3,1.75,1750,3250,1,0,0,4,7,1230,520,47.6807,-122.366,1480,3600,5000,5080,1750,90,90
4,2.75,1660,5150,1,0,0,5,7,1280,380,47.6835,-122.362,1490,4017,6810,5507,1660,91,91
1,1,630,5150,1,0,0,4,5,630,0,47.6923,-122.369,1390,5150,5780,6540,630,65,65
2,3,2020,5000,1,0,0,3,8,1350,670,47.6758,-122.375,1160,1118,7020,2278,2020,67,67
3,1,1260,8910,1,0,0,4,7,1260,0,47.7,-122.375,1560,8910,10170,10470,1260,70,70
3,1.5,1380,3031,1,0,0,4,7,1380,0,47.6889,-122.38,1440,4005,4411,5445,1380,90,90
3,2.5,1530,3210,1,0,0,5,7,1010,520,47.6913,-122.393,1330,4410,4740,5740,1530,91,91
2,2,1240,2500,2,0,0,3,7,1240,0,47.6793,-122.395,1660,5000,3740,6660,1240,34,34
3,1.5,1900,5250,1,0,0,4,7,1500,400,47.6991,-122.392,1810,5250,7150,7060,1900,76,76
3,2.5,2550,6240,1,0,3,5,8,1750,800,47.6992,-122.387,2180,5200,8790,7380,2550,62,62
4,2.5,1860,3840,1,0,0,3,7,1170,690,47.6886,-122.359,1400,3840,5700,5240,1860,91,1
4,1.75,2120,4650,1,0,1,3,7,1190,930,47.6964,-122.4,2070,6487,6770,8557,2120,68,68
2,1,1170,4080,1,0,0,4,7,1170,0,47.6784,-122.386,1560,4586,5250,6146,1170,110,110
2,1,1250,3708,1,0,0,3,7,1250,0,47.685,-122.363,1430,3708,4958,5138,1250,93,93
3,1.5,2070,5386,1,0,0,4,7,1140,930,47.6896,-122.374,1770,5386,7456,7156,2070,71,71
2,1,910,4191,1,0,0,3,6,910,0,47.6929,-122.36,1480,6050,5101,7530,910,109,109
3,2.25,1670,6414,1,0,0,4,8,1670,0,47.6921,-122.386,2130,7035,8084,9165,1670,58,58
4,2.75,2640,3750,2,0,0,5,7,1840,800,47.6783,-122.363,1690,5000,6390,6690,2640,108,108
3,2,1410,4800,1,0,0,3,7,1410,0,47.6852,-122.378,1190,3840,6210,5030,1410,79,79
3,1.5,1620,7500,1,0,2,4,8,1620,0,47.7014,-122.381,2440,7800,9120,10240,1620,70,70
2,1.75,1840,4076,1,0,0,3,8,1140,700,47.6875,-122.393,1540,4076,5916,5616,1840,62,62
3,2.25,1380,1621,2,0,0,3,8,1140,240,47.678,-122.375,1460,1403,3001,2863,1380,12,12
3,2.5,2350,3750,2,0,0,3,7,1740,610,47.6767,-122.365,1590,4700,6100,6290,2350,16,16
4,2,2060,5000,1,0,0,3,7,1030,1030,47.6992,-122.379,1280,5000,7060,6280,2060,70,1
4,2.75,3950,10214,1,0,3,3,10,2050,1900,47.6969,-122.384,3130,8608,14164,11738,3950,64,64
3,2.5,2830,3750,3,0,0,3,10,2830,0,47.6798,-122.385,1780,5100,6580,6880,2830,5,5
3,2.25,998,844,2,0,0,3,7,798,200,47.6983,-122.367,998,1110,1842,2108,998,12,12
4,2.25,2000,3672,2,0,0,5,7,1650,350,47.6769,-122.383,2000,5100,5672,7100,2000,93,93
2,2.25,2460,16940,1,0,4,4,9,1930,530,47.6792,-122.404,2260,6851,19400,9111,2460,83,83
3,1,1170,3348,1,0,0,4,7,1170,0,47.687,-122.378,1590,4219,4518,5809,1170,95,95
5,2.5,2720,5000,1,0,0,4,7,1530,1190,47.6827,-122.376,1210,5000,7720,6210,2720,80,80
3,2.5,1530,2978,1,0,0,3,7,1210,320,47.6796,-122.39,1640,5100,4508,6740,1530,22,22
2,1,1070,8130,1,0,0,3,7,1070,0,47.697,-122.37,1360,7653,9200,9013,1070,77,77
2,1.75,1760,5000,1,0,0,4,7,940,820,47.682,-122.372,1530,5000,6760,6530,1760,92,92
5,2,2610,5009,1,0,0,3,7,1710,900,47.6969,-122.366,1600,5040,7619,6640,2610,31,31
7,2.75,2310,2400,1,0,0,3,6,2310,0,47.6775,-122.39,1340,3825,4710,5165,2310,104,104
4,2.5,2560,4000,2,0,0,5,8,1610,950,47.6885,-122.386,1760,4000,6560,5760,2560,90,90
3,2.25,2400,5300,1,0,0,4,7,1250,1150,47.6876,-122.384,1540,4800,7700,6340,2400,80,80
3,2.25,1360,1041,2,0,0,3,8,1094,266,47.6925,-122.375,1522,1382,2401,2904,1360,13,13
2,1,840,3840,1,0,0,4,7,840,0,47.684,-122.378,1310,3840,4680,5150,840,93,93
6,2.25,2550,5000,2,0,0,4,7,2550,0,47.6785,-122.396,1480,5000,7550,6480,2550,112,112
3,1.75,1890,3825,1,0,0,3,7,1290,600,47.6831,-122.381,1320,3825,5715,5145,1890,45,45
4,2.75,2690,5400,2,0,0,3,7,2210,480,47.6963,-122.367,1620,5400,8090,7020,2690,79,6
6,2.5,3760,12978,1,0,0,3,9,2360,1400,47.6976,-122.381,2300,7362,16738,9662,3760,52,52
3,2.25,2140,6720,1,0,0,3,8,1440,700,47.6949,-122.396,2060,6720,8860,8780,2140,58,58
2,2.25,1000,905,3,0,0,3,8,1000,0,47.6842,-122.387,980,1023,1905,2003,1000,13,13
1,1,1660,5422,1,0,0,4,7,830,830,47.6821,-122.388,1100,5356,7082,6456,1660,111,111
2,1.5,1210,5000,1,0,0,5,6,1210,0,47.6793,-122.397,1570,5000,6210,6570,1210,112,112
3,1,1380,7015,1,0,0,4,7,1380,0,47.6987,-122.36,1160,6700,8395,7860,1380,94,94
3,1,1800,5750,1,0,0,3,7,1040,760,47.686,-122.395,1320,5625,7550,6945,1800,72,72
3,1.5,1430,5200,1,0,3,4,7,1250,180,47.6988,-122.387,2210,6240,6630,8450,1430,79,79
3,3.5,2670,3000,2,0,0,3,9,1870,800,47.6813,-122.372,1750,5000,5670,6750,2670,5,5
2,1.75,1520,4220,1,0,0,4,7,840,680,47.6876,-122.366,1120,5700,5740,6820,1520,109,109
3,1,900,4084,1,0,0,3,7,900,0,47.684,-122.393,1280,4080,4984,5360,900,109,109
2,1,800,6016,1,0,0,3,6,800,0,47.6913,-122.369,1470,3734,6816,5204,800,77,77
3,2,940,5000,1,0,0,3,7,880,60,47.6771,-122.398,1420,5000,5940,6420,940,78,78
2,1,620,4455,1,0,0,3,6,620,0,47.6877,-122.395,1180,5000,5075,6180,620,92,92
4,2,2120,4000,1,0,0,4,7,1720,400,47.688,-122.383,1760,4000,6120,5760,2120,92,92
3,2.25,1130,1221,2,0,0,3,8,1030,100,47.6799,-122.375,1300,5000,2351,6300,1130,15,15
2,2.5,980,1013,3,0,0,3,8,980,0,47.6844,-122.387,980,1023,1993,2003,980,11,11
3,1.5,1670,5000,1,0,0,4,7,1670,0,47.678,-122.36,1750,5000,6670,6750,1670,107,107
3,2,1810,4500,1,0,0,4,7,980,830,47.681,-122.359,1800,4500,6310,6300,1810,113,113
3,1.75,2140,6000,1,0,0,3,7,1070,1070,47.6913,-122.366,1240,4650,8140,5890,2140,71,71
3,1.75,1680,2400,1,0,0,3,7,1170,510,47.6849,-122.367,1080,4560,4080,5640,1680,90,90
2,1.5,1080,6760,1,0,2,3,6,1080,0,47.7008,-122.386,2080,5800,7840,7880,1080,96,96
3,2.5,1820,5280,1,0,0,4,7,910,910,47.6892,-122.375,1600,4820,7100,6420,1820,70,70
2,1,1250,3825,1,0,0,3,7,850,400,47.6805,-122.38,1370,4998,5075,6368,1250,90,90
3,3,1730,1755,3,0,0,3,8,1730,0,47.6944,-122.377,1830,1804,3485,3634,1730,5,5
3,3.25,3080,12100,2,0,0,3,8,2080,1000,47.695,-122.399,2100,6581,15180,8681,3080,35,35
2,1,800,5100,1,0,0,3,7,800,0,47.6775,-122.388,1330,5100,5900,6430,800,74,74
3,3,1730,1902,3,0,0,3,8,1730,0,47.6944,-122.377,1830,1804,3632,3634,1730,5,5
3,1,1910,8167,1,0,0,4,8,1270,640,47.7004,-122.368,1500,6816,10077,8316,1910,68,68
4,2.25,2410,4560,2,0,2,5,9,1800,610,47.6796,-122.402,2150,5100,6970,7250,2410,90,90
3,1,1670,4005,1,0,0,4,7,1170,500,47.6878,-122.38,1240,4005,5675,5245,1670,80,80
3,1.75,1460,2800,2,0,0,3,7,1460,0,47.6779,-122.371,1220,4062,4260,5282,1460,91,91
2,1.5,1790,3760,1,0,0,4,8,1280,510,47.6871,-122.373,1540,5080,5550,6620,1790,91,91
2,1,640,2500,1,0,0,4,6,640,0,47.6776,-122.361,1460,4200,3140,5660,640,101,101
2,1.75,1980,8550,1,0,0,3,7,990,990,47.6989,-122.369,1480,6738,10530,8218,1980,38,38
3,1.75,1390,4602,1,0,0,3,7,930,460,47.6944,-122.366,1230,4800,5992,6030,1390,38,38
3,3,1320,1012,3,0,0,3,8,1320,0,47.6904,-122.395,1320,1536,2332,2856,1320,10,10
4,1.75,1640,4240,1,0,0,5,7,920,720,47.6766,-122.368,1300,4240,5880,5540,1640,98,98
3,2,1320,1297,3,0,0,3,7,1320,0,47.6959,-122.376,1380,1503,2617,2883,1320,24,24
3,1,1290,3880,1,0,0,4,7,1290,0,47.6879,-122.392,1290,4850,5170,6140,1290,100,100
3,3.25,1600,1298,3,0,0,3,8,1600,0,47.6954,-122.375,1600,1348,2898,2948,1600,20,20
3,2.25,998,904,2,0,0,3,7,798,200,47.6983,-122.367,998,1110,1902,2108,998,12,12
3,1.75,1410,4080,1,0,0,4,7,1000,410,47.6808,-122.384,1410,4080,5490,5490,1410,69,69
2,1.5,1780,4750,1,0,0,4,7,1080,700,47.6859,-122.395,1690,5962,6530,7652,1780,72,72
2,1,760,4000,1,0,0,3,7,760,0,47.6896,-122.396,1520,4000,4760,5520,760,75,75
2,1,1070,5150,1,0,0,4,6,870,200,47.6853,-122.366,1520,3860,6220,5380,1070,111,111
3,1.75,2000,5000,1,0,0,4,7,1110,890,47.6859,-122.399,1750,5000,7000,6750,2000,98,98
4,2.5,2220,5900,2,0,0,3,8,2220,0,47.6956,-122.36,1620,5900,8120,7520,2220,5,5
3,2,2080,3880,1,0,0,5,7,1160,920,47.686,-122.391,1330,3880,5960,5210,2080,65,65
2,1,750,4680,1,0,0,3,5,750,0,47.6919,-122.371,1450,4400,5430,5850,750,71,71
3,3.5,1600,1431,2,0,0,3,8,1240,360,47.6865,-122.363,1500,4120,3031,5620,1600,13,13
4,2.5,3350,4501,2,0,0,3,9,2640,710,47.688,-122.379,1000,4500,7851,5500,3350,17,17
5,3.25,3230,3825,2,0,0,3,9,2480,750,47.6785,-122.392,1480,5100,7055,6580,3230,5,5
4,1,1420,6458,1,0,0,4,7,1420,0,47.6988,-122.358,1670,6350,7878,8020,1420,66,66
3,2.5,1330,1064,3,0,0,3,8,1330,0,47.6835,-122.387,1330,1113,2394,2443,1330,15,15
4,2.5,2570,7221,1,0,0,4,8,1570,1000,47.6921,-122.387,2440,7274,9791,9714,2570,61,61
4,1.75,2680,6120,1,0,0,5,8,1340,1340,47.6965,-122.393,2320,6840,8800,9160,2680,60,60
3,1,1680,8910,1,0,0,4,7,1680,0,47.7011,-122.375,1620,7182,10590,8802,1680,79,79
4,1.75,1500,6820,1,0,0,5,7,1500,0,47.6794,-122.37,1360,4125,8320,5485,1500,114,114
5,2,2020,5000,1,0,0,4,7,2020,0,47.6949,-122.37,1510,6600,7020,8110,2020,81,81
4,2.75,4510,5000,2,0,2,3,8,3270,1240,47.6852,-122.4,2010,5000,9510,7010,4510,78,14
2,1,1250,5040,1,0,0,3,7,950,300,47.6959,-122.365,1290,5040,6290,6330,1250,99,99
4,2.25,2020,4960,2,0,0,3,7,1710,310,47.6867,-122.369,1590,4550,6980,6140,2020,81,81
2,1,850,4650,1,0,0,3,7,850,0,47.6926,-122.365,980,4700,5500,5680,850,44,44
5,2.75,2620,5500,1,0,0,3,7,1710,910,47.6806,-122.388,1790,5500,8120,7290,2620,108,108
2,1,960,4920,1,0,0,3,6,960,0,47.6946,-122.362,1010,5040,5880,6050,960,77,77
2,1,750,2786,1,0,0,5,7,750,0,47.6892,-122.393,1700,4653,3536,6353,750,72,72
3,2,1380,5000,1,0,0,4,7,1380,0,47.6807,-122.369,1350,5000,6380,6350,1380,102,102
4,2,1190,8190,1,0,0,3,7,1190,0,47.6908,-122.397,1190,1567,9380,2757,1190,74,74
3,3,1530,1568,3,0,0,3,8,1530,0,47.6998,-122.367,1460,1224,3098,2684,1530,7,7
4,2,2850,7861,1,0,4,4,10,1450,1400,47.6995,-122.397,2810,8087,10711,10897,2850,49,49
3,1.5,1940,5625,1,0,0,4,7,1440,500,47.6818,-122.388,1460,5500,7565,6960,1940,78,78
3,1,960,3600,1,0,0,4,7,960,0,47.6758,-122.369,1580,5000,4560,6580,960,113,113
2,1,1520,3360,1,0,0,4,7,830,690,47.6815,-122.382,1470,3774,4880,5244,1520,92,92
2,2.5,1340,1263,3,0,0,3,8,1340,0,47.6788,-122.388,1510,1260,2603,2770,1340,11,11
3,1.75,1400,4000,1,0,0,3,7,870,530,47.6913,-122.381,1400,4000,5400,5400,1400,68,68
2,1,1080,4000,1,0,0,3,7,1080,0,47.6902,-122.387,1530,4240,5080,5770,1080,79,79
1,1,730,5005,1,0,0,4,5,730,0,47.6992,-122.364,1630,5667,5735,7297,730,74,74
3,1.75,1250,3880,1,0,0,4,7,750,500,47.6869,-122.392,1240,3880,5130,5120,1250,75,75
3,2.5,1790,3962,2,0,0,3,8,1790,0,47.6894,-122.391,1340,3960,5752,5300,1790,27,27
2,1,1550,4600,1,0,0,4,7,1050,500,47.686,-122.384,1550,4600,6150,6150,1550,78,78
4,3.5,2760,5040,2,0,2,3,9,2760,0,47.6756,-122.401,2370,5760,7800,8130,2760,64,10
3,1.5,860,3200,1,0,0,3,6,860,0,47.6791,-122.362,1220,4300,4060,5520,860,90,90
3,2,3660,22410,1,0,3,4,9,1830,1830,47.6972,-122.4,2680,8250,26070,10930,3660,72,72
4,3,3370,7920,1,0,3,3,10,1860,1510,47.6773,-122.403,2730,7380,11290,10110,3370,31,31
3,1,1210,4731,1,0,0,3,7,1210,0,47.6865,-122.397,1450,5264,5941,6714,1210,118,118
4,2.5,3030,3841,3,0,0,3,9,3030,0,47.6781,-122.369,1080,4922,6871,6002,3030,14,14
3,1,1680,8010,1,0,0,3,7,840,840,47.6993,-122.376,1890,8778,9690,10668,1680,68,68
2,1,710,5100,1,0,0,5,7,710,0,47.6765,-122.381,1530,5100,5810,6630,710,114,114
3,2.25,1700,3333,1,0,0,3,7,1100,600,47.6784,-122.361,1700,3750,5033,5450,1700,95,95
3,2.25,1130,4445,1,0,0,4,8,1130,0,47.6845,-122.375,1330,4445,5575,5775,1130,89,89
3,1.75,2430,5000,2,0,0,4,7,1760,670,47.6785,-122.372,1320,4062,7430,5382,2430,74,74
6,3.5,2820,5400,1,0,0,3,8,1620,1200,47.6791,-122.374,1560,2276,8220,3836,2820,61,61
3,1.75,1750,5200,1,0,1,4,8,1750,0,47.6995,-122.383,2060,5200,6950,7260,1750,63,63
2,1.75,1210,4141,1,0,0,4,7,910,300,47.686,-122.382,1310,4141,5351,5451,1210,77,77
2,1,940,5000,1,0,0,4,7,940,0,47.6879,-122.385,1560,4500,5940,6060,940,82,82
3,1,1500,4000,1,0,0,3,6,900,600,47.6921,-122.38,950,4000,5500,4950,1500,94,94
4,1,1660,6075,1,0,0,5,7,1660,0,47.6755,-122.403,1810,5400,7735,7210,1660,104,104
3,1.75,1550,3680,1,0,0,3,7,1050,500,47.6817,-122.36,1560,4000,5230,5560,1550,92,92
5,3,2190,4900,2,0,0,5,7,1490,700,47.6892,-122.386,1370,4606,7090,5976,2190,79,79
2,1,1160,5000,1,0,0,4,8,1160,0,47.6865,-122.399,1750,5000,6160,6750,1160,82,82
2,1,860,5160,1,0,0,4,7,860,0,47.6823,-122.388,1090,5356,6020,6446,860,110,110
2,1.75,1170,4887,1,0,0,3,6,1020,150,47.695,-122.366,1170,5441,6057,6611,1170,90,90
4,1,1600,5500,1,0,0,4,7,1600,0,47.6983,-122.393,1900,5500,7100,7400,1600,73,73
2,1,950,3880,1,0,0,4,6,950,0,47.687,-122.389,1660,3880,4830,5540,950,100,100
3,1,1090,3000,1,0,0,4,8,1090,0,47.6889,-122.375,1570,5080,4090,6650,1090,90,90
3,1.5,2240,5300,1,0,0,5,7,1120,1120,47.6927,-122.395,1740,7110,7540,8850,2240,64,64
3,1,1140,4560,1,0,0,4,6,770,370,47.6889,-122.362,1340,3980,5700,5320,1140,75,75
2,1,860,3880,1,0,0,4,6,860,0,47.6862,-122.391,1230,4260,4740,5490,860,103,103
3,3,1460,1200,3,0,0,3,8,1460,0,47.7,-122.367,1460,1245,2660,2705,1460,13,13
2,2.25,1210,1267,2,0,0,3,8,1120,90,47.6783,-122.376,1360,1349,2477,2709,1210,9,9
4,3,2550,5300,2,0,0,3,8,1720,830,47.6786,-122.367,1590,4505,7850,6095,2550,111,2
4,2.5,2210,4861,2,0,0,3,9,2210,0,47.6959,-122.364,1590,5080,7071,6670,2210,6,6
3,2.5,2290,9142,1,0,0,3,8,2290,0,47.691,-122.387,1770,8035,11432,9805,2290,47,47
2,1,1770,8640,1,0,0,3,6,1520,250,47.6926,-122.363,1060,4804,10410,5864,1770,70,70
1,1,610,6000,1,0,0,4,5,610,0,47.6911,-122.367,970,5000,6610,5970,610,101,101
4,1.75,2090,5050,1,0,0,4,7,1090,1000,47.6802,-122.358,1760,5000,7140,6760,2090,103,103
3,2.25,2410,9668,1,0,1,4,8,1540,870,47.6996,-122.391,2510,5250,12078,7760,2410,54,54
2,2.5,1380,1329,2,0,0,3,8,1050,330,47.6903,-122.37,1360,3750,2709,5110,1380,11,11
2,1.5,1090,6750,1,0,0,3,7,950,140,47.6836,-122.397,1640,6750,7840,8390,1090,77,77
3,2.25,2190,2416,3,0,0,3,8,2190,0,47.6758,-122.38,1510,3615,4606,5125,2190,5,5
2,1,1380,5820,1,0,0,3,7,1380,0,47.6875,-122.392,1540,4076,7200,5616,1380,101,38
4,2,1760,7800,1,0,0,3,8,1760,0,47.6945,-122.38,1950,7800,9560,9750,1760,65,65
2,2,1520,5010,1,0,0,3,7,1520,0,47.6948,-122.364,1110,5040,6530,6150,1520,20,20
4,2,1610,5000,2,0,0,5,7,1610,0,47.6775,-122.398,1300,4950,6610,6250,1610,73,73
3,2,1340,2550,2,0,0,3,7,1340,0,47.6793,-122.38,1370,5100,3890,6470,1340,35,35
4,1.75,1850,4388,2,0,0,5,8,1850,0,47.6885,-122.381,1410,4107,6238,5517,1850,78,78
4,1,1390,3708,1,0,0,4,7,1390,0,47.685,-122.363,1430,3708,5098,5138,1390,93,93
3,1.75,1610,3478,1,0,0,4,7,1060,550,47.6774,-122.372,1610,3478,5088,5088,1610,90,90
3,2.5,2050,4185,2,0,0,3,9,2050,0,47.6922,-122.371,1150,5000,6235,6150,2050,8,8
2,1,980,2130,1,0,0,4,6,860,120,47.6769,-122.366,980,2800,3110,3780,980,101,101
4,2.25,2400,5350,1,0,0,4,7,1460,940,47.6763,-122.37,1250,4880,7750,6130,2400,90,90
3,1.75,2100,5000,1,0,0,3,8,2100,0,47.6776,-122.36,1830,4200,7100,6030,2100,103,103
4,1.75,1580,3635,1,0,0,4,7,790,790,47.6795,-122.371,1190,3638,5215,4828,1580,109,109
3,1.5,1310,3880,1,0,0,3,7,1090,220,47.6821,-122.392,1570,3880,5190,5450,1310,63,63
3,1.5,1620,6630,1,0,0,3,8,1280,340,47.6948,-122.394,1880,5100,8250,6980,1620,65,65
5,2.5,1690,2402,1,0,0,3,7,990,700,47.6903,-122.38,1200,4005,4092,5205,1690,89,89
2,1,880,6650,1,0,0,5,6,880,0,47.6914,-122.372,1250,6650,7530,7900,880,101,101
2,1,990,4920,1,0,0,3,6,990,0,47.6939,-122.368,990,4960,5910,5950,990,88,88
3,3,2470,7410,2,0,0,5,8,1860,610,47.6937,-122.392,2390,7800,9880,10190,2470,42,42
2,1,840,3860,1,0,0,4,6,840,0,47.6842,-122.365,1390,3860,4700,5250,840,110,110
3,2.25,2930,7005,3,0,2,3,9,2670,260,47.6763,-122.404,2450,6460,9935,8910,2930,20,20
3,2,1460,3000,1,0,0,4,7,940,520,47.682,-122.365,1460,3000,4460,4460,1460,29,29
3,1,910,3880,1,0,0,3,7,780,130,47.6862,-122.392,1220,3880,4790,5100,910,77,77
2,1,980,4108,1,0,0,3,7,980,0,47.687,-122.381,1500,4046,5088,5546,980,72,72
3,1,1290,5440,1,0,0,4,6,790,500,47.6951,-122.367,1220,5464,6730,6684,1290,90,90
3,2.5,1300,5150,1,0,0,4,7,1300,0,47.6838,-122.362,1400,4017,6450,5417,1300,99,99
2,1.5,1450,3840,1,0,0,3,7,950,500,47.684,-122.381,1450,3840,5290,5290,1450,72,72
3,1.75,2660,7800,1,0,0,4,8,1330,1330,47.6993,-122.378,1950,6240,10460,8190,2660,68,68
3,1,1200,5404,1,0,0,3,6,1200,0,47.6969,-122.368,1200,5987,6604,7187,1200,82,82
3,2.5,1960,3060,2,0,0,3,8,1960,0,47.6764,-122.389,1220,3060,5020,4280,1960,9,9
4,2,2300,3400,1,0,0,5,8,1550,750,47.678,-122.361,1670,4200,5700,5870,2300,104,104
3,2,1840,4750,1,0,0,5,7,1010,830,47.6862,-122.395,1760,5510,6590,7270,1840,68,68
4,2.5,2040,5000,1,0,0,5,7,1180,860,47.6786,-122.36,1540,5000,7040,6540,2040,95,95
3,1.75,2140,7280,1,0,0,3,7,1070,1070,47.6993,-122.377,2280,8400,9420,10680,2140,109,109
2,1,950,4080,1,0,0,4,7,950,0,47.6765,-122.384,1120,4080,5030,5200,950,95,95
2,1.75,1230,5418,1,0,0,3,8,990,240,47.6839,-122.376,1330,5074,6648,6404,1230,70,70
3,2,1480,5000,1,0,0,4,7,750,730,47.6859,-122.37,1250,4000,6480,5250,1480,91,91
3,2,2540,4750,1,0,0,5,9,1840,700,47.6838,-122.4,2190,4750,7290,6940,2540,89,89
4,1.75,1420,5000,1,0,0,4,7,1420,0,47.6771,-122.397,1490,5000,6420,6490,1420,74,74
5,3.5,3740,5610,2,0,0,3,9,2860,880,47.6764,-122.392,1520,4590,9350,6110,3740,5,5
3,2.5,1220,1475,3,0,0,3,8,1220,0,47.6909,-122.395,1220,1546,2695,2766,1220,19,19
3,1,1440,4300,1,0,0,3,8,1440,0,47.6847,-122.372,1640,4500,5740,6140,1440,90,90
2,1,910,4301,1,0,0,4,7,910,0,47.6814,-122.399,1810,4301,5211,6111,910,96,96
3,1,1360,3880,1,0,0,3,7,1060,300,47.6837,-122.391,1110,3880,5240,4990,1360,56,56
4,3.75,3610,7904,3,0,0,3,11,3290,320,47.6992,-122.385,2460,7300,11514,9760,3610,25,25
2,1.75,2080,4800,1,0,0,5,7,1080,1000,47.6896,-122.362,1310,4800,6880,6110,2080,96,96
3,2,1700,4080,1,0,0,4,7,850,850,47.6785,-122.393,1480,5100,5780,6580,1700,78,78
2,1,1050,2570,1,0,0,5,7,850,200,47.6764,-122.366,1080,2800,3620,3880,1050,92,92
4,3.5,3760,5000,2,0,0,3,9,2860,900,47.6826,-122.394,1340,5000,8760,6340,3760,5,5
3,1.5,1340,1110,2,0,0,3,7,1040,300,47.698,-122.366,1220,1110,2450,2330,1340,20,20
6,3,2800,4213,2,0,0,3,8,2800,0,47.6892,-122.389,1440,3960,7013,5400,2800,21,21
3,2.5,2420,7500,1,0,2,4,8,1210,1210,47.6949,-122.389,2340,7500,9920,9840,2420,75,75
1,1,640,6350,1,0,0,3,5,640,0,47.6976,-122.359,1270,6350,6990,7620,640,80,80
2,1,880,4000,1,0,0,3,6,780,100,47.6931,-122.379,950,4000,4880,4950,880,82,82
4,2,1540,3740,1,0,0,4,7,770,770,47.6886,-122.375,1090,5080,5280,6170,1540,73,73
2,1,1250,5880,1,0,0,3,6,900,350,47.6908,-122.391,1520,5020,7130,6540,1250,71,71
4,1,2080,5500,1,0,0,3,7,1040,1040,47.6838,-122.386,1280,4000,7580,5280,2080,78,78
4,2.25,2410,4250,1,0,0,5,7,1460,950,47.6849,-122.376,1360,5074,6660,6434,2410,90,90
3,1.75,1480,6985,1,0,0,4,7,1200,280,47.686,-122.374,1480,5588,8465,7068,1480,93,93
4,1.75,1260,3880,1,0,0,5,7,860,400,47.687,-122.391,1000,3880,5140,4880,1260,101,101
4,2.5,2310,4079,2,0,0,3,8,2310,0,47.6937,-122.361,1220,4800,6389,6020,2310,11,11
2,1,770,4000,1,0,0,5,5,770,0,47.6959,-122.364,1420,5040,4770,6460,770,95,95
2,1,1440,4046,1,0,0,3,7,960,480,47.6901,-122.382,1400,4046,5486,5446,1440,73,73
3,1.75,1620,3975,1,0,0,5,7,940,680,47.6786,-122.368,1320,3922,5595,5242,1620,93,93
2,1,700,2334,1,0,0,3,7,700,0,47.701,-122.39,2300,5000,3034,7300,700,74,74
3,1.75,1400,3825,1,0,0,4,6,1100,300,47.6793,-122.393,1720,5100,5225,6820,1400,115,115
3,2.25,1500,1290,2,0,0,3,8,1220,280,47.6785,-122.375,1460,1375,2790,2835,1500,13,13
3,1.75,2000,6130,1,0,0,4,8,1120,880,47.6925,-122.388,2140,7150,8130,9290,2000,68,68
3,1.75,1770,3880,1,0,0,3,8,1300,470,47.6846,-122.392,1430,3880,5650,5310,1770,56,56
3,1,910,4500,1,0,0,3,7,910,0,47.6828,-122.395,1370,5000,5410,6370,910,71,71
3,1.75,1840,5000,1,0,0,4,7,920,920,47.6808,-122.376,1220,5000,6840,6220,1840,109,109
2,1,1220,3000,1,0,0,3,7,920,300,47.6823,-122.365,1270,3000,4220,4270,1220,93,93
4,2.75,2890,5000,1,0,0,3,8,1990,900,47.6768,-122.363,1080,3750,7890,4830,2890,108,0
2,1,790,5024,1,0,0,4,7,790,0,47.6833,-122.395,1330,5024,5814,6354,790,78,78
4,1.75,1750,5500,1,0,0,5,7,1050,700,47.6802,-122.388,1640,5500,7250,7140,1750,93,93
4,1,1550,4750,1,0,0,3,7,1550,0,47.6824,-122.389,1320,4750,6300,6070,1550,100,100
2,1,800,5040,1,0,0,3,6,800,0,47.6953,-122.362,1020,5040,5840,6060,800,59,59
4,2.5,1690,4080,1,0,0,4,7,1140,550,47.6825,-122.379,1600,4590,5770,6190,1690,107,107
2,1.75,1500,6800,1,0,0,4,7,910,590,47.7004,-122.371,1450,6800,8300,8250,1500,77,77
3,2.5,1430,1056,3,0,0,3,8,1430,0,47.684,-122.388,1310,2135,2486,3445,1430,16,16
6,3.25,3750,14150,2,0,2,5,9,2750,1000,47.6999,-122.393,2140,7968,17900,10108,3750,83,46
3,2,2150,3880,1,0,0,3,8,1080,1070,47.6814,-122.392,2130,4000,6030,6130,2150,68,68
2,1,1890,5202,1,0,0,4,7,1890,0,47.6786,-122.379,1670,5100,7092,6770,1890,110,110
3,2.5,2690,4047,3,0,0,3,10,2690,0,47.6797,-122.385,2040,5000,6737,7040,2690,5,5
3,1.5,1950,1963,3,0,0,3,8,1950,0,47.6904,-122.397,1590,2028,3913,3618,1950,17,17
4,3,3380,16133,1,0,1,3,8,2330,1050,47.5501,-122.261,2500,11100,19513,13600,3380,60,60
2,1,1120,5650,1,0,1,3,6,720,400,47.5155,-122.255,2160,6480,6770,8640,1120,115,115
4,2.5,2090,4400,2,0,0,3,8,2090,0,47.5403,-122.286,2090,3430,6490,5520,2090,8,8
3,2.5,1630,2844,2,0,0,3,7,1630,0,47.5413,-122.288,1610,2582,4474,4192,1630,16,16
5,2,1880,4179,1,0,0,3,7,940,940,47.5536,-122.283,1350,5150,6059,6500,1880,67,15
2,1,1320,3090,1,0,0,4,7,1320,0,47.5517,-122.276,1270,4120,4410,5390,1320,111,111
3,1.75,2380,12681,1,0,0,1,6,1380,1000,47.5294,-122.279,1720,6377,15061,8097,2380,101,101
4,1.5,2890,9000,2,0,4,3,8,2090,800,47.5682,-122.274,2550,8400,11890,10950,2890,80,80
2,1,910,4500,1,0,0,4,7,910,0,47.5633,-122.289,1270,3500,5410,4770,910,113,113
3,1,780,3540,1,0,0,2,6,780,0,47.565,-122.291,1260,3540,4320,4800,780,99,99
4,1.75,2540,7200,1,0,0,4,7,1270,1270,47.5579,-122.271,1650,7200,9740,8850,2540,72,72
3,2.5,1320,1780,2,0,0,3,7,880,440,47.528,-122.269,3040,6000,3100,9040,1320,14,14
2,1,2540,7000,1,0,0,5,8,1320,1220,47.5259,-122.261,2160,6000,9540,8160,2540,77,77
3,1,1000,4000,1,0,0,4,6,1000,0,47.5523,-122.286,1040,4240,5000,5280,1000,104,104
1,0.75,590,5650,1,0,0,3,6,590,0,47.5181,-122.267,980,5650,6240,6630,590,75,75
4,2.25,1950,7000,1,0,1,3,8,1450,500,47.5426,-122.262,1840,6440,8950,8280,1950,62,62
3,2,1770,6000,1,0,3,3,7,1100,670,47.5644,-122.29,1300,3000,7770,4300,1770,35,35
4,2.25,2010,7200,1,0,1,4,8,1010,1000,47.5591,-122.267,2010,7200,9210,9210,2010,69,69
2,1,1010,6180,1,0,0,3,6,1010,0,47.5532,-122.28,1560,6180,7190,7740,1010,116,116
3,1,1450,6000,1,0,0,4,7,1450,0,47.5238,-122.287,1170,6464,7450,7634,1450,66,66
3,1.5,1470,7200,2,0,0,4,7,1470,0,47.5602,-122.28,1530,7200,8670,8730,1470,112,112
6,2,2650,4621,1,0,0,3,8,2650,0,47.5543,-122.275,1640,4879,7271,6519,2650,108,108
2,1,990,4800,1,0,0,3,6,990,0,47.5615,-122.28,1700,5400,5790,7100,990,111,111
3,1.5,2080,5000,1,0,0,3,7,1300,780,47.5322,-122.29,1860,5000,7080,6860,2080,56,56
3,1,2230,8163,1,0,0,3,7,1230,1000,47.5215,-122.275,2380,6874,10393,9254,2230,53,53
3,1,1210,4872,1,0,0,4,6,1210,0,47.5551,-122.273,1070,4872,6082,5942,1210,70,70
3,1,960,4600,1,0,0,4,6,960,0,47.5553,-122.286,1380,5175,5560,6555,960,92,92
2,1,2150,4500,1,0,0,3,7,1260,890,47.5158,-122.267,1590,5010,6650,6600,2150,102,102
2,1,800,3000,1,0,0,3,6,800,0,47.5602,-122.292,1640,3400,3800,5040,800,115,115
2,1,720,5913,1,0,0,3,6,720,0,47.5447,-122.27,1560,6600,6633,8160,720,99,99
3,2.75,2130,1400,2,0,0,3,9,1080,1050,47.5661,-122.29,1520,3132,3530,4652,2130,9,9
3,3,2010,2554,2,0,0,3,7,1860,150,47.5525,-122.269,1370,5100,4564,6470,2010,18,18
2,1,1230,6600,1,0,0,3,7,1130,100,47.5573,-122.282,1260,5060,7830,6320,1230,113,113
3,2,1410,4800,1,0,0,4,8,1410,0,47.5597,-122.267,1820,7200,6210,9020,1410,92,92
2,2.5,1950,2162,2,0,0,3,9,1500,450,47.5622,-122.292,1800,2457,4112,4257,1950,7,7
2,1,1250,4576,1,0,0,3,6,1040,210,47.5387,-122.266,1550,5000,5826,6550,1250,94,94
3,2.75,2780,7200,1,0,0,4,8,1870,910,47.5632,-122.27,1700,7200,9980,8900,2780,106,106
3,1.5,1240,5506,1,0,0,4,7,1240,0,47.5294,-122.285,1670,5589,6746,7259,1240,48,48
3,1.75,1020,5000,1,0,0,5,6,1020,0,47.5332,-122.29,1360,5000,6020,6360,1020,65,65
3,2.5,2420,8856,1,0,3,3,9,1620,800,47.5405,-122.263,2650,9750,11276,12400,2420,62,62
3,1,1130,12500,1,0,0,3,7,1130,0,47.5491,-122.268,2280,8750,13630,11030,1130,65,65
5,3,2140,5937,1,0,0,3,7,1280,860,47.5459,-122.27,1820,6710,8077,8530,2140,41,41
2,1,960,4000,1,0,0,3,6,960,0,47.5554,-122.267,1210,4000,4960,5210,960,101,101
3,1,1800,7200,1,0,0,3,7,1020,780,47.5616,-122.275,1740,5475,9000,7215,1800,55,55
4,2,1610,6250,1,0,0,4,7,1610,0,47.5293,-122.271,1310,6000,7860,7310,1610,67,67
3,3,1390,1080,2,0,0,3,7,1140,250,47.5325,-122.282,1450,1461,2470,2911,1390,13,13
3,1,2320,6750,1,0,0,3,7,1160,1160,47.5327,-122.276,1230,6075,9070,7305,2320,59,59
2,1,1470,5566,1,0,0,4,7,770,700,47.5348,-122.269,1410,5808,7036,7218,1470,100,100
3,1.75,2380,5650,1,0,2,4,8,1190,1190,47.5119,-122.255,2350,6554,8030,8904,2380,63,63
2,1.75,1610,4104,1,0,0,3,7,950,660,47.5565,-122.275,1510,5284,5714,6794,1610,23,23
3,2,1570,6300,1,0,0,3,7,820,750,47.5565,-122.275,1510,4281,7870,5791,1570,66,9
2,1,810,4755,1,0,0,3,7,810,0,47.5313,-122.28,1180,4755,5565,5935,810,39,39
3,1.75,1490,3800,1,0,0,3,6,700,790,47.5554,-122.27,2180,4000,5290,6180,1490,106,106
5,2,1430,5600,1,0,0,3,6,1430,0,47.5192,-122.266,1860,5980,7030,7840,1430,72,72
3,1,1070,3713,1,0,0,4,6,1070,0,47.5683,-122.285,1290,3960,4783,5250,1070,102,102
3,2,1830,4992,1,0,0,3,7,1230,600,47.5145,-122.27,2050,7740,6822,9790,1830,66,66
4,1.5,1600,5750,2,0,0,4,6,1600,0,47.5437,-122.28,1690,5750,7350,7440,1600,117,117
2,1,950,5650,1,0,0,5,6,950,0,47.5149,-122.257,1250,5650,6600,6900,950,76,76
2,2.5,1000,1092,2,0,0,3,7,990,10,47.5419,-122.271,1330,1466,2092,2796,1000,15,15
3,1.75,1090,4500,1,0,0,5,8,1090,0,47.5157,-122.256,1640,5225,5590,6865,1090,90,90
3,2.25,1960,1985,2,0,0,3,7,1750,210,47.5419,-122.289,1760,1985,3945,3745,1960,16,16
3,1.75,1350,7370,1,0,0,4,6,1350,0,47.5336,-122.278,1440,6000,8720,7440,1350,107,107
3,1.75,1670,6034,1,0,0,3,7,990,680,47.5209,-122.286,1230,6034,7704,7264,1670,62,62
3,3.75,2260,2050,2,0,0,3,9,1170,1090,47.566,-122.29,2130,3082,4310,5212,2260,9,9
4,2,1830,5220,1,0,0,3,7,1830,0,47.5331,-122.278,1760,5757,7050,7517,1830,68,68
3,1,760,3090,1,0,0,2,5,760,0,47.5513,-122.275,1020,5356,3850,6376,760,116,116
2,1,910,6232,1,0,0,3,6,910,0,47.5328,-122.272,1070,6232,7142,7302,910,76,76
5,3,2008,5050,1,0,0,3,7,1216,792,47.5376,-122.292,2040,5297,7058,7337,2008,27,27
4,2,1760,5500,1,0,1,3,7,780,980,47.5183,-122.265,1510,5500,7260,7010,1760,94,10
4,2.5,2900,5760,1,0,0,4,8,1660,1240,47.55,-122.272,2250,6098,8660,8348,2900,60,60
2,2,1480,6075,1,0,0,5,7,740,740,47.5317,-122.276,1230,6053,7555,7283,1480,100,100
3,2.25,1410,7290,1,0,0,3,7,940,470,47.5396,-122.274,1550,7375,8700,8925,1410,39,39
4,1.75,2180,4066,1,0,0,3,6,1270,910,47.5487,-122.277,1400,1343,6246,2743,2180,108,108
3,2,1640,9234,1,0,0,5,7,1060,580,47.5162,-122.274,2230,10354,10874,12584,1640,52,52
3,1,1600,7161,1,0,0,3,8,1600,0,47.5507,-122.261,1760,8280,8761,10040,1600,66,66
3,1.5,1570,10824,2,0,0,3,7,1570,0,47.54,-122.275,1530,8125,12394,9655,1570,111,111
3,1,960,5030,1,0,0,3,7,960,0,47.5611,-122.28,1460,5400,5990,6860,960,64,64
3,1,1100,5000,1,0,0,3,7,1100,0,47.5433,-122.283,1020,5000,6100,6020,1100,59,59
3,2,1170,5450,1,0,0,5,6,1170,0,47.5276,-122.273,1340,6384,6620,7724,1170,117,117
3,1.75,2330,7200,1,0,0,4,8,1320,1010,47.565,-122.274,1820,7200,9530,9020,2330,69,69
2,1,1220,6000,1,0,0,3,6,880,340,47.5647,-122.27,1220,6840,7220,8060,1220,81,81
5,2,2040,6180,2,0,0,4,7,2040,0,47.5503,-122.28,1870,4365,8220,6235,2040,111,111
3,1.75,1180,4000,1,0,0,3,7,1040,140,47.5226,-122.284,1430,4000,5180,5430,1180,90,90
3,1,1010,8800,1,0,0,4,7,1010,0,47.5483,-122.278,1400,4095,9810,5495,1010,65,65
3,2.5,2200,3360,2,0,0,3,8,2200,0,47.5418,-122.287,2130,3423,5560,5553,2200,10,10
3,1.75,1900,3000,1,0,0,5,7,1070,830,47.5255,-122.265,1130,6000,4900,7130,1900,116,116
3,2.5,1320,3150,2,0,0,3,7,1320,0,47.5328,-122.282,1390,1725,4470,3115,1320,14,14
5,2.75,2410,5003,1,0,0,3,7,1410,1000,47.5298,-122.274,1590,5003,7413,6593,2410,11,11
2,1,1040,5700,1,0,0,3,6,1040,0,47.519,-122.26,1380,5700,6740,7080,1040,97,97
3,1,1590,5400,1,0,1,3,8,1280,310,47.5509,-122.261,2140,7161,6990,9301,1590,71,71
4,1,1780,4310,1,0,0,5,6,1780,0,47.5486,-122.278,1460,4310,6090,5770,1780,100,100
2,1,1740,3622,1,0,0,4,7,950,790,47.5541,-122.29,1270,3800,5362,5070,1740,95,95
2,1,2120,6897,1,0,0,4,7,1060,1060,47.5566,-122.278,1900,4462,9017,6362,2120,96,96
1,1,1180,4000,1,0,2,4,8,840,340,47.5561,-122.266,1420,4000,5180,5420,1180,109,109
3,1,1122,6554,1,0,0,3,5,1122,0,47.5135,-122.257,1610,5650,7676,7260,1122,119,119
4,1.5,1220,4900,1,0,0,3,6,1220,0,47.5292,-122.269,1410,3000,6120,4410,1220,77,77
2,1,760,6141,1,0,0,2,6,760,0,47.5469,-122.277,900,4120,6901,5020,760,99,99
4,2.75,2310,5650,1,0,2,3,8,1330,980,47.513,-122.252,2300,5650,7960,7950,2310,67,2
3,1,1330,3740,1,0,0,3,6,1330,0,47.5502,-122.274,1330,5053,5070,6383,1330,116,116
3,2,1320,4000,1,0,0,4,6,1020,300,47.5515,-122.262,2410,6212,5320,8622,1320,79,79
4,1,2590,18224,1,0,0,4,7,2000,590,47.5318,-122.286,1800,7080,20814,8880,2590,108,108
2,1,1140,11480,1,0,0,3,6,1140,0,47.5328,-122.274,1550,8150,12620,9700,1140,112,112
2,1,840,5551,1,0,0,3,6,840,0,47.5354,-122.28,1270,4652,6391,5922,840,67,67
2,1,750,5379,1,0,0,3,6,750,0,47.5324,-122.272,1030,5511,6129,6541,750,100,100
5,3,2930,5500,1,0,0,3,7,1750,1180,47.5572,-122.281,1400,5500,8430,6900,2930,68,68
3,1.5,2000,7294,1,0,0,3,7,1520,480,47.5297,-122.267,2000,6000,9294,8000,2000,54,54
3,1,1660,7650,1,0,0,3,7,1350,310,47.5576,-122.277,1750,5760,9310,7510,1660,109,109
2,1.75,1280,7110,1,0,0,4,7,1000,280,47.5569,-122.273,1550,6835,8390,8385,1280,64,64
4,2,2060,3060,2,0,0,3,7,2060,0,47.5631,-122.285,1630,3766,5120,5396,2060,51,51
2,1,880,2400,1,0,0,3,6,760,120,47.5643,-122.275,1180,6300,3280,7480,880,101,101
5,2,3110,6131,1,0,0,5,7,1560,1550,47.5615,-122.279,1720,6600,9241,8320,3110,79,79
5,3,2350,6480,2,0,3,4,7,1650,700,47.558,-122.266,1840,7200,8830,9040,2350,95,52
3,1.75,1430,4920,1,0,0,2,6,1430,0,47.5388,-122.275,1550,5646,6350,7196,1430,62,62
2,1,890,5000,1,0,0,4,6,890,0,47.5526,-122.287,1160,5000,5890,6160,890,72,72
1,1,1090,8750,1,0,0,4,6,1090,0,47.54,-122.269,1830,5000,9840,6830,1090,95,95
3,2,1340,7200,1,0,0,4,7,1340,0,47.5601,-122.265,1630,5760,8540,7390,1340,96,96
3,3,2130,5000,1,0,0,3,7,1570,560,47.5451,-122.284,1638,4500,7130,6138,2130,106,106
3,1.5,1660,5665,1,0,0,5,7,920,740,47.5391,-122.274,1530,5665,7325,7195,1660,101,101
2,1,930,5760,1,0,0,3,6,730,200,47.5598,-122.266,1970,5760,6690,7730,930,102,102
3,1,2130,3825,1,0,0,3,7,2130,0,47.5506,-122.281,1780,5150,5955,6930,2130,102,102
4,2.5,2570,8178,1,0,2,3,8,1710,860,47.5483,-122.261,2050,7500,10748,9550,2570,58,58
4,2.25,2750,6180,1,0,0,4,8,1500,1250,47.5691,-122.284,1740,6180,8930,7920,2750,71,71
3,2,1600,7995,1,0,0,3,7,1600,0,47.5177,-122.257,2440,6900,9595,9340,1600,69,31
4,1.75,2140,4959,1,0,0,3,7,1080,1060,47.5166,-122.266,1590,5250,7099,6840,2140,54,54
4,3.75,4410,9231,3,0,3,3,11,4410,0,47.5427,-122.265,2160,6600,13641,8760,4410,18,18
2,1,2020,6720,1,0,0,3,7,1010,1010,47.5474,-122.291,1720,6720,8740,8440,2020,71,71
3,3,2830,6041,2,0,3,3,8,1840,990,47.5694,-122.283,3420,6360,8871,9780,2830,104,104
2,1,830,4500,1,0,0,3,6,830,0,47.5248,-122.265,1092,5350,5330,6442,830,99,99
5,3.75,3360,6000,2,0,0,3,8,2640,720,47.558,-122.277,1930,6000,9360,7930,3360,56,15
3,1,1450,4000,1,0,1,4,8,950,500,47.5554,-122.266,1880,4000,5450,5880,1450,71,71
4,1,1710,6050,1,0,0,3,7,1410,300,47.5569,-122.288,1560,4950,7760,6510,1710,106,106
1,1,790,4590,1,0,0,3,6,790,0,47.5677,-122.285,1070,4590,5380,5660,790,108,108
4,2.5,2240,7200,2,0,0,3,8,2240,0,47.5636,-122.275,1860,6600,9440,8460,2240,24,24
4,2,2380,4500,1,0,0,3,6,1470,910,47.5652,-122.281,1300,4500,6880,5800,2380,93,0
4,2.5,2840,8820,1,0,2,5,8,1420,1420,47.5542,-122.265,2310,8750,11660,11060,2840,67,67
6,2,2500,5200,1,0,0,3,8,1250,1250,47.5517,-122.268,1800,5200,7700,7000,2500,53,53
3,1.75,1500,6180,1,0,0,4,6,1060,440,47.5689,-122.284,1740,6180,7680,7920,1500,72,72
4,2,1830,6000,1,0,0,5,7,1070,760,47.5453,-122.279,1830,5500,7830,7330,1830,66,66
2,1.5,1100,1228,2,0,0,3,7,900,200,47.5538,-122.282,1340,1380,2328,2720,1100,12,12
4,2,1950,3757,1,0,0,4,6,1160,790,47.5372,-122.269,1720,3757,5707,5477,1950,111,111
4,2.75,1720,6270,2,0,0,3,8,1720,0,47.5458,-122.268,2130,8700,7990,10830,1720,41,41
5,2.75,2160,7200,1,0,0,3,7,1220,940,47.5576,-122.273,1900,7200,9360,9100,2160,64,64
3,2,2330,4950,1,0,0,3,6,1430,900,47.5585,-122.29,1160,5115,7280,6275,2330,119,119
6,4.5,3390,7200,2,0,0,3,8,2440,950,47.5205,-122.288,2040,7214,10590,9254,3390,12,12
4,2.5,1800,5070,1,0,0,5,7,1080,720,47.5303,-122.28,1870,5365,6870,7235,1800,40,40
4,2.75,2420,11201,1,0,1,3,8,1420,1000,47.5459,-122.265,3170,9385,13621,12555,2420,71,16
2,1,1270,3008,1,0,0,4,6,650,620,47.5351,-122.279,1270,1514,4278,2784,1270,96,96
3,1,1050,5518,1,0,0,3,7,1050,0,47.5564,-122.278,1490,4269,6568,5759,1050,71,71
3,1.75,1350,7370,1,0,0,4,6,1350,0,47.5336,-122.278,1440,6000,8720,7440,1350,107,107
3,1,1530,6372,1,0,0,3,7,1210,320,47.535,-122.289,1960,6426,7902,8386,1530,57,57
3,1,1240,4842,1,0,0,4,6,1240,0,47.5166,-122.269,1540,5110,6082,6650,1240,103,103
3,2.75,3890,7216,2,0,1,3,8,3260,630,47.5445,-122.266,2490,9920,11106,12410,3890,52,4
3,1,1200,8360,1,0,0,2,6,1200,0,47.5414,-122.281,1570,6823,9560,8393,1200,71,71
4,2,1540,9279,1,0,0,3,7,1540,0,47.5163,-122.268,1540,5110,10819,6650,1540,64,64
4,2.75,5470,18200,2,1,4,3,11,3730,1740,47.5316,-122.263,3620,15100,23670,18720,5470,27,27
3,1.75,1960,11931,1,0,0,3,7,980,980,47.5432,-122.272,1460,4498,13891,5958,1960,65,65
3,2.5,1660,3990,2,0,0,3,7,1660,0,47.5298,-122.268,1670,4050,5650,5720,1660,10,10
5,3.5,3550,9600,2,0,0,3,9,2550,1000,47.5484,-122.269,2030,9600,13150,11630,3550,21,21
2,1.5,1010,1309,2,0,0,3,7,860,150,47.5659,-122.286,1190,3060,2319,4250,1010,12,12
3,1,1190,4120,1,0,0,3,6,1190,0,47.5513,-122.272,1360,4635,5310,5995,1190,90,90
5,3.25,2820,6589,1,0,0,3,7,2320,500,47.5357,-122.273,1560,5647,9409,7207,2820,113,0
4,1.5,1550,5053,1,0,0,4,7,1180,370,47.5499,-122.274,1450,5639,6603,7089,1550,56,56
6,3.25,4920,20590,1,0,3,4,9,2730,2190,47.5468,-122.267,3700,14994,25510,18694,4920,59,59
3,3.5,2380,6250,2,0,3,3,8,1670,710,47.5137,-122.252,2540,4010,8630,6550,2380,22,22
3,2,1460,5715,1,0,0,3,7,1460,0,47.54,-122.276,1400,5715,7175,7115,1460,62,0
2,1,790,5150,1,0,0,4,6,790,0,47.5528,-122.272,1460,5150,5940,6610,790,71,71
2,1,1210,3090,1,0,0,3,6,860,350,47.5532,-122.277,1210,3348,4300,4558,1210,93,93
2,1,940,9330,1,0,0,3,6,940,0,47.5445,-122.273,1900,6145,10270,8045,940,78,78
4,3.25,2720,4000,2,0,1,3,10,2070,650,47.5554,-122.267,1450,4000,6720,5450,2720,5,5
2,1,670,3101,1,0,0,4,6,670,0,47.5546,-122.274,1660,4100,3771,5760,670,71,71
2,1,1150,3000,1,0,0,3,6,780,370,47.5624,-122.291,1150,5000,4150,6150,1150,104,104
3,1,980,3090,1,0,0,3,6,980,0,47.5525,-122.277,980,3090,4070,4070,980,116,116
3,1,1640,6180,1,0,0,4,7,1640,0,47.5682,-122.284,1540,6180,7820,7720,1640,73,73
4,1,1150,6000,1,0,0,3,6,1150,0,47.562,-122.283,840,3030,7150,3870,1150,112,112
3,1,1060,4880,1,0,0,2,6,910,150,47.5545,-122.288,1200,4880,5940,6080,1060,106,106
3,2.25,1640,2875,2,0,0,3,6,1240,400,47.5686,-122.286,1500,3960,4515,5460,1640,36,36
1,1,720,5000,1,0,0,4,6,720,0,47.5289,-122.272,1170,5000,5720,6170,720,111,111
4,2.75,2310,5000,1,0,0,5,8,1480,830,47.5502,-122.268,1100,5000,7310,6100,2310,111,111
2,1,1170,5150,1,0,0,3,6,980,190,47.5503,-122.283,1660,5150,6320,6810,1170,112,112
4,2,2200,3060,1,0,0,3,7,1100,1100,47.565,-122.284,1410,5100,5260,6510,2200,111,14
4,3,1780,4228,1,0,0,3,7,1780,0,47.5488,-122.287,1730,5304,6008,7034,1780,66,66
3,2,1440,4859,2,0,0,2,6,1440,0,47.5503,-122.285,1360,4558,6299,5918,1440,98,98
2,1,1180,9261,1,0,0,4,7,940,240,47.5492,-122.274,1700,6325,10441,8025,1180,62,62
2,1,1410,5650,1,0,0,3,6,1410,0,47.5159,-122.258,1430,5650,7060,7080,1410,101,101
3,1,1420,8000,1,0,4,3,7,1420,0,47.5169,-122.255,1780,8295,9420,10075,1420,69,69
3,2.5,1960,7200,1,0,0,4,8,980,980,47.5655,-122.27,1440,7200,9160,8640,1960,79,79
3,1.5,2040,6000,1,0,0,3,7,1340,700,47.5218,-122.286,1190,6000,8040,7190,2040,62,62
4,1.75,2740,8520,1,0,2,3,8,1370,1370,47.5445,-122.263,2740,9286,11260,12026,2740,65,65
3,2,1290,6150,1,0,1,5,6,1290,0,47.5181,-122.257,1960,6150,7440,8110,1290,69,69
3,1,1060,6000,1,0,0,3,8,1060,0,47.5427,-122.275,1240,7874,7060,9114,1060,65,65
4,1,1870,14703,1,0,0,3,6,1090,780,47.5274,-122.281,1650,6045,16573,7695,1870,91,91
5,3.5,3400,9804,2,0,0,3,9,2550,850,47.543,-122.266,2380,7440,13204,9820,3400,11,11
5,2.5,2340,1989,2,1,4,3,8,2340,0,47.5193,-122.257,2200,3230,4329,5430,2340,60,60
2,1,1450,4750,1,0,0,3,7,850,600,47.5293,-122.272,1190,5000,6200,6190,1450,69,69
7,4,3150,7800,2,0,0,3,8,3150,0,47.5259,-122.279,1880,6000,10950,7880,3150,6,6
3,2.5,1320,2480,2,0,0,3,7,1320,0,47.536,-122.284,1320,3240,3800,4560,1320,14,14
2,1.75,1160,4848,2,0,1,4,7,1160,0,47.542,-122.265,1990,7440,6008,9430,1160,70,70
2,2,1440,6677,1,0,0,3,7,870,570,47.5513,-122.264,2020,7642,8117,9662,1440,67,67
2,1.5,750,2964,1,0,0,5,5,750,0,47.5518,-122.277,1350,3090,3714,4440,750,100,100
2,2,1320,3060,1,0,0,4,6,1320,0,47.5643,-122.284,1410,3264,4380,4674,1320,109,109
3,1.5,1440,8370,1,0,0,3,7,1440,0,47.5418,-122.275,1440,8370,9810,9810,1440,42,42
3,1,890,4810,1,0,0,3,6,890,0,47.5153,-122.266,1230,6057,5700,7287,890,109,109
2,2,870,6450,1,0,0,4,6,740,130,47.5354,-122.278,1640,5775,7320,7415,870,65,65
3,1,1550,4160,1,0,0,4,6,1550,0,47.5387,-122.265,1590,5000,5710,6590,1550,93,93
2,1,1430,4000,1,0,0,3,7,930,500,47.5233,-122.284,1110,4000,5430,5110,1430,70,70
3,1,1350,7553,1,0,0,3,6,1350,0,47.5345,-122.274,1380,7470,8903,8850,1350,105,105
5,2,2110,7919,1,0,0,3,7,1110,1000,47.5164,-122.267,1590,5250,10029,6840,2110,53,53
3,1,820,5150,1,0,0,5,6,820,0,47.5514,-122.284,1100,5150,5970,6250,820,101,101
2,1,780,7200,1,0,0,2,6,780,0,47.5609,-122.279,1750,7200,7980,8950,780,84,84
5,2.5,2420,8560,1,0,2,3,7,1620,800,47.532,-122.285,2210,7040,10980,9250,2420,41,41
3,1.75,2390,6000,1,0,0,3,6,1240,1150,47.5362,-122.268,2020,6000,8390,8020,2390,111,111
2,1,1280,9690,1,0,0,4,6,640,640,47.5341,-122.279,1630,15884,10970,17514,1280,100,100
3,1,1740,4800,1,0,0,3,8,1740,0,47.5596,-122.27,1600,4800,6540,6400,1740,67,67
3,2,1170,3868,1,0,0,4,7,1170,0,47.5543,-122.29,1400,3800,5038,5200,1170,94,94
3,1,980,4800,1,0,0,3,7,980,0,47.5663,-122.274,2030,7200,5780,9230,980,93,93
3,1,1100,8536,1,0,0,4,7,1100,0,47.5162,-122.261,1570,8040,9636,9610,1100,62,62
3,3.25,2200,7440,2,0,0,4,7,1710,490,47.5409,-122.268,1260,6765,9640,8025,2200,72,72
2,1,820,4860,1,0,0,5,6,820,0,47.5298,-122.271,1240,6000,5680,7240,820,64,64
2,1,970,5665,1,0,0,4,6,970,0,47.5513,-122.273,1490,4429,6635,5919,970,111,111
2,1,830,7200,1,0,0,2,6,830,0,47.5604,-122.275,1150,6600,8030,7750,830,99,99
3,2.5,1610,2527,2,0,2,3,9,1080,530,47.5674,-122.29,1610,4173,4137,5783,1610,14,14
4,3.5,2700,2868,2,0,0,3,11,1920,780,47.5685,-122.286,1430,3858,5568,5288,2700,13,13
2,1,2240,7200,1,0,0,4,7,1120,1120,47.5631,-122.271,1390,6000,9440,7390,2240,79,79
4,1.75,2100,4400,1,0,0,5,7,1720,380,47.5299,-122.266,1850,4400,6500,6250,2100,95,95
3,2.5,2160,3000,1,0,0,3,7,1260,900,47.5644,-122.289,1060,3500,5160,4560,2160,110,3
1,1,790,12000,1,0,0,3,6,790,0,47.5146,-122.265,1900,6000,12790,7900,790,101,101
3,1,2480,8906,1,0,0,3,7,1240,1240,47.5366,-122.289,1800,8906,11386,10706,2480,50,50
2,1,1030,6000,1,0,0,3,7,1030,0,47.5669,-122.283,1510,5000,7030,6510,1030,94,94
2,1,920,6600,1,0,0,4,6,920,0,47.5572,-122.282,1370,5500,7520,6870,920,109,109
3,2.5,1580,2170,2,0,0,3,7,1580,0,47.5418,-122.289,1610,1917,3750,3527,1580,16,16
3,2.75,2130,1400,2,0,0,3,9,1080,1050,47.5661,-122.29,1880,3132,3530,5012,2130,9,9
3,1,1330,3740,1,0,0,3,6,1330,0,47.5502,-122.274,1330,5053,5070,6383,1330,116,116
2,1,860,3300,1,0,0,5,6,860,0,47.5496,-122.279,1380,4400,4160,5780,860,116,116
3,1,1920,6710,1,0,0,3,7,1320,600,47.5346,-122.286,1810,5600,8630,7410,1920,60,60
3,1.75,1870,7189,1,0,0,3,7,1270,600,47.5412,-122.27,1780,6200,9059,7980,1870,60,60
3,1.75,1840,8601,1,0,0,3,7,920,920,47.5359,-122.276,1390,7452,10441,8842,1840,114,0
3,1,920,3863,1,0,0,3,6,920,0,47.5524,-122.27,1080,5150,4783,6230,920,49,49
4,1.75,1800,5210,1,0,0,5,7,1080,720,47.5298,-122.28,1870,5365,7010,7235,1800,40,40
4,1,1270,6459,1,0,0,3,7,1270,0,47.5441,-122.273,1300,4100,7729,5400,1270,101,101
3,1,960,6180,1,0,0,4,6,960,0,47.5518,-122.279,1250,4120,7140,5370,960,109,109
3,2.25,2220,4060,1,0,0,3,7,1330,890,47.5188,-122.265,1930,5625,6280,7555,2220,26,26
3,1.25,1230,4500,1,0,0,4,7,1230,0,47.5301,-122.271,1310,5000,5730,6310,1230,106,106
3,2,1680,4886,2,0,0,3,7,1180,500,47.5536,-122.286,1400,4900,6566,6300,1680,79,79
4,1,2000,4676,1,0,0,3,7,1250,750,47.5529,-122.268,1140,4676,6676,5816,2000,103,28
2,0.5,580,6900,1,0,0,3,5,580,0,47.5135,-122.262,1570,5040,7480,6610,580,78,78
2,2.25,860,696,2,0,0,3,9,860,0,47.5663,-122.29,1100,3000,1556,4100,860,10,10
4,4.5,4750,13912,2,0,2,3,10,3600,1150,47.5332,-122.265,3600,22124,18662,25724,4750,14,14
3,2.5,2080,3920,2,0,0,3,8,2080,0,47.5412,-122.286,2110,3710,6000,5820,2080,9,9
3,1.5,1160,8906,1,0,0,3,7,1160,0,47.5362,-122.29,1160,8906,10066,10066,1160,57,57
3,1.75,1890,7004,1,0,0,3,7,1290,600,47.5557,-122.28,1440,5378,8894,6818,1890,54,54
4,2,1800,5465,1,0,0,3,7,900,900,47.561,-122.272,1400,5400,7265,6800,1800,77,77
2,1,1190,3400,1,0,0,4,7,990,200,47.5539,-122.268,1180,4000,4590,5180,1190,102,102
2,1,1000,3700,1,0,0,3,6,800,200,47.552,-122.29,1270,5000,4700,6270,1000,90,90
4,2.75,1640,3000,1,0,0,3,7,1000,640,47.5625,-122.283,1150,4545,4640,5695,1640,35,35
4,2,1540,5110,1,0,0,3,7,1540,0,47.5164,-122.268,1540,5110,6650,6650,1540,62,62
3,1,960,5030,1,0,0,3,7,960,0,47.5611,-122.28,1460,5400,5990,6860,960,64,64
6,3,3560,4290,1,0,0,4,7,1780,1780,47.5282,-122.269,3040,6000,7850,9040,3560,62,62
3,1,950,4000,1,0,0,3,7,780,170,47.5232,-122.284,1230,4000,4950,5230,950,70,70
3,1.5,1890,6183,1,0,0,3,7,1090,800,47.5396,-122.269,1750,6183,8073,7933,1890,52,52
2,1,810,4800,1,0,0,3,6,810,0,47.5614,-122.27,1040,4800,5610,5840,810,100,100
3,2.5,2230,7200,3,0,3,3,9,2230,0,47.558,-122.265,2230,7200,9430,9430,2230,23,23
3,1,1660,7650,1,0,0,3,7,1350,310,47.5576,-122.277,1750,5760,9310,7510,1660,109,109
3,3.5,2100,2479,2,0,0,3,9,1450,650,47.562,-122.292,1800,2457,4579,4257,2100,8,8
2,1,840,5087,1,0,0,3,7,840,0,47.5557,-122.278,1590,5087,5927,6677,840,94,94
2,1,690,6000,1,0,0,3,6,690,0,47.5621,-122.283,840,3030,6690,3870,690,70,70
2,1.75,590,6138,1,0,0,2,5,590,0,47.545,-122.278,1360,7112,6728,8472,590,72,72
2,1.75,1830,7200,1,0,2,4,7,1070,760,47.5592,-122.273,1570,6000,9030,7570,1830,70,70
3,2.5,1300,3612,2,0,0,3,7,1300,0,47.5328,-122.282,1390,2943,4912,4333,1300,14,14
4,3,2240,5580,2,0,0,5,7,1830,410,47.5598,-122.27,1530,4800,7820,6330,2240,70,70
4,2,2320,7400,1,0,0,5,7,1620,700,47.5558,-122.269,1740,4000,9720,5740,2320,106,106
4,2.5,1470,1612,2,0,0,3,7,980,490,47.5275,-122.271,1460,5027,3082,6487,1470,16,16
2,1,900,6400,1,0,0,2,6,900,0,47.5287,-122.281,1350,6405,7300,7755,900,79,79
1,2,1070,675,2,0,0,3,8,880,190,47.5574,-122.284,1220,788,1745,2008,1070,12,12
5,3.5,3990,5000,2,0,0,3,8,2910,1080,47.54,-122.27,1310,5000,8990,6310,3990,15,15
2,1,1390,5346,1,0,0,5,7,960,430,47.5567,-122.279,1450,5040,6736,6490,1390,111,111
2,1,800,3090,1,0,0,4,6,800,0,47.5518,-122.277,1400,3090,3890,4490,800,94,94
4,1,1480,6500,1,0,0,4,7,1480,0,47.5282,-122.267,2380,6000,7980,8380,1480,105,105
3,1,2020,4120,1,0,0,4,7,1520,500,47.5514,-122.271,1200,4635,6140,5835,2020,90,90
3,1.5,2390,4600,2,0,0,3,8,1750,640,47.5383,-122.268,1690,5220,6990,6910,2390,99,20
5,2.75,2060,8906,1,0,0,4,7,1220,840,47.5358,-122.289,1840,8906,10966,10746,2060,41,41
2,1,1110,6000,1,0,0,3,7,1010,100,47.5632,-122.282,1410,3500,7110,4910,1110,68,68
2,1,1080,6250,1,0,2,4,7,1080,0,47.5128,-122.251,2100,6875,7330,8975,1080,77,46
2,2.5,1000,1092,2,0,0,3,7,990,10,47.5419,-122.271,1330,1466,2092,2796,1000,15,15
2,1,980,3915,1,0,0,4,7,980,0,47.5589,-122.29,1425,1576,4895,3001,980,100,100
5,2.5,3150,5150,2,0,0,5,8,1870,1280,47.5506,-122.269,1550,5150,8300,6700,3150,112,10
2,1,970,5600,1,0,0,3,6,970,0,47.5297,-122.277,1020,5600,6570,6620,970,68,68
5,1.75,1580,5292,1,0,0,3,6,980,600,47.5677,-122.29,1600,2976,6872,4576,1580,106,106
4,1,1060,7200,1,0,1,3,6,880,180,47.5591,-122.268,1910,7200,8260,9110,1060,94,94
3,1,920,4429,1,0,0,3,7,920,0,47.5369,-122.291,1320,7860,5349,9180,920,67,67
3,2,2110,5150,1,0,0,5,6,1080,1030,47.5521,-122.271,1170,5107,7260,6277,2110,100,100
2,2.5,1730,1037,3,0,0,3,8,1730,0,47.5594,-122.285,1280,1026,2767,2306,1730,11,11
3,2,2010,4320,2,0,2,3,9,2010,0,47.5153,-122.256,1640,5225,6330,6865,2010,20,20
4,2.75,2670,6780,2,0,3,5,8,1630,1040,47.5131,-122.256,2400,5989,9450,8389,2670,111,111
3,2.5,1280,5040,2,0,0,4,7,1280,0,47.5611,-122.276,1500,5040,6320,6540,1280,34,34
3,1,1150,3090,1,0,0,3,6,1150,0,47.5506,-122.276,1150,5664,4240,6814,1150,109,109
3,1.75,2080,6554,1,0,0,3,7,1040,1040,47.5135,-122.257,1230,5650,8634,6880,2080,69,69
2,1,890,6000,1,0,0,3,6,890,0,47.5437,-122.281,1090,5900,6890,6990,890,78,78
4,3,1820,3120,1,0,0,3,7,1000,820,47.5468,-122.274,1600,5001,4940,6601,1820,22,22
3,3.25,1400,1343,2,0,0,3,7,1160,240,47.5483,-122.277,1400,1326,2743,2726,1400,14,14
3,1.5,1550,8000,1,0,0,3,6,1330,220,47.5536,-122.286,1150,5150,9550,6300,1550,39,39
3,2.5,1390,2450,2,0,0,3,7,1390,0,47.5298,-122.269,1390,2450,3840,3840,1390,10,10
5,3.75,2980,4635,3,0,0,3,8,2980,0,47.5508,-122.268,1100,5150,7615,6250,2980,22,22
5,2.75,1650,5453,1,0,0,3,7,1650,0,47.5293,-122.285,1670,5885,7103,7555,1650,49,49
5,3.5,2420,4670,2,0,0,3,7,2420,0,47.5241,-122.285,1430,4468,7090,5898,2420,6,6
5,3.25,2590,6180,1,0,0,3,7,1330,1260,47.551,-122.272,1560,6180,8770,7740,2590,59,59
4,2.75,2500,5257,2,0,0,3,8,2500,0,47.5293,-122.287,1660,5970,7757,7630,2500,53,53
3,1.75,1760,5355,1,0,0,3,7,1160,600,47.5368,-122.267,1790,6225,7115,8015,1760,63,63
2,2.5,1390,1821,2,0,0,3,7,1180,210,47.5537,-122.282,1350,1821,3211,3171,1390,12,12
3,1,1560,5225,1,0,0,3,7,1260,300,47.5554,-122.279,1560,5322,6785,6882,1560,92,92
3,1.5,1390,2153,2,0,0,3,7,1390,0,47.5506,-122.29,1100,2617,3543,3717,1390,18,18
3,1,1010,3060,1,0,0,3,6,1010,0,47.5657,-122.285,1330,4590,4070,5920,1010,115,115
5,2.5,3750,91681,2,1,4,3,10,3750,0,47.5379,-122.264,3540,24293,95431,27833,3750,94,94
3,1.75,1540,6273,1,0,0,4,6,770,770,47.5305,-122.277,1140,5512,7813,6652,1540,68,68
2,1,920,5250,1,0,0,4,6,920,0,47.5177,-122.266,1210,5250,6170,6460,920,113,113
2,1.5,1110,986,2,0,0,3,7,950,160,47.5427,-122.272,1110,3515,2096,4625,1110,10,10
3,3,1820,1641,3,0,0,3,8,1540,280,47.6482,-122.358,1720,1501,3461,3221,1820,13,13
3,3.25,1290,1230,2,0,2,3,9,1090,200,47.6367,-122.37,1710,1797,2520,3507,1290,11,11
3,2.5,1800,4763,2,0,0,3,7,1240,560,47.646,-122.362,1790,4763,6563,6553,1800,34,34
2,2.25,1460,1851,2,0,0,3,9,1180,280,47.6461,-122.362,1800,4269,3311,6069,1460,5,5
3,2.75,1430,1521,2,0,0,3,9,1130,300,47.6353,-122.371,1930,2700,2951,4630,1430,10,10
3,1.75,1800,5700,1,0,0,4,8,1000,800,47.6491,-122.367,1680,5350,7500,7030,1800,78,78
4,2.5,2440,5737,2,0,0,4,8,1700,740,47.6472,-122.367,2020,5543,8177,7563,2440,90,90
2,1,980,1179,2,0,0,3,8,980,0,47.6381,-122.375,1190,1600,2159,2790,980,9,9
4,3.25,2960,4296,2,0,0,3,9,2190,770,47.6526,-122.372,2150,6000,7256,8150,2960,12,12
3,2.5,1630,2640,2,0,0,5,8,1630,0,47.6452,-122.371,1630,3000,4270,4630,1630,100,100
3,1.5,1660,4800,2,0,0,3,8,1660,0,47.6352,-122.358,1690,4000,6460,5690,1660,112,112
2,1,980,3600,1,0,0,3,6,980,0,47.6366,-122.365,1690,3600,4580,5290,980,112,112
3,2.25,1620,4500,2,0,0,4,8,1620,0,47.643,-122.361,1210,4320,6120,5530,1620,93,93
3,3.25,1730,1229,2,0,2,3,9,1320,410,47.6374,-122.369,1710,1686,2959,3396,1730,11,11
3,1,1300,3600,2,0,0,3,7,1300,0,47.6345,-122.366,2510,4800,4900,7310,1300,119,119
2,1,1180,2160,1,0,1,3,7,940,240,47.6313,-122.368,2700,5400,3340,8100,1180,110,110
6,4.75,5540,7200,2,0,2,4,11,3950,1590,47.6361,-122.366,2930,7200,12740,10130,5540,110,110
4,1,1340,2006,1,0,0,3,7,1340,0,47.6357,-122.373,2040,3625,3346,5665,1340,88,88
3,2.5,1350,941,3,0,0,3,9,1350,0,47.6265,-122.364,1640,1369,2291,3009,1350,12,12
2,1,910,3600,1,0,0,4,7,910,0,47.6341,-122.361,1720,3600,4510,5320,910,110,110
3,1.75,1510,3600,1,0,0,5,8,1230,280,47.6387,-122.363,1300,3600,5110,4900,1510,109,109
3,2,1420,3600,1,0,0,4,7,1420,0,47.6367,-122.364,1250,3600,5020,4850,1420,115,115
3,2.5,1530,762,2,0,0,3,8,1050,480,47.642,-122.374,1610,1482,2292,3092,1530,12,12
6,3,2790,4550,2,0,0,4,8,2790,0,47.627,-122.361,2590,4550,7340,7140,2790,112,112
6,4.5,5480,10800,2,0,3,4,9,4430,1050,47.6307,-122.367,2970,7200,16280,10170,5480,20,20
2,2,1780,3810,1,0,0,3,7,980,800,47.6474,-122.362,1690,3810,5590,5500,1780,97,97
2,1,1390,3600,1,0,0,4,7,1010,380,47.6422,-122.36,1590,3600,4990,5190,1390,106,106
3,2.5,1700,1156,2,0,2,3,9,1320,380,47.6373,-122.369,1710,1686,2856,3396,1700,17,17
4,4.25,3650,5328,1,0,0,3,9,2330,1320,47.638,-122.362,1710,3600,8978,5310,3650,112,0
4,1.75,2010,3600,1,0,0,3,7,2010,0,47.6337,-122.371,2010,3600,5610,5610,2010,117,117
5,3.5,4460,2975,3,0,2,3,10,3280,1180,47.6313,-122.37,2490,4231,7435,6721,4460,4,4
5,1,1670,6400,1,0,0,3,8,1670,0,47.6542,-122.373,1910,2983,8070,4893,1670,100,100
4,2.25,2190,4080,2,0,0,3,8,1800,390,47.6425,-122.358,2100,4080,6270,6180,2190,101,101
4,2,2600,4800,1,0,2,3,8,1400,1200,47.637,-122.371,2050,3505,7400,5555,2600,66,66
2,2.5,1160,1458,2,0,0,3,8,1040,120,47.6384,-122.373,1650,2311,2618,3961,1160,7,7
4,2.75,2600,2750,1,0,0,3,7,1620,980,47.6413,-122.357,1960,3705,5350,5665,2600,83,83
3,3,2060,1850,2,0,0,3,8,1400,660,47.6543,-122.373,1910,2951,3910,4861,2060,12,12
2,1.5,1340,3600,1,0,0,3,7,1340,0,47.6358,-122.364,1340,3600,4940,4940,1340,116,116
5,3,4150,7500,2,0,4,5,11,3510,640,47.6303,-122.362,2250,4050,11650,6300,4150,110,110
5,2.5,2010,3600,1,0,0,3,6,1510,500,47.6522,-122.366,1780,3600,5610,5380,2010,107,107
3,1.75,1400,2003,1,0,0,4,8,700,700,47.6508,-122.368,1370,1281,3403,2651,1400,111,8
3,3.5,2760,4500,2,0,0,3,9,2120,640,47.6529,-122.372,1950,6000,7260,7950,2760,15,15
2,1.5,870,4800,1,0,0,3,7,870,0,47.6509,-122.37,2090,4800,5670,6890,870,95,95
4,3,2790,3600,2,0,0,3,8,1880,910,47.6362,-122.363,1360,3600,6390,4960,2790,114,1
2,1.5,830,1241,2,0,0,3,7,830,0,47.6363,-122.368,1610,2666,2071,4276,830,14,14
4,2.5,2520,2600,2,0,0,5,8,1670,850,47.6434,-122.358,2290,3600,5120,5890,2520,94,94
4,3,2120,3600,2,0,3,4,8,1830,290,47.6344,-122.369,2120,3600,5720,5720,2120,111,18
3,2.5,1410,1250,2,0,0,3,8,1140,270,47.6515,-122.375,1720,2825,2660,4545,1410,9,9
2,1,1100,2800,1,0,0,3,7,1100,0,47.6361,-122.371,1110,1673,3900,2783,1100,94,94
3,2.5,1680,1683,2,0,0,3,9,1120,560,47.6425,-122.374,1610,1618,3363,3228,1680,5,5
4,3.75,2690,4000,2,0,3,4,9,2120,570,47.6418,-122.372,2830,4000,6690,6830,2690,110,25
3,3.5,1370,1764,2,0,0,3,8,1180,190,47.6511,-122.368,1400,1398,3134,2798,1370,19,19
3,2.75,1710,3600,1,0,0,3,7,1590,120,47.642,-122.36,1710,3600,5310,5310,1710,110,110
2,2.5,2310,3313,2,0,0,3,9,2310,0,47.6318,-122.365,2700,5670,5623,8370,2310,13,13
4,2.75,2940,5400,1,0,2,5,8,1940,1000,47.6366,-122.369,1970,2008,8340,3978,2940,109,109
2,1.5,1110,957,2,0,0,3,8,930,180,47.6319,-122.362,1680,1104,2067,2784,1110,14,14
2,1.75,1230,3600,1,0,0,5,7,1230,0,47.6423,-122.361,1210,4500,4830,5710,1230,94,94
4,3,2420,4800,1,0,0,3,7,1520,900,47.6453,-122.358,1090,3800,7220,4890,2420,100,100
2,1,1180,6000,1,0,0,3,7,1180,0,47.6531,-122.373,1600,6000,7180,7600,1180,109,109
3,2.5,2660,1973,3,0,3,3,9,1870,790,47.6264,-122.364,1640,1369,4633,3009,2660,12,12
4,1.5,2480,6383,1,0,0,3,7,1380,1100,47.6445,-122.374,1440,6000,8863,7440,2480,73,73
3,3,1720,954,3,0,0,3,8,1460,260,47.648,-122.358,1720,1294,2674,3014,1720,13,13
2,1,840,3400,1,0,2,4,7,840,0,47.6403,-122.372,2000,4000,4240,6000,840,95,95
3,1.75,1470,873,3,0,0,3,10,1470,0,47.6256,-122.362,1410,967,2343,2377,1470,10,10
3,1,1260,3230,1,0,0,3,7,1260,0,47.644,-122.369,1700,3500,4490,5200,1260,112,112
4,2.5,3200,3600,3,0,3,4,9,2600,600,47.632,-122.369,2490,4080,6800,6570,3200,22,22
3,2.5,1580,1487,3,0,1,3,9,1580,0,47.6276,-122.359,1610,1297,3067,2907,1580,10,10
3,2,2520,5400,1,0,0,4,8,1410,1110,47.6365,-122.361,1960,5400,7920,7360,2520,113,113
3,1.5,2310,3360,1,0,0,3,8,1790,520,47.6431,-122.359,1930,4320,5670,6250,2310,93,93
3,2.5,2860,4500,2,0,2,3,8,1980,880,47.6463,-122.371,2310,4500,7360,6810,2860,104,104
2,2.75,1910,1369,3,0,0,3,9,1910,0,47.6544,-122.373,1910,1879,3279,3789,1910,17,17
5,3.25,3410,9088,2,0,3,3,9,2760,650,47.6285,-122.361,3540,7100,12498,10640,3410,107,107
3,1,2280,4600,1,0,2,3,8,1250,1030,47.6378,-122.372,1910,4000,6880,5910,2280,83,83
3,1,1010,6000,1,0,0,3,7,1010,0,47.6438,-122.357,1960,4000,7010,5960,1010,100,37
3,1.5,2140,3600,2,0,0,3,9,1900,240,47.6337,-122.365,2020,4800,5740,6820,2140,94,94
6,4.5,4230,6420,2,0,3,4,8,2360,1870,47.6301,-122.369,3450,4085,10650,7535,4230,103,103
4,2,1590,5400,1,0,2,3,7,990,600,47.637,-122.367,2190,4800,6990,6990,1590,119,119
3,2.5,2660,1967,3,0,3,3,9,1870,790,47.6264,-122.363,1640,1369,4627,3009,2660,12,12
4,1.75,2130,5080,1,0,0,3,8,2130,0,47.6427,-122.363,1900,5080,7210,6980,2130,105,21
4,2.5,3470,4160,2,0,0,3,9,2480,990,47.63,-122.363,2280,5440,7630,7720,3470,92,92
4,2.5,2730,4800,1,0,0,5,8,2230,500,47.642,-122.358,2190,4200,7530,6390,2730,110,110
6,2,2150,4505,1,0,0,3,7,1270,880,47.6514,-122.369,1740,4505,6655,6245,2150,67,67
3,1.75,2060,3600,1,0,0,3,7,1180,880,47.6389,-122.371,1730,2475,5660,4205,2060,114,29
3,2.75,2520,5401,1,0,0,4,7,1360,1160,47.6452,-122.373,1800,5036,7921,6836,2520,73,73
3,2.5,1760,1472,3,0,0,3,8,1640,120,47.6473,-122.374,1760,5400,3232,7160,1760,13,13
3,1,1500,2400,1,0,0,5,7,1500,0,47.6333,-122.362,1780,3600,3900,5380,1500,119,119
5,4.25,3350,3600,2,0,0,3,10,2260,1090,47.6351,-122.364,1810,3600,6950,5410,3350,5,5
2,2.5,1680,975,3,0,0,3,9,1680,0,47.6321,-122.361,1680,977,2655,2657,1680,10,10
3,1.75,920,3600,1,0,0,4,6,820,100,47.6386,-122.365,1620,3600,4520,5220,920,115,115
3,3,2490,3600,2,0,3,4,8,1790,700,47.6313,-122.369,2490,3600,6090,6090,2490,108,108
3,2.5,1520,2208,2,0,0,3,8,1040,480,47.6419,-122.374,1610,1618,3728,3228,1520,12,12
3,2,1760,5488,1,0,0,3,7,1540,220,47.6479,-122.367,1760,5943,7248,7703,1760,92,92
5,3.5,3520,5400,2,0,0,3,9,2400,1120,47.6364,-122.363,1360,3600,8920,4960,3520,11,11
3,1.5,2540,2700,2,0,0,4,8,1630,910,47.637,-122.361,2520,5400,5240,7920,2540,97,97
3,2.5,1580,991,3,0,0,3,9,1580,0,47.6276,-122.359,1610,1297,2571,2907,1580,10,10
3,2.5,2160,1250,3,0,0,3,8,1830,330,47.6515,-122.375,1870,2825,3410,4695,2160,9,9
3,2.5,2370,6840,2,0,0,3,9,2370,0,47.6503,-122.366,1590,4400,9210,5990,2370,32,32
2,2.5,1280,1051,2,0,0,3,8,1080,200,47.6273,-122.359,1580,1279,2331,2859,1280,10,10
4,2,1630,1724,1,0,0,3,6,1030,600,47.6472,-122.362,1780,3810,3354,5590,1630,104,44
3,1.75,2140,5808,1,0,1,3,7,1070,1070,47.6435,-122.373,1930,5808,7948,7738,2140,72,72
2,1.5,1110,3600,1,0,0,5,7,1110,0,47.6382,-122.359,1670,5400,4710,7070,1110,115,115
4,2.25,2280,6660,1,0,2,3,8,1960,320,47.6503,-122.368,1720,5336,8940,7056,2280,79,30
4,3.25,3620,5131,2,0,3,4,11,2350,1270,47.6499,-122.37,2550,5174,8751,7724,3620,92,92
2,1,1540,6872,1,0,0,4,7,820,720,47.6454,-122.373,1420,5538,8412,6958,1540,73,73
4,2,1980,7200,2,0,3,3,8,1700,280,47.6318,-122.369,2490,4200,9180,6690,1980,109,109
3,1,1400,2250,1,0,0,3,7,1400,0,47.6373,-122.358,1630,3600,3650,5230,1400,110,110
3,2,1740,3600,1,0,0,5,7,990,750,47.6448,-122.358,1250,3600,5340,4850,1740,96,96
3,3,3030,5156,1,0,0,4,9,2080,950,47.647,-122.369,1910,5720,8186,7630,3030,90,90
3,2,1750,2640,1,0,0,3,8,1010,740,47.6419,-122.368,1750,4560,4390,6310,1750,105,9
2,2.25,1010,1107,2,0,0,3,8,710,300,47.6363,-122.371,1140,1531,2117,2671,1010,13,13
3,3.25,2200,2400,2,0,0,3,8,1740,460,47.6325,-122.371,2200,3600,4600,5800,2200,31,31
2,1,1380,1800,2,0,0,3,7,1080,300,47.6416,-122.361,1600,3600,3180,5200,1380,65,65
5,1,2010,5210,1,0,0,3,9,1890,120,47.6501,-122.37,2330,5000,7220,7330,2010,92,92
3,3,1800,5000,1,0,2,3,8,1500,300,47.6475,-122.371,1670,5000,6800,6670,1800,90,90
3,1.5,1830,4000,1,0,0,4,7,1350,480,47.6453,-122.371,1570,3672,5830,5242,1830,109,109
4,2.5,2440,3600,2,0,0,4,8,2440,0,47.6298,-122.362,2440,5440,6040,7880,2440,117,117
6,4.5,3830,4800,3,0,0,3,9,3050,780,47.6404,-122.361,1990,4800,8630,6790,3830,100,10
3,1.5,1940,2885,1,0,2,3,8,1940,0,47.6308,-122.369,2550,3600,4825,6150,1940,119,119
6,3.5,3670,3959,2,0,0,3,10,2410,1260,47.6356,-122.373,2060,3625,7629,5685,3670,11,11
1,1,590,833,1,0,0,4,7,590,0,47.6082,-122.299,780,1617,1423,2397,590,93,93
3,2,1570,7000,2,0,2,4,8,1050,520,47.6061,-122.286,1990,6675,8570,8665,1570,48,48
4,1.5,2120,5000,2,0,0,4,8,2120,0,47.6024,-122.296,1830,5000,7120,6830,2120,119,119
2,1.75,1850,2530,2,0,0,4,7,1850,0,47.6106,-122.31,1500,1795,4380,3295,1850,116,116
2,1,1080,3600,1,0,0,3,7,1080,0,47.6078,-122.291,2230,4500,4680,6730,1080,97,97
4,2.75,2020,2750,1,0,0,3,8,1010,1010,47.6053,-122.291,1840,4000,4770,5840,2020,102,0
3,2.5,1860,1290,2,0,0,3,9,1240,620,47.6179,-122.301,1710,1525,3150,3235,1860,9,9
4,1.75,1430,4096,2,0,0,3,7,1430,0,47.604,-122.306,1640,3377,5526,5017,1430,119,119
3,3.5,1810,1846,2,0,0,4,8,1440,370,47.607,-122.305,1480,3600,3656,5080,1810,10,10
4,2.25,1930,3500,1,0,0,5,8,1540,390,47.6167,-122.29,1800,5000,5430,6800,1930,103,103
6,2,3560,5120,2,0,2,3,9,3560,0,47.6056,-122.311,2130,5120,8680,7250,3560,119,119
3,3,2880,3750,2,0,0,3,9,2220,660,47.6155,-122.29,1910,4000,6630,5910,2880,110,24
4,2,1990,4740,1,0,0,3,7,1080,910,47.6112,-122.303,1560,2370,6730,3930,1990,93,93
4,3.75,3450,8395,2,0,4,4,10,2640,810,47.6134,-122.282,3180,5183,11845,8363,3450,26,26
4,2.75,3010,3400,2,0,2,3,9,2240,770,47.6142,-122.284,1940,5080,6410,7020,3010,96,6
3,2.25,2360,5504,2,0,0,4,8,2080,280,47.617,-122.288,2840,5470,7864,8310,2360,106,106
4,1.5,2080,4400,1,0,0,3,7,2080,0,47.606,-122.299,1680,4400,6480,6080,2080,94,94
4,2,1480,6324,1,0,0,3,7,1480,0,47.6147,-122.302,1480,3600,7804,5080,1480,76,76
2,1.5,1530,1012,2,0,0,3,8,1200,330,47.602,-122.306,1530,1425,2542,2955,1530,14,14
3,1,1560,4500,1,0,0,3,7,1560,0,47.6118,-122.306,1660,4500,6060,6160,1560,116,116
2,1,1040,5120,1,0,0,3,7,1040,0,47.6048,-122.312,1250,4000,6160,5250,1040,118,118
3,1.75,1300,2446,1,0,3,3,8,880,420,47.6071,-122.285,2440,5051,3746,7491,1300,58,58
2,1.5,830,1276,2,0,0,3,7,830,0,47.6175,-122.297,1540,1484,2106,3024,830,14,14
2,2.25,1040,1516,2,0,0,3,8,1040,0,47.6037,-122.307,1560,1920,2556,3480,1040,11,11
3,2.5,1620,2640,2,0,0,4,7,1620,0,47.6036,-122.305,1370,3840,4260,5210,1620,119,21
2,1.5,1300,1676,1,0,2,3,7,1300,0,47.6133,-122.308,1260,1740,2976,3000,1300,76,76
3,1.5,2120,4370,1,0,0,3,8,2120,0,47.606,-122.307,1960,5120,6490,7080,2120,115,115
3,1,1530,2370,2,0,0,3,8,1530,0,47.6108,-122.303,1310,2370,3900,3680,1530,118,118
3,2.25,1590,929,2,0,0,3,9,1060,530,47.6172,-122.31,1510,1193,2519,2703,1590,5,5
3,1.25,2400,6653,3,0,2,3,11,2400,0,47.6019,-122.29,1910,6653,9053,8563,2400,27,27
3,2,1460,3600,2,0,0,3,7,1460,0,47.6123,-122.314,1590,1210,5060,2800,1460,117,117
2,1.75,1340,1368,2,0,0,3,7,1060,280,47.618,-122.311,2480,1707,2708,4187,1340,13,13
3,3.25,1720,1587,2,0,2,3,9,1410,310,47.6187,-122.299,1490,1620,3307,3110,1720,15,15
3,2,1880,3048,2,0,0,4,7,1880,0,47.6031,-122.303,1680,3600,4928,5280,1880,117,117
3,1.75,1380,3402,1,0,0,3,7,1380,0,47.6109,-122.302,1500,5496,4782,6996,1380,119,14
5,2.5,2640,4400,1,0,0,5,7,1840,800,47.605,-122.3,1720,4400,7040,6120,2640,94,94
3,2,1410,2700,2,0,0,4,7,1410,0,47.6029,-122.302,1750,4000,4110,5750,1410,117,117
2,1,790,6600,1,0,0,3,6,790,0,47.6149,-122.293,1520,4400,7390,5920,790,70,70
1,1,860,4800,1,0,0,3,6,860,0,47.6146,-122.299,1380,4800,5660,6180,860,112,112
2,3,2210,3917,2,0,0,3,10,1500,710,47.6166,-122.291,1720,3933,6127,5653,2210,11,11
5,2,2280,3600,2,0,0,3,7,2280,0,47.6056,-122.305,1740,1800,5880,3540,2280,27,27
2,2.25,1540,965,3,0,0,3,9,1540,0,47.6181,-122.318,1410,964,2505,2374,1540,12,12
3,2.5,2340,4200,1,0,0,3,7,1540,800,47.6033,-122.303,1590,4200,6540,5790,2340,113,113
3,3.5,1630,1329,2,0,0,3,9,1360,270,47.6159,-122.306,1580,1319,2959,2899,1630,19,19
3,1,1280,3200,1,0,0,3,7,1280,0,47.6029,-122.307,1320,1676,4480,2996,1280,116,116
3,2,2005,7000,1,0,0,3,7,1605,400,47.6039,-122.298,1750,4500,9005,6250,2005,39,39
3,1.75,2010,4905,1,0,0,5,7,1230,780,47.6105,-122.309,2210,1834,6915,4044,2010,107,107
1,1,790,2400,1,0,0,3,7,790,0,47.6178,-122.299,1580,2566,3190,4146,790,101,101
5,2,2000,3000,1,0,0,3,6,1200,800,47.6028,-122.298,1330,4000,5000,5330,2000,88,88
3,3,1330,1379,2,0,0,4,8,1120,210,47.6126,-122.313,1810,1770,2709,3580,1330,14,14
3,1.5,1280,1920,1,0,0,3,7,1280,0,47.6117,-122.301,1280,3150,3200,4430,1280,114,25
4,2.25,3470,8000,1,0,1,3,9,2360,1110,47.6149,-122.287,3010,8000,11470,11010,3470,113,12
3,3.25,1530,1565,2,0,0,3,8,1280,250,47.6179,-122.312,1530,1381,3095,2911,1530,14,14
2,1.5,1370,1221,2,0,0,3,8,1080,290,47.6039,-122.307,1560,2081,2591,3641,1370,11,11
4,2,1240,3000,1,0,0,3,7,1040,200,47.6076,-122.298,1480,3500,4240,4980,1240,111,111
6,2,3080,5500,2,0,0,1,7,3080,0,47.6031,-122.296,1830,5000,8580,6830,3080,119,119
3,1.75,2480,4000,1,0,0,3,8,1240,1240,47.615,-122.288,2450,4000,6480,6450,2480,71,0
4,2,1930,3240,1,0,0,4,7,1930,0,47.6156,-122.299,1480,3600,5170,5080,1930,108,108
3,1.5,1490,4400,1,0,0,4,7,1490,0,47.6113,-122.292,1560,4400,5890,5960,1490,113,113
3,2,1180,1800,2,0,2,3,8,1180,0,47.6168,-122.301,1500,1948,2980,3448,1180,25,25
2,1.5,960,1829,2,0,0,3,7,960,0,47.6032,-122.308,1470,1829,2789,3299,960,14,14
3,2,1860,3600,1,0,0,3,7,1110,750,47.6102,-122.296,1680,3695,5460,5375,1860,104,104
2,2.25,1530,1324,2,0,0,3,8,1280,250,47.6032,-122.311,1410,1689,2854,3099,1530,9,9
3,2,1540,3600,1,0,0,3,7,890,650,47.6103,-122.296,1540,3600,5140,5140,1540,25,25
4,2.25,2170,4080,2,0,0,3,7,1920,250,47.6124,-122.293,1890,4400,6250,6290,2170,39,39
3,2,1280,960,2,0,0,3,9,1040,240,47.602,-122.311,1280,1173,2240,2453,1280,5,5
3,3.5,1710,2096,2,0,0,3,8,1290,420,47.6055,-122.305,1630,1543,3806,3173,1710,11,11
7,2.5,2580,5750,1,0,0,4,7,1880,700,47.6025,-122.294,2280,5750,8330,8030,2580,118,118
3,2,1380,3600,3,0,0,3,8,1380,0,47.6074,-122.305,1480,3600,4980,5080,1380,4,4
2,1,1570,4400,1,0,0,4,8,1570,0,47.6112,-122.293,1850,4400,5970,6250,1570,105,105
3,1,950,4250,1,0,0,5,6,950,0,47.609,-122.307,2130,5120,5200,7250,950,71,71
4,2.75,3100,3773,2,0,0,3,8,2000,1100,47.6158,-122.291,2130,3777,6873,5907,3100,100,18
4,1,1630,2566,1,0,0,3,7,1630,0,47.6183,-122.3,1220,2314,4196,3534,1630,98,98
4,3.25,3640,3604,2,0,2,5,9,1960,1680,47.6145,-122.284,1940,4600,7244,6540,3640,106,106
6,1.75,1840,2774,1,0,0,3,7,1060,780,47.6041,-122.31,1680,4292,4614,5972,1840,119,119
3,3.25,1720,1977,2,0,0,3,8,1360,360,47.6127,-122.299,1720,3420,3697,5140,1720,12,12
3,1,1600,1950,2,0,0,2,7,1600,0,47.6028,-122.312,1310,1138,3550,2448,1600,113,113
3,1,1740,4400,1,0,0,3,7,1740,0,47.6059,-122.3,1720,4400,6140,6120,1740,95,95
5,1,2550,4623,2,0,0,4,9,2550,0,47.6092,-122.294,1570,3875,7173,5445,2550,114,114
4,2,1810,4400,2,0,0,3,8,1700,110,47.6132,-122.292,1470,4400,6210,5870,1810,110,110
3,2.75,2220,4000,2,0,0,3,8,1700,520,47.617,-122.291,1800,4000,6220,5800,2220,105,14
4,2,2280,6010,1,0,0,3,7,1140,1140,47.6034,-122.289,2240,6200,8290,8440,2280,119,119
4,2.75,2610,4400,1,0,0,5,8,1260,1350,47.6158,-122.293,1770,4400,7010,6170,2610,99,99
3,2.5,1700,4105,2,0,0,3,8,1700,0,47.6078,-122.292,1880,3665,5805,5545,1700,27,27
3,2.5,1350,3068,2,0,0,3,7,1350,0,47.6099,-122.293,1900,4000,4418,5900,1350,28,28
3,2,1510,3817,1,0,0,3,8,1510,0,47.6088,-122.294,1510,3817,5327,5327,1510,114,21
3,2.5,1690,1479,3,0,0,3,8,1420,270,47.6022,-122.311,1280,1253,3169,2533,1690,14,14
3,3,1550,1608,2,0,0,3,8,1280,270,47.6042,-122.303,1940,1883,3158,3823,1550,18,18
4,1.5,1100,3300,1,0,0,1,7,1100,0,47.6033,-122.295,2020,4000,4400,6020,1100,100,100
5,2.5,3100,5374,2,0,0,4,9,3100,0,47.6154,-122.283,2180,5800,8474,7980,3100,113,113
3,2,2090,4190,1,0,0,4,8,1490,600,47.6178,-122.284,2090,6270,6280,8360,2090,89,89
2,2.5,1170,1394,2,0,0,3,8,1170,0,47.6131,-122.297,1250,3136,2564,4386,1170,18,18
4,1,2210,4366,2,0,0,3,8,2210,0,47.6105,-122.309,1740,1745,6576,3485,2210,118,118
4,2,1910,2874,1,0,0,3,7,1060,850,47.6101,-122.295,1520,2874,4784,4394,1910,109,109
4,2.25,2240,5000,2,0,0,3,8,1770,470,47.6027,-122.295,2120,5000,7240,7120,2240,119,1
3,2,2600,6600,2,0,4,3,10,1930,670,47.6055,-122.285,2670,6270,9200,8940,2600,49,1
3,2,2330,3600,1,0,0,4,7,1580,750,47.6025,-122.303,1750,3600,5930,5350,2330,119,119
2,1,940,5120,1,0,0,3,7,940,0,47.6073,-122.308,1300,5120,6060,6420,940,110,110
2,1,650,5400,1,0,0,3,6,650,0,47.6185,-122.295,1310,4906,6050,6216,650,69,69
5,1,1750,3861,1,0,0,3,7,1750,0,47.6075,-122.295,1700,4255,5611,5955,1750,116,116
3,2,1560,1156,3,0,0,3,8,1560,0,47.605,-122.304,1560,1728,2716,3288,1560,5,5
2,2,1130,1148,2,0,0,3,9,800,330,47.6023,-122.314,1350,1201,2278,2551,1130,12,12
3,3.5,1740,1975,2,0,3,3,8,1310,430,47.6085,-122.311,1740,1975,3715,3715,1740,21,21
3,2.25,1620,1062,3,0,0,3,8,1620,0,47.6051,-122.304,1560,1728,2682,3288,1620,5,5
3,1,1280,3870,1,0,0,3,7,640,640,47.6163,-122.294,1280,4800,5150,6080,1280,74,74
4,2,1300,7200,1,0,0,3,7,1300,0,47.6169,-122.294,1540,6600,8500,8140,1300,61,61
3,3,2260,2400,2,0,0,3,7,2260,0,47.6094,-122.31,1320,2790,4660,4110,2260,110,42
5,2.5,2760,4000,1,0,0,3,8,1730,1030,47.6074,-122.299,1680,4000,6760,5680,2760,93,0
4,1,1270,3630,1,0,0,3,7,1270,0,47.6135,-122.307,1420,4848,4900,6268,1270,116,116
3,2.5,1380,1021,2,0,0,3,8,1160,220,47.6148,-122.309,1440,1021,2401,2461,1380,11,11
4,2.25,1490,956,2,0,0,3,7,1020,470,47.6184,-122.301,1510,1350,2446,2860,1490,14,14
3,3,2260,1825,2,0,0,3,8,1660,600,47.6108,-122.308,2260,1834,4085,4094,2260,17,17
2,1,750,2020,1,0,0,3,7,750,0,47.6175,-122.301,1630,2383,2770,4013,750,111,20
3,3,3790,5001,2,0,0,3,10,2810,980,47.6035,-122.285,2500,6286,8791,8786,3790,30,30
4,3,1790,3600,1,0,0,3,8,1790,0,47.6117,-122.313,1770,3119,5390,4889,1790,118,118
4,2.75,1750,5080,1,0,0,3,8,1750,0,47.6143,-122.305,1700,4572,6830,6272,1750,116,116
3,2.5,1750,1381,3,0,0,3,8,1750,0,47.6021,-122.294,1940,4800,3131,6740,1750,11,11
6,1.75,2920,5000,2,0,0,4,9,2780,140,47.6024,-122.295,2020,5000,7920,7020,2920,111,111
3,1.75,1720,5000,1,0,0,3,9,1720,0,47.6157,-122.29,2120,4188,6720,6308,1720,65,0
2,1.75,1200,3136,1,0,0,3,7,800,400,47.6132,-122.297,1330,3164,4336,4494,1200,115,10
3,1.5,1300,1435,2,0,0,3,8,1120,180,47.6114,-122.31,1320,1652,2735,2972,1300,12,12
2,2.25,1180,2090,2,0,0,3,7,1180,0,47.6032,-122.31,1550,2812,3270,4362,1180,15,15
2,1.5,880,2400,1,0,0,3,7,880,0,47.6144,-122.295,1220,4440,3280,5660,880,90,90
4,2.5,2390,5071,2,0,0,3,9,1760,630,47.6144,-122.283,1940,5071,7461,7011,2390,31,31
4,2,1220,7489,2,0,0,3,7,1220,0,47.6133,-122.306,1220,3750,8709,4970,1220,116,116
2,1.5,1190,1361,2,0,0,3,8,1190,0,47.6161,-122.302,1280,3360,2551,4640,1190,12,12
2,2,1050,1173,2,0,0,3,8,720,330,47.6181,-122.302,1340,1317,2223,2657,1050,15,15
2,1,880,1165,2,0,0,3,8,880,0,47.6192,-122.297,1640,3825,2045,5465,880,14,14
2,1,1000,5120,1,0,0,3,6,1000,0,47.6088,-122.307,1940,4300,6120,6240,1000,117,117
3,2.75,1720,6720,1,0,0,4,7,1270,450,47.6138,-122.298,1690,3248,8440,4938,1720,72,72
5,3.25,2400,3118,2,0,0,4,7,1780,620,47.6094,-122.291,2100,3941,5518,6041,2400,91,91
2,2.5,1050,1029,2,0,0,3,8,950,100,47.6018,-122.299,1350,3600,2079,4950,1050,12,12
5,1,2480,4400,1,0,0,3,7,1640,840,47.6046,-122.3,1940,4400,6880,6340,2480,100,100
3,2.5,2010,2263,2,0,0,3,8,1340,670,47.6088,-122.311,1500,2670,4273,4170,2010,5,5
3,2.25,1450,1619,2,0,0,3,8,1140,310,47.6076,-122.304,1580,3472,3069,5052,1450,13,13
3,2.5,2110,1339,2,0,0,3,8,1410,700,47.6088,-122.311,1630,2670,3449,4300,2110,5,5
3,2.5,1590,4094,2,0,0,3,7,1590,0,47.61,-122.293,1940,3924,5684,5864,1590,28,28
3,2,1770,1800,3,0,0,3,8,1770,0,47.6102,-122.314,1890,3200,3570,5090,1770,20,20
3,1.75,1680,2400,1,0,0,5,7,870,810,47.6155,-122.3,1440,3600,4080,5040,1680,97,97
5,2,1510,3000,2,0,0,3,6,1510,0,47.6029,-122.304,1610,3600,4510,5210,1510,36,36
3,1.75,1370,2800,1,0,0,5,7,800,570,47.6157,-122.291,2270,3773,4170,6043,1370,37,37
4,3,1670,1189,3,0,0,3,8,1427,243,47.6182,-122.302,1700,1401,2859,3101,1670,19,19
1,1,1310,8667,1,0,0,1,6,1310,0,47.6059,-122.313,1130,4800,9977,5930,1310,101,101
5,1,3020,4800,2,0,0,3,7,3020,0,47.6025,-122.313,1350,1307,7820,2657,3020,118,118
3,1.75,1740,4400,1,0,0,3,8,1740,0,47.6115,-122.292,1740,4400,6140,6140,1740,116,116
3,3.25,2660,4000,2,0,0,3,9,2170,490,47.6186,-122.288,2660,4000,6660,6660,2660,16,16
2,2,1405,1073,2,0,0,3,8,1140,265,47.612,-122.295,1405,3000,2478,4405,1405,12,12
3,2.25,1760,1146,3,0,0,3,9,1760,0,47.6073,-122.304,1346,3472,2906,4818,1760,5,5
4,3.25,2190,4265,2,0,0,3,9,1540,650,47.6178,-122.29,1730,4265,6455,5995,2190,4,4
2,1,680,4800,1,0,0,3,6,680,0,47.6084,-122.304,1610,4800,5480,6410,680,102,102
4,2.25,2820,5000,1,0,2,4,9,1800,1020,47.6097,-122.287,2880,6000,7820,8880,2820,93,93
2,1,1050,2542,1,0,0,3,7,880,170,47.6172,-122.298,1620,1809,3592,3429,1050,115,115
3,2.25,1530,1245,2,0,0,3,9,1050,480,47.6018,-122.297,1530,2307,2775,3837,1530,5,5
1,1,550,1279,2,0,0,3,7,550,0,47.616,-122.314,1460,1385,1829,2845,550,11,11
4,1,1970,4740,1,0,0,3,7,1670,300,47.6136,-122.303,1510,4740,6710,6250,1970,115,10
3,2.5,2040,4559,2,0,0,3,9,2040,0,47.6156,-122.295,1500,4500,6599,6000,2040,21,21
3,1.5,1970,3400,1,0,0,4,8,1420,550,47.6163,-122.292,1940,4000,5370,5940,1970,90,90
3,1,1040,4000,1,0,0,3,7,1040,0,47.6178,-122.292,1170,4000,5040,5170,1040,69,69
4,2,1930,3976,1,0,0,4,8,1930,0,47.6117,-122.297,1470,4080,5906,5550,1930,105,105
3,1,1610,7680,1,0,0,3,6,900,710,47.6038,-122.303,1940,2880,9290,4820,1610,63,63
2,1.5,830,1077,2,0,0,3,7,830,0,47.6058,-122.319,830,1366,1907,2196,830,13,13
2,1,770,3325,1,0,0,3,7,770,0,47.6102,-122.299,960,4800,4095,5760,770,101,101
4,1.5,2340,5000,2,0,0,3,8,2100,240,47.6065,-122.291,2320,5500,7340,7820,2340,107,107
3,2.25,1450,1445,2,0,0,3,7,980,470,47.6184,-122.301,1510,1370,2895,2880,1450,14,14
4,2.5,2710,4069,3,0,0,4,10,2710,0,47.604,-122.288,1810,3586,6779,5396,2710,29,29
4,3.25,2910,1880,2,0,3,5,9,1830,1080,47.616,-122.282,3100,8200,4790,11300,2910,105,105
2,1.5,1340,1286,2,0,0,3,8,1190,150,47.617,-122.309,1460,1245,2626,2705,1340,13,13
3,1,940,3000,1,0,0,3,7,940,0,47.6033,-122.3,1210,3500,3940,4710,940,116,116
2,2.25,1540,958,3,0,0,3,9,1540,0,47.6179,-122.318,1410,958,2498,2368,1540,12,12
3,3.5,1460,1021,2,0,0,3,8,1150,310,47.6169,-122.309,1460,1245,2481,2705,1460,13,13
8,5,2800,2580,2,0,0,3,8,1880,920,47.6086,-122.303,1800,2580,5380,4380,2800,22,22
5,3,3830,8480,2,0,1,5,9,2630,1200,47.6166,-122.287,3050,7556,12310,10606,3830,114,21
3,3.25,1540,704,3,0,0,3,9,1540,0,47.6177,-122.308,1540,1456,2244,2996,1540,8,8
3,1.75,1320,1014,3,0,0,3,9,1320,0,47.6047,-122.305,1380,1495,2334,2875,1320,4,4
4,3.5,2160,3600,2,0,0,3,8,1660,500,47.6103,-122.297,1230,3840,5760,5070,2160,21,21
4,2,2250,4200,1,0,0,3,7,1650,600,47.6136,-122.297,1200,3360,6450,4560,2250,110,110
3,1,1480,4200,1,0,0,3,7,1480,0,47.6147,-122.298,1460,3600,5680,5060,1480,94,94
4,1.75,1940,4800,1,0,0,5,7,1030,910,47.6054,-122.314,1450,4800,6740,6250,1940,97,97
3,3.25,2210,3600,2,0,0,3,8,1820,390,47.7031,-122.279,2010,6690,5810,8700,2210,24,24
4,1.5,1380,7800,1,0,0,3,7,1080,300,47.7093,-122.306,1770,7503,9180,9273,1380,91,91
2,1,930,7740,1,0,0,3,6,930,0,47.7091,-122.292,1250,7740,8670,8990,930,95,95
3,1,1170,6700,1,0,0,3,8,1170,0,47.7122,-122.29,2410,7620,7870,10030,1170,62,62
4,1.5,1940,8970,1,0,0,3,7,1270,670,47.7297,-122.326,1960,8470,10910,10430,1940,39,39
4,1.75,2220,6350,1,0,0,3,7,1110,1110,47.7136,-122.29,1950,8100,8570,10050,2220,60,60
3,2.5,1212,1174,3,0,0,3,7,1212,0,47.7145,-122.311,1256,1226,2386,2482,1212,15,15
5,2.75,3100,9825,2,0,2,4,8,3100,0,47.7188,-122.281,2120,8400,12925,10520,3100,69,32
2,1,1430,12092,1,0,0,4,7,1430,0,47.7023,-122.276,2320,10800,13522,13120,1430,81,81
3,1.75,1430,8412,1,0,0,4,7,1070,360,47.7218,-122.299,1490,8410,9842,9900,1430,91,91
3,2.5,1520,1488,3,0,0,3,8,1520,0,47.7337,-122.309,1520,1497,3008,3017,1520,13,13
0,1.5,1430,1650,3,0,0,3,7,1430,0,47.7222,-122.29,1430,1650,3080,3080,1430,20,20
3,1,1490,7200,1,0,0,3,7,1490,0,47.7276,-122.307,1280,7200,8690,8480,1490,65,65
3,1,1540,24500,1,0,0,3,7,1540,0,47.7213,-122.29,1540,7250,26040,8790,1540,70,70
2,1,770,6017,1,0,0,3,7,770,0,47.7223,-122.321,1670,7500,6787,9170,770,69,69
2,1,790,8100,1,0,0,3,6,790,0,47.7159,-122.305,1420,8100,8890,9520,790,72,72
3,1,1250,7654,1,0,0,3,7,1000,250,47.7289,-122.291,1310,7350,8904,8660,1250,67,67
3,3,1296,1051,3,0,0,3,8,1296,0,47.7175,-122.284,1520,1939,2347,3459,1296,10,10
3,1.75,1340,3850,1,0,0,4,7,1340,0,47.7134,-122.292,1540,7645,5190,9185,1340,59,59
4,2,1650,6480,2,0,0,5,7,1650,0,47.7117,-122.286,1650,6350,8130,8000,1650,72,72
4,3,1630,7626,1,0,0,5,7,1110,520,47.7168,-122.308,1630,8082,9256,9712,1630,29,29
4,1.75,2220,7230,1,0,1,3,8,1280,940,47.7065,-122.279,2210,7230,9450,9440,2220,69,69
4,3,2460,10401,1,0,0,5,7,1700,760,47.7106,-122.285,1470,7727,12861,9197,2460,72,72
2,1,1270,8164,1,0,0,4,6,1270,0,47.7116,-122.311,1580,9095,9434,10675,1270,78,78
4,1.5,1860,7808,1,0,0,3,7,1080,780,47.7314,-122.3,1530,7884,9668,9414,1860,66,66
3,1.75,1560,14288,1,0,0,3,6,780,780,47.7183,-122.306,1320,8928,15848,10248,1560,75,75
4,2.75,4110,8400,2,0,1,3,9,3130,980,47.717,-122.281,2820,8400,12510,11220,4110,91,1
1,1,900,6380,1,0,0,3,6,900,0,47.7019,-122.311,1830,6380,7280,8210,900,72,72
2,1,800,5220,1,0,0,3,6,800,0,47.7037,-122.32,1910,5376,6020,7286,800,76,76
2,1.75,1200,2622,1,0,0,5,7,800,400,47.7175,-122.292,1310,1926,3822,3236,1200,63,63
3,3,2360,2750,2,0,1,3,7,1780,580,47.7142,-122.281,1970,5800,5110,7770,2360,36,36
3,1.75,2280,3446,2,0,0,3,8,2280,0,47.715,-122.282,1610,6670,5726,8280,2280,70,23
3,2.25,1330,969,3,0,0,3,7,1330,0,47.7177,-122.292,1310,1941,2299,3251,1330,12,12
2,1.5,988,1080,3,0,0,3,7,988,0,47.7123,-122.301,1128,1080,2068,2208,988,12,12
2,1.75,2060,7192,1,0,0,3,7,1420,640,47.7038,-122.317,1860,7140,9252,9000,2060,79,79
4,3.5,2720,9000,2,0,0,3,8,2670,50,47.7034,-122.297,1960,7772,11720,9732,2720,22,22
3,1.5,1010,7683,1,0,0,5,7,1010,0,47.72,-122.318,1550,7271,8693,8821,1010,66,66
4,2.5,1600,14000,1,0,0,3,8,1310,290,47.7258,-122.326,1600,10200,15600,11800,1600,69,69
2,1,890,7250,1,0,0,3,7,890,0,47.7118,-122.314,900,7000,8140,7900,890,76,76
3,3,2150,3962,1,0,0,3,7,1540,610,47.7183,-122.285,1730,4609,6112,6339,2150,70,70
3,1,1400,7066,1,0,0,3,8,1400,0,47.7127,-122.325,1400,7320,8466,8720,1400,62,62
3,1,1500,6240,1,0,0,4,7,1500,0,47.7281,-122.311,1230,6240,7740,7470,1500,66,66
3,1.5,1400,8840,1,0,0,4,6,1400,0,47.7273,-122.309,1260,8840,10240,10100,1400,67,67
3,2.25,1606,1452,3,0,0,3,8,1606,0,47.7175,-122.284,1516,1939,3058,3455,1606,10,10
4,2.5,2650,7945,2,0,0,3,9,2650,0,47.7113,-122.296,1200,7920,10595,9120,2650,13,13
4,1.75,1730,5922,2,0,0,5,7,1730,0,47.7188,-122.321,1700,6127,7652,7827,1730,70,70
3,1.75,1560,5950,1,0,0,4,6,780,780,47.719,-122.307,1320,7830,7510,9150,1560,75,75
2,1.5,1400,1650,3,0,0,3,7,1400,0,47.7222,-122.29,1430,1650,3050,3080,1400,20,20
4,2,2070,7830,1,0,1,5,7,1180,890,47.7058,-122.278,2390,7830,9900,10220,2070,78,78
3,1,960,6634,1,0,0,3,6,960,0,47.7264,-122.31,1570,7203,7594,8773,960,67,67
4,2,2520,7334,1,0,0,3,7,1600,920,47.7263,-122.291,2040,7937,9854,9977,2520,64,64
5,2.5,2570,9600,1,0,2,3,8,1620,950,47.7216,-122.282,2680,9900,12170,12580,2570,63,63
3,3,1571,2017,3,0,0,3,8,1571,0,47.7338,-122.309,1520,1497,3588,3017,1571,11,11
3,1,1260,6826,1,0,0,3,6,720,540,47.731,-122.303,1300,6826,8086,8126,1260,75,75
2,1,720,6050,1,0,0,2,5,720,0,47.7259,-122.29,1480,7280,6770,8760,720,68,68
4,2.75,3160,37200,2,0,3,3,8,2310,850,47.7214,-122.285,3130,20000,40360,23130,3160,80,80
3,1,1370,6780,2,0,0,3,6,1370,0,47.7156,-122.291,1450,7214,8150,8664,1370,89,89
2,1,1560,4920,1,0,0,4,6,780,780,47.7248,-122.325,1760,7510,6480,9270,1560,72,72
2,1,1340,7250,1,0,0,4,7,1340,0,47.7015,-122.32,1450,7026,8590,8476,1340,68,68
3,2.5,2080,9612,1,0,3,4,8,1700,380,47.7293,-122.283,2560,10202,11692,12762,2080,79,79
3,3,1520,1884,3,0,0,3,8,1520,0,47.7176,-122.284,1360,1939,3404,3299,1520,10,10
3,3.25,1410,1442,3,0,0,3,8,1360,50,47.7183,-122.317,1500,1200,2852,2700,1410,13,13
3,2,1860,7232,1,0,0,3,7,1320,540,47.7165,-122.319,1830,7220,9092,9050,1860,34,34
4,2.75,2850,7510,2,0,0,3,8,2850,0,47.7097,-122.305,1510,8833,10360,10343,2850,11,11
3,1,1350,7085,1,0,0,5,7,1350,0,47.7318,-122.305,1350,7085,8435,8435,1350,75,75
4,1.75,1680,6834,1,0,0,3,7,1680,0,47.716,-122.307,950,7425,8514,8375,1680,71,71
5,2.5,2670,16777,1,0,0,4,7,1620,1050,47.7015,-122.301,1610,8227,19447,9837,2670,99,99
3,1.75,1890,6557,1,0,0,3,8,1890,0,47.7032,-122.286,1920,6793,8447,8713,1890,52,52
3,1,1780,6840,2,0,0,4,6,1780,0,47.727,-122.3,1410,7200,8620,8610,1780,72,72
3,1.75,1770,6000,1,0,0,3,7,1130,640,47.7135,-122.315,1900,7200,7770,9100,1770,67,67
3,2.5,1256,1154,3,0,0,3,7,1256,0,47.7146,-122.311,1309,1232,2410,2541,1256,14,14
4,3,2280,7400,1,0,0,3,7,1340,940,47.711,-122.306,1540,7500,9680,9040,2280,41,41
4,1.75,3420,7200,1,0,3,5,8,1770,1650,47.7081,-122.277,2450,6200,10620,8650,3420,72,72
4,2.25,1930,8338,1,0,0,3,8,1930,0,47.7026,-122.285,2280,7616,10268,9896,1930,51,51
3,2,1630,7800,1,0,0,5,7,1630,0,47.7326,-122.307,1470,7800,9430,9270,1630,69,69
6,2.25,2660,13579,2,0,0,3,7,2660,0,47.7142,-122.286,1120,8242,16239,9362,2660,82,24
5,3,2600,13674,1,0,0,5,8,1300,1300,47.7176,-122.302,2150,7800,16274,9950,2600,52,52
3,1,1070,6109,1,0,0,5,7,1070,0,47.7207,-122.32,1170,7200,7179,8370,1070,68,68
3,1,1120,8200,1,0,0,4,7,1120,0,47.7254,-122.29,1820,7205,9320,9025,1120,81,81
3,1.5,2080,5244,1,0,0,3,7,1190,890,47.7144,-122.293,1850,6982,7324,8832,2080,60,60
4,2.5,2070,8127,1,0,0,3,9,1590,480,47.7316,-122.289,2050,8131,10197,10181,2070,95,11
3,1.75,1560,5223,1,0,0,4,7,810,750,47.7175,-122.288,1440,8491,6783,9931,1560,79,79
3,1.75,1640,4860,1,0,0,3,8,1200,440,47.7125,-122.32,1480,7200,6500,8680,1640,54,54
3,1,1400,8100,1,0,0,3,6,1400,0,47.7124,-122.289,1420,8100,9500,9520,1400,75,75
3,1,1180,8400,1,0,0,3,7,1180,0,47.7028,-122.295,1740,7020,9580,8760,1180,68,68
3,1,1360,8968,1,0,0,3,7,1360,0,47.7105,-122.289,1490,7355,10328,8845,1360,63,63
3,2.5,1440,7320,1,0,0,5,7,1440,0,47.7179,-122.316,1160,6941,8760,8101,1440,65,65
2,1,1060,10423,1,0,0,3,7,1060,0,47.705,-122.313,2240,10200,11483,12440,1060,54,54
3,1,1000,6947,1,0,0,3,7,1000,0,47.7142,-122.319,1000,6947,7947,7947,1000,72,72
4,2,2100,13468,1,0,0,5,7,1050,1050,47.7139,-122.292,1470,8675,15568,10145,2100,57,57
3,3.25,2320,6744,2,0,0,3,9,1930,390,47.7132,-122.293,1700,6744,9064,8444,2320,5,5
2,1.5,1430,1650,3,0,0,3,7,1430,0,47.7222,-122.29,1430,1650,3080,3080,1430,20,20
4,3.75,4420,9492,2,0,1,3,9,3420,1000,47.7211,-122.283,2880,9900,13912,12780,4420,57,9
3,2,1400,6380,1,0,0,4,7,700,700,47.7015,-122.316,1690,5800,7780,7490,1400,95,95
6,2,1900,8240,1,0,0,2,7,1200,700,47.7037,-122.296,1900,8240,10140,10140,1900,55,55
3,2.25,1880,7989,1,0,0,3,7,1280,600,47.7077,-122.299,1820,7414,9869,9234,1880,37,37
4,2.75,2520,8433,2,0,0,3,8,2520,0,47.7214,-122.289,1890,7772,10953,9662,2520,5,5
3,1.5,1090,5003,1,0,0,3,7,1090,0,47.703,-122.321,1540,5279,6093,6819,1090,57,57
2,1,880,6171,1,0,0,4,7,880,0,47.7262,-122.285,2260,12769,7051,15029,880,70,70
3,1,1130,7000,1,0,0,3,6,830,300,47.7132,-122.283,1050,7000,8130,8050,1130,75,75
3,1.75,1550,7270,1,0,0,5,7,1550,0,47.72,-122.317,1050,7210,8820,8260,1550,66,66
3,1.5,1600,10440,1,0,0,3,7,1600,0,47.7109,-122.311,1600,8816,12040,10416,1600,65,65
3,3.25,1760,1778,3,0,0,3,8,1760,0,47.7201,-122.301,1520,1615,3538,3135,1760,11,11
4,2.75,2230,9640,1,0,0,3,8,1320,910,47.7269,-122.325,2100,9600,11870,11700,2230,21,21
3,1.5,1000,6914,1,0,0,3,7,1000,0,47.7144,-122.319,1000,6947,7914,7947,1000,72,72
3,2.75,2910,3094,2,0,2,5,7,2010,900,47.7071,-122.276,2400,7530,6004,9930,2910,80,80
2,1.5,940,1222,2,0,0,3,7,860,80,47.7178,-122.318,1302,1840,2162,3142,940,15,15
2,1,1140,8147,1,0,0,3,7,1140,0,47.7278,-122.289,1260,8148,9287,9408,1140,61,61
3,2,1320,6500,1,0,0,3,7,1320,0,47.7119,-122.319,1110,6592,7820,7702,1320,72,72
3,1,1420,8160,1,0,0,3,7,970,450,47.7164,-122.306,1340,8160,9580,9500,1420,72,72
4,1.75,1670,9886,1,0,0,5,7,1670,0,47.7249,-122.287,2590,9997,11556,12587,1670,72,72
3,1.5,1500,6337,1,0,0,5,7,1500,0,47.7276,-122.312,1420,6337,7837,7757,1500,66,66
4,1.75,1670,9500,1,0,0,3,7,1670,0,47.7254,-122.31,1620,9500,11170,11120,1670,43,43
2,2,1180,9265,1,0,0,3,7,1180,0,47.7252,-122.297,460,18000,10445,18460,1180,79,79
3,2.25,1890,7498,1,0,0,3,7,1190,700,47.73,-122.297,1660,8100,9388,9760,1890,32,32
2,1,1060,6100,1,0,0,3,6,1060,0,47.7317,-122.296,1550,9150,7160,10700,1060,68,68
4,2.75,1240,3867,1,0,0,3,7,800,440,47.7157,-122.284,1150,7733,5107,8883,1240,32,32
3,1,1330,5000,1,0,0,3,7,1120,210,47.7211,-122.308,1920,7790,6330,9710,1330,62,62
3,1.75,2130,6360,1,0,0,3,7,1720,410,47.7059,-122.301,1540,6361,8490,7901,2130,60,60
2,2,1320,2040,3,0,0,3,7,1320,0,47.7224,-122.291,1430,2040,3360,3470,1320,22,22
2,1,770,7200,1,0,0,3,7,770,0,47.7143,-122.325,1320,7139,7970,8459,770,68,68
4,3,2370,8154,1,0,0,3,7,1380,990,47.7258,-122.306,2100,8148,10524,10248,2370,42,42
3,3.25,2610,16387,2,1,4,3,9,2610,0,47.7175,-122.278,2590,12958,18997,15548,2610,13,13
3,1,1250,7157,1,0,0,3,7,1250,0,47.7323,-122.304,1300,6796,8407,8096,1250,75,5
3,2.5,1930,7214,2,0,0,3,8,1930,0,47.7191,-122.309,1930,7266,9144,9196,1930,14,14
2,1,820,4206,1,0,0,3,5,820,0,47.7076,-122.284,1810,7200,5026,9010,820,70,70
3,1,920,5546,1,0,0,2,6,920,0,47.7114,-122.284,1300,5546,6466,6846,920,91,91
2,1,1300,6617,1,0,0,3,7,1300,0,47.7238,-122.302,1820,7800,7917,9620,1300,33,33
2,1.5,1150,7552,1,0,1,3,7,1150,0,47.7298,-122.286,1910,8145,8702,10055,1150,75,75
3,1,1150,7080,1,0,0,3,7,1150,0,47.7106,-122.288,1490,7921,8230,9411,1150,67,67
3,2,2020,8555,1,0,0,4,7,1220,800,47.7278,-122.287,1600,8148,10575,9748,2020,62,62
3,1,1220,8040,1,0,0,3,7,1220,0,47.7133,-122.308,1360,8040,9260,9400,1220,54,54
5,2.5,2760,8015,1,0,0,4,8,1600,1160,47.7255,-122.297,460,18000,10775,18460,2760,59,59
3,2.25,2560,8040,1,0,0,3,8,1510,1050,47.7124,-122.303,1980,8040,10600,10020,2560,61,61
5,2.75,3250,8100,2,0,0,3,8,3250,0,47.7133,-122.311,1270,8100,11350,9370,3250,5,5
3,1.75,2120,5992,1,0,0,3,7,1060,1060,47.7083,-122.308,1840,11000,8112,12840,2120,72,72
3,1,1630,8146,1,0,0,3,7,1630,0,47.7293,-122.29,1480,8146,9776,9626,1630,67,67
3,1,1600,6380,1,0,0,3,7,1400,200,47.7015,-122.317,1760,6380,7980,8140,1600,80,80
3,1.5,1650,9957,1,0,0,4,7,1100,550,47.7303,-122.298,1650,7957,11607,9607,1650,58,58
4,1.75,1470,5350,1,0,0,3,7,980,490,47.7048,-122.315,1970,6138,6820,8108,1470,64,64
3,2,1590,5009,2,0,0,4,6,1590,0,47.7012,-122.322,1730,6380,6599,8110,1590,34,34
3,1,1520,9507,1,0,0,3,7,1520,0,47.7162,-122.324,1360,7219,11027,8579,1520,65,65
3,1.75,2450,9377,1,0,2,4,8,1540,910,47.7296,-122.284,2520,9725,11827,12245,2450,57,57
3,1.75,1330,6743,1,0,0,3,8,1330,0,47.7012,-122.286,2600,7350,8073,9950,1330,61,13
3,2,1540,7800,1,0,0,3,8,1540,0,47.7041,-122.288,1510,7800,9340,9310,1540,15,15
6,2.25,2660,13579,2,0,0,3,7,2660,0,47.7142,-122.286,1120,8242,16239,9362,2660,82,25
4,2.75,2260,7209,1,0,3,3,7,1330,930,47.7088,-122.302,1790,10860,9469,12650,2260,17,17
3,1,1450,8100,1,0,0,3,6,1450,0,47.7027,-122.289,1450,7800,9550,9250,1450,67,67
2,2.5,1830,8107,1,0,0,5,7,930,900,47.701,-122.305,1260,6960,9937,8220,1830,73,73
5,1.75,2250,13526,1,0,1,3,8,1350,900,47.7108,-122.279,2580,10078,15776,12658,2250,62,62
3,2.5,1480,8381,1,0,0,4,7,1480,0,47.7078,-122.288,1710,8050,9861,9760,1480,51,51
4,2,1870,6000,1,0,0,3,7,1870,0,47.7155,-122.315,1520,7169,7870,8689,1870,63,63
3,2.25,1333,1470,3,0,3,3,7,1333,0,47.7058,-122.302,1360,1680,2803,3040,1333,10,10
2,1,1140,7435,1,0,0,3,7,1140,0,47.73,-122.31,1320,9385,8575,10705,1140,67,25
4,1.5,1720,6417,1,0,0,3,7,1720,0,47.7268,-122.311,1430,6240,8137,7670,1720,66,66
3,1,1740,9163,1,0,0,3,7,1740,0,47.705,-122.299,1490,6509,10903,7999,1740,65,65
4,2.75,2740,6200,1,0,3,4,8,1820,920,47.7084,-122.277,2430,6000,8940,8430,2740,72,72
3,2.25,1390,1407,3,0,0,3,7,1390,0,47.7227,-122.296,1390,1628,2797,3018,1390,15,15
3,1.75,1700,8432,1,0,0,3,8,1230,470,47.7221,-122.317,1800,7842,10132,9642,1700,42,42
3,1,1350,7740,1,0,0,4,6,860,490,47.7098,-122.291,1130,7740,9090,8870,1350,72,72
4,2.25,1910,8005,1,0,0,3,8,1280,630,47.7259,-122.298,1860,8010,9915,9870,1910,59,59
4,2,1870,6000,1,0,0,3,7,1870,0,47.7155,-122.315,1520,7169,7870,8689,1870,63,63
3,2.25,2240,6450,1,0,0,3,7,1440,800,47.7034,-122.315,1390,6450,8690,7840,2240,40,40
4,2.5,3260,10032,1,0,0,3,8,1960,1300,47.7203,-122.323,1802,7249,13292,9051,3260,41,41
2,1,910,7617,1,0,0,3,6,910,0,47.7332,-122.305,1310,6624,8527,7934,910,83,83
3,2.25,1347,1292,3,0,0,3,7,1347,0,47.7306,-122.291,1480,1865,2639,3345,1347,9,9
5,2,3540,9970,2,0,3,3,9,3540,0,47.7108,-122.277,2280,7195,13510,9475,3540,49,49
3,1.5,1500,6332,1,0,0,3,7,1500,0,47.7274,-122.312,1500,6337,7832,7837,1500,66,66
4,1,1710,7000,1,0,0,3,7,1710,0,47.7037,-122.293,2030,7938,8710,9968,1710,69,69
4,1.75,1920,7455,1,0,0,4,7,960,960,47.7106,-122.286,1920,7455,9375,9375,1920,80,50
3,1.75,1760,6788,2,1,4,3,7,1760,0,47.7336,-122.284,1630,7588,8548,9218,1760,79,55
5,3,2270,6664,1,0,0,3,7,1340,930,47.7191,-122.315,1870,6187,8934,8057,2270,24,24
4,1.75,1600,6380,1,0,0,3,8,1130,470,47.701,-122.306,1090,6380,7980,7470,1600,60,60
2,1.5,1084,3427,2,0,0,3,7,1084,0,47.7117,-122.326,1084,6250,4511,7334,1084,43,43
4,2,2750,7807,1,0,0,5,7,2250,500,47.7168,-122.287,1510,7807,10557,9317,2750,103,103
4,1,1170,8147,1,0,0,3,6,1170,0,47.7281,-122.289,1260,8147,9317,9407,1170,60,60
5,3.75,3990,18897,2,0,0,3,8,3090,900,47.7228,-122.31,2080,9793,22887,11873,3990,82,4
2,1,1190,4440,1,0,0,3,6,1190,0,47.7135,-122.287,1060,5715,5630,6775,1190,38,38
4,2.5,3000,8100,2,0,0,3,8,3000,0,47.7151,-122.305,1550,8100,11100,9650,3000,27,27
3,1,970,5922,1,0,0,3,7,970,0,47.719,-122.321,1730,6128,6892,7858,970,70,70
3,2.5,2590,7237,2,0,0,3,8,2590,0,47.7113,-122.309,1670,7648,9827,9318,2590,15,15
2,1,1670,6212,1,0,0,4,7,1670,0,47.7152,-122.282,1670,7272,7882,8942,1670,72,72
6,2.25,3550,11780,1,0,0,4,8,2960,590,47.7218,-122.312,2360,8850,15330,11210,3550,71,71
3,1.75,1580,20588,1,0,0,3,8,1580,0,47.706,-122.29,2080,7800,22168,9880,1580,49,49
2,1,1630,7680,1,0,0,3,7,830,800,47.7092,-122.291,1250,7740,9310,8990,1630,72,72
3,2.5,2250,8300,2,0,0,3,8,2250,0,47.7174,-122.308,1790,7626,10550,9416,2250,16,16
4,1.75,2030,12518,1,0,0,3,8,1610,420,47.7278,-122.297,1650,7872,14548,9522,2030,69,69
4,1.75,1930,10210,1,0,2,3,8,1670,260,47.7078,-122.277,2730,6600,12140,9330,1930,78,78
4,1.5,1890,6052,1,0,0,4,7,1890,0,47.7055,-122.3,1510,6072,7942,7582,1890,64,64
4,1.75,1920,6000,1,0,0,4,7,960,960,47.7137,-122.315,1850,7200,7920,9050,1920,65,65
3,3.5,1320,1161,3,0,0,3,8,1320,0,47.7162,-122.294,1320,1161,2481,2481,1320,9,9
3,2.25,1700,9008,1,0,0,3,8,1340,360,47.7161,-122.317,2340,8003,10708,10343,1700,34,34
4,1.75,1890,6000,1,0,0,4,6,1110,780,47.7274,-122.305,1560,6356,7890,7916,1890,72,72
2,1.75,2080,8112,1,1,4,4,8,1040,1040,47.7134,-122.277,2030,8408,10192,10438,2080,80,30
4,2,1730,9139,2,0,0,3,8,1730,0,47.7181,-122.316,1410,7311,10869,8721,1730,62,62
4,3.25,3580,19989,1,1,4,4,7,3480,100,47.7087,-122.276,2410,6389,23569,8799,3580,104,50
3,1,920,5546,1,0,0,2,6,920,0,47.7114,-122.284,1300,5546,6466,6846,920,91,91
4,2.5,2080,11176,1,0,0,5,8,2080,0,47.7107,-122.289,1390,7928,13256,9318,2080,65,65
3,1,1160,7854,1,0,0,3,7,1160,0,47.7304,-122.308,1300,8317,9014,9617,1160,59,59
3,2.25,2190,8775,1,0,1,4,8,2190,0,47.7303,-122.287,1910,8145,10965,10055,2190,92,92
2,1,1100,7500,1,0,0,3,7,1100,0,47.7235,-122.326,1920,7149,8600,9069,1100,68,68
5,3.5,4390,10140,2,0,0,3,9,3350,1040,47.7174,-122.282,2010,8400,14530,10410,4390,14,14
4,2.5,2360,7370,1,0,0,3,7,1460,900,47.7201,-122.308,1590,9906,9730,11496,2360,34,34
3,1,1660,7500,1,0,0,4,7,1060,600,47.7105,-122.306,1450,7500,9160,8950,1660,79,79
4,2.5,2970,7961,1,0,0,3,8,2020,950,47.7118,-122.29,1410,7959,10931,9369,2970,50,50
3,1.5,1280,974,3,0,0,3,7,1280,0,47.7162,-122.293,1420,1422,2254,2842,1280,16,16
3,1,1000,7800,1,0,0,4,6,860,140,47.7098,-122.283,1700,7800,8800,9500,1000,89,89
3,2.5,1601,2491,3,0,0,3,7,1536,65,47.719,-122.317,1420,1156,4092,2576,1601,12,12
4,2.5,2340,7877,2,0,0,3,9,2340,0,47.73,-122.315,1920,9116,10217,11036,2340,15,15
4,1,1260,7800,1,0,0,3,7,1260,0,47.7334,-122.307,1639,7492,9060,9131,1260,72,8
3,1.75,1430,8865,1,0,0,3,7,1430,0,47.7331,-122.299,1250,8154,10295,9404,1430,69,69
4,3.5,2840,4637,3,0,0,3,8,2840,0,47.7033,-122.321,1730,5279,7477,7009,2840,11,11
3,1.75,1800,7199,1,0,0,3,7,1300,500,47.7264,-122.307,1800,8100,8999,9900,1800,47,47
3,1.5,2790,6900,1,0,2,3,8,1700,1090,47.7328,-122.288,2410,8100,9690,10510,2790,64,64
3,1,1460,8227,1,0,0,3,6,880,580,47.7009,-122.301,1530,8128,9687,9658,1460,71,71
3,2.25,2570,7242,2,0,0,3,7,2170,400,47.721,-122.319,1690,7639,9812,9329,2570,68,23
3,1.5,1730,9509,2,0,0,3,8,1270,460,47.7067,-122.282,1810,8795,11239,10605,1730,64,64
3,1.75,2260,8512,1,0,0,3,7,1130,1130,47.7129,-122.304,2240,8040,10772,10280,2260,71,71
3,1.75,1540,9000,1,0,0,3,8,1540,0,47.7152,-122.322,1710,7488,10540,9198,1540,48,48
2,1,1160,6911,1,0,0,3,7,1160,0,47.7149,-122.318,1120,6948,8071,8068,1160,72,72
2,1,1060,6050,1,0,0,3,7,940,120,47.7028,-122.321,1540,5279,7110,6819,1060,80,80
3,3.25,1770,1977,3,0,0,3,8,1770,0,47.7186,-122.314,1860,2210,3747,4070,1770,18,18
4,1.5,1620,5444,1,0,0,3,8,1620,0,47.7065,-122.297,1620,6912,7064,8532,1620,64,64
3,1.5,1480,1722,3,0,0,3,7,1480,0,47.728,-122.292,1480,5764,3202,7244,1480,12,12
3,3.25,1860,2218,3,0,0,3,8,1860,0,47.7185,-122.313,1860,2218,4078,4078,1860,18,18
2,1,1630,12059,1,0,0,3,7,1270,360,47.7228,-122.314,1660,8800,13689,10460,1630,72,72
4,2.25,2300,7700,1,0,0,3,7,1380,920,47.7137,-122.322,2010,8820,10000,10830,2300,60,60
2,1.5,1230,1516,3,0,0,3,8,1230,0,47.7265,-122.314,1352,1411,2746,2763,1230,19,19
3,2,1510,7066,1,0,2,3,7,1230,280,47.7053,-122.303,1950,8089,8576,10039,1510,46,46
3,1,1240,8840,1,0,0,3,6,1240,0,47.7277,-122.308,1250,8840,10080,10090,1240,67,67
4,1,1590,7085,1,0,0,3,6,1590,0,47.7315,-122.305,1320,7085,8675,8405,1590,75,75
2,1,1730,6375,2,0,0,4,6,1730,0,47.5357,-122.368,1180,6250,8105,7430,1730,74,74
2,1,950,5316,1,0,2,3,7,950,0,47.57,-122.38,1620,6085,6266,7705,950,71,71
4,2.5,2360,10000,1,0,3,3,8,1980,380,47.573,-122.374,2480,5000,12360,7480,2360,42,42
3,2.5,1800,1120,2,0,0,3,8,1800,0,47.5436,-122.369,1800,2380,2920,4180,1800,8,8
3,2.5,2830,6000,1,0,3,3,9,1730,1100,47.5751,-122.378,2040,5300,8830,7340,2830,65,65
2,1.75,1760,4600,1,0,0,4,7,850,910,47.5654,-122.372,1150,4800,6360,5950,1760,93,93
3,2.5,1780,2778,2,0,0,3,8,1530,250,47.5487,-122.372,1380,1998,4558,3378,1780,12,12
3,1.75,1580,7344,1,0,0,5,7,1580,0,47.5256,-122.38,1580,6207,8924,7787,1580,108,108
5,2,3020,6000,1,0,0,5,7,1860,1160,47.5207,-122.378,1380,6000,9020,7380,3020,94,94
5,1,1710,9100,1,0,0,4,7,1320,390,47.5379,-122.378,1880,9100,10810,10980,1710,93,93
3,3.5,1900,2133,2,0,0,3,8,1520,380,47.5675,-122.369,1530,3264,4033,4794,1900,10,10
2,3.25,1570,2031,2,0,0,3,8,1310,260,47.548,-122.375,1570,2039,3601,3609,1570,13,13
3,3.25,1560,1345,2,0,0,3,8,1260,300,47.5637,-122.375,1560,4800,2905,6360,1560,10,10
1,0.5,880,1642,1,0,0,3,6,500,380,47.5732,-122.372,1410,2992,2522,4402,880,109,109
3,1,1030,7200,1,0,0,3,6,880,150,47.5255,-122.376,1030,7200,8230,8230,1030,71,71
1,1.5,1170,1456,2,0,0,3,8,1070,100,47.5493,-122.372,1360,1730,2626,3090,1170,12,12
2,1.5,1170,5248,1,0,0,5,6,1170,0,47.5318,-122.374,1170,5120,6418,6290,1170,78,78
2,1,670,6720,1,0,0,5,6,670,0,47.5151,-122.372,710,6720,7390,7430,670,77,77
2,1,940,4264,1,0,0,5,7,940,0,47.5314,-122.378,1630,4472,5204,6102,940,70,70
2,1,1760,4441,1,0,0,3,8,1310,450,47.5311,-122.381,1350,5748,6201,7098,1760,69,69
3,1.5,1170,4080,1,0,0,5,6,1170,0,47.5338,-122.381,920,4242,5250,5162,1170,102,102
2,1,850,6370,1,0,0,3,6,850,0,47.5198,-122.373,850,5170,7220,6020,850,68,68
3,2.5,1800,2791,2,0,0,3,8,1800,0,47.5442,-122.371,1580,2617,4591,4197,1800,8,8
3,1,1050,5500,1,0,0,3,6,930,120,47.5402,-122.38,1410,5834,6550,7244,1050,99,99
2,1,1240,6400,1,0,1,4,7,1060,180,47.5493,-122.377,1240,6400,7640,7640,1240,81,81
2,1,910,5525,1,0,0,2,6,910,0,47.5322,-122.379,1620,5525,6435,7145,910,109,109
3,1.75,1700,5750,1,0,2,5,7,1450,250,47.5643,-122.38,1700,5750,7450,7450,1700,94,94
2,2,1900,7740,1,0,0,4,7,1150,750,47.5227,-122.372,1140,7740,9640,8880,1900,96,96
3,1,1080,4930,1,0,0,3,6,1080,0,47.5209,-122.374,1100,5950,6010,7050,1080,69,69
2,1,960,5096,1,0,0,5,7,960,0,47.5314,-122.378,1760,4488,6056,6248,960,70,70
3,1,1710,5110,1,0,0,3,7,1100,610,47.5256,-122.379,1310,5110,6820,6420,1710,65,65
2,1,1120,5329,1,0,1,3,6,750,370,47.5421,-122.378,1530,5330,6449,6860,1120,90,90
3,2,1020,1204,2,0,0,3,7,720,300,47.5445,-122.376,1360,1506,2224,2866,1020,15,15
3,2.75,2160,4086,1,0,0,3,7,1380,780,47.5352,-122.38,1300,4080,6246,5380,2160,32,32
1,1.75,1440,4920,1,0,0,3,7,720,720,47.534,-122.376,1440,4920,6360,6360,1440,96,96
2,2.5,1380,889,2,0,0,3,7,1140,240,47.5441,-122.369,1580,1397,2269,2977,1380,7,7
3,1.5,1280,4720,1,0,0,4,7,850,430,47.5509,-122.377,1280,4720,6000,6000,1280,78,78
2,1,1070,6100,1,0,0,3,6,1070,0,47.5698,-122.377,1770,5695,7170,7465,1070,79,79
4,1,1440,7404,1,0,0,3,6,1080,360,47.5328,-122.379,1620,7436,8844,9056,1440,101,101
4,2,2000,8317,1,0,0,4,8,2000,0,47.5394,-122.379,1390,6001,10317,7391,2000,102,102
3,1.75,1820,6038,1,0,0,4,7,1040,780,47.5233,-122.378,1700,6040,7858,7740,1820,67,67
4,1.75,2000,4000,1,0,0,5,7,1450,550,47.5659,-122.375,1430,4000,6000,5430,2000,93,93
2,1,720,5000,1,0,0,5,6,720,0,47.5195,-122.374,810,5000,5720,5810,720,68,68
2,1,880,5750,1,0,0,3,6,880,0,47.5642,-122.379,1190,5750,6630,6940,880,80,80
4,2.25,3300,8365,3,0,0,3,9,3300,0,47.5363,-122.377,1290,8369,11665,9659,3300,5,5
3,1.5,1060,5750,1,0,0,2,7,1060,0,47.5532,-122.372,1060,5750,6810,6810,1060,38,38
3,2,2150,5400,1,0,0,4,7,1380,770,47.555,-122.379,1940,6500,7550,8440,2150,108,108
2,1,1350,4494,1,0,0,3,7,920,430,47.5315,-122.38,1470,5225,5844,6695,1350,70,70
3,1.75,2330,6000,1,0,0,4,7,1630,700,47.5765,-122.378,1600,4000,8330,5600,2330,79,79
3,2.5,1670,7740,1,0,0,3,7,1130,540,47.5222,-122.37,1220,7740,9410,8960,1670,45,45
3,3,1860,2875,2,0,0,3,8,1710,150,47.5511,-122.373,1350,4830,4735,6180,1860,10,10
3,2,1820,1357,3,0,0,3,9,1820,0,47.5432,-122.376,1710,1372,3177,3082,1820,5,5
4,1.5,1850,6125,1,0,0,3,6,1110,740,47.5352,-122.37,990,6125,7975,7115,1850,74,74
2,1,1140,1730,1,0,0,3,8,1010,130,47.5494,-122.372,1360,1730,2870,3090,1140,12,12
3,1.5,2600,5085,1,0,0,4,7,1400,1200,47.5659,-122.376,1320,4000,7685,5320,2600,79,79
3,1,1600,4489,1,0,2,3,6,800,800,47.5686,-122.378,1640,6013,6089,7653,1600,75,75
2,1,740,6840,1,0,0,5,6,740,0,47.5172,-122.375,740,6840,7580,7580,740,77,77
3,1,1500,5750,1,0,0,4,7,1050,450,47.5677,-122.376,1500,5060,7250,6560,1500,92,92
2,1,670,2378,1,0,0,3,5,670,0,47.5769,-122.372,700,2970,3048,3670,670,100,100
3,3.75,2670,6517,2,0,4,4,8,2020,650,47.5702,-122.38,2010,6073,9187,8083,2670,42,42
2,1.75,870,4000,1,0,0,3,6,870,0,47.5657,-122.376,1420,4000,4870,5420,870,78,78
4,2.75,2440,5080,2,0,0,3,8,1750,690,47.5547,-122.379,1920,6375,7520,8295,2440,59,59
3,2,2060,4437,1,0,0,3,7,1030,1030,47.5705,-122.376,1750,4452,6497,6202,2060,90,90
3,3.25,1460,1592,2,0,0,3,8,1130,330,47.5481,-122.374,1560,1701,3052,3261,1460,13,13
2,1,1250,8520,1,0,0,3,6,1250,0,47.5158,-122.378,1040,8520,9770,9560,1250,91,91
2,1,1260,4800,1,0,0,3,6,1100,160,47.5196,-122.376,1260,2435,6060,3695,1260,72,72
4,1,1460,4600,1,0,2,3,6,780,680,47.566,-122.38,1560,4600,6060,6160,1460,73,73
3,1.75,2520,5043,1,0,0,3,8,1260,1260,47.5339,-122.372,1360,4920,7563,6280,2520,62,62
4,1.75,1540,5120,1,0,0,5,6,770,770,47.5359,-122.372,1080,5120,6660,6200,1540,76,76
2,1,770,5185,1,0,0,3,7,770,0,47.5459,-122.379,1260,6550,5955,7810,770,72,72
1,1.5,1010,1157,2,0,0,3,8,950,60,47.5492,-122.372,1360,1688,2167,3048,1010,12,12
2,1,690,6400,1,0,0,3,6,690,0,47.5287,-122.367,1000,6400,7090,7400,690,76,76
3,1.5,1480,7749,1,0,0,5,7,1480,0,47.5144,-122.379,1140,5320,9229,6460,1480,59,59
3,1,1010,7920,1,0,0,3,6,1010,0,47.5249,-122.37,1520,7560,8930,9080,1010,94,94
6,2.5,2640,3680,2,0,0,5,8,1760,880,47.5771,-122.38,1960,3680,6320,5640,2640,97,97
4,2.5,1850,5040,1,0,0,3,7,1230,620,47.5386,-122.373,1010,5040,6890,6050,1850,89,1
3,2,1020,889,2,0,0,3,7,720,300,47.5434,-122.375,1130,972,1909,2102,1020,10,10
3,2.5,2380,2500,3,0,3,3,9,2380,0,47.5734,-122.375,2270,5000,4880,7270,2380,31,31
4,2.5,2100,7920,1,0,0,4,6,1400,700,47.5293,-122.371,1230,7920,10020,9150,2100,103,103
2,1,740,6840,1,0,0,3,6,740,0,47.5168,-122.373,740,6840,7580,7580,740,77,77
3,2.5,1090,1139,2,0,0,3,8,960,130,47.5664,-122.369,1400,1348,2229,2748,1090,10,10
4,1,1030,5750,1,0,0,3,7,1030,0,47.553,-122.37,1250,5750,6780,7000,1030,48,48
4,1.75,1970,5160,1,0,0,3,7,1970,0,47.534,-122.373,1230,4920,7130,6150,1970,77,77
2,2.5,2600,5000,1,0,0,5,8,1300,1300,47.5806,-122.379,2260,5000,7600,7260,2600,93,93
4,2.75,1540,4840,1,0,2,4,7,850,690,47.5491,-122.375,1180,4840,6380,6020,1540,90,90
3,2,1560,6300,1,0,0,3,7,1560,0,47.5407,-122.379,1620,6300,7860,7920,1560,95,95
3,2.25,2520,6690,2,0,2,5,8,1700,820,47.5705,-122.381,1990,5792,9210,7782,2520,75,24
2,1.75,2470,4600,1,0,3,4,7,1140,1330,47.5599,-122.378,1790,5175,7070,6965,2470,103,103
3,3.25,1570,2048,2,0,0,3,8,1290,280,47.548,-122.375,1570,2006,3618,3576,1570,13,13
2,1,1760,5250,1,0,2,4,7,1000,760,47.5577,-122.379,1760,5400,7010,7160,1760,68,68
3,2.5,1360,1489,2,0,0,3,8,1360,0,47.549,-122.372,1360,1688,2849,3048,1360,12,12
2,1,1410,5000,1,0,2,4,7,940,470,47.5531,-122.379,1450,5000,6410,6450,1410,101,101
2,1,1120,4800,1,0,0,3,7,770,350,47.5669,-122.372,1510,4800,5920,6310,1120,93,93
2,1,670,7844,1,0,0,3,6,670,0,47.5165,-122.372,740,7218,8514,7958,670,77,77
2,1,630,6550,1,0,0,3,5,630,0,47.5486,-122.38,1420,6550,7180,7970,630,101,101
1,1,640,10280,1,0,0,2,5,640,0,47.5144,-122.368,1090,9000,10920,10090,640,99,99
3,1.75,1570,6975,1,0,0,3,7,1040,530,47.5137,-122.37,1280,7813,8545,9093,1570,40,40
2,1,620,4760,1,0,0,3,6,620,0,47.5292,-122.376,620,4760,5380,5380,620,78,78
3,1,1150,2496,1,0,0,3,6,1010,140,47.5194,-122.376,1340,1203,3646,2543,1150,72,72
3,2.5,1540,6100,1,0,0,3,6,770,770,47.5696,-122.378,1710,5950,7640,7660,1540,75,0
3,1,1800,5612,1,0,0,4,7,1200,600,47.525,-122.378,1450,5250,7412,6700,1800,77,77
2,1,930,5650,1,0,2,3,7,930,0,47.5478,-122.377,1340,6400,6580,7740,930,78,78
2,2.5,1400,2958,2,0,0,3,8,1400,0,47.5496,-122.373,1540,2385,4358,3925,1400,12,12
4,1.75,1990,4725,1,0,0,4,7,1190,800,47.5275,-122.38,1240,4961,6715,6201,1990,75,75
3,1.75,1270,4800,1,0,0,3,7,1270,0,47.5362,-122.376,1220,4800,6070,6020,1270,67,0
4,2.25,1990,7320,1,0,0,4,7,1030,960,47.5237,-122.376,1320,7320,9310,8640,1990,54,54
3,1.5,2390,4452,2,0,1,3,9,1790,600,47.5826,-122.378,2610,5000,6842,7610,2390,90,90
3,2.5,1780,1754,3,0,0,3,8,1780,0,47.548,-122.373,1780,1607,3534,3387,1780,12,12
3,2.5,2160,3738,2,0,0,3,8,2160,0,47.5661,-122.375,1500,4000,5898,5500,2160,25,25
4,3.25,2630,7770,2,0,0,3,9,2630,0,47.5459,-122.377,1370,7770,10400,9140,2630,5,5
3,1.75,1530,6300,1,0,0,3,6,1530,0,47.516,-122.375,920,6300,7830,7220,1530,77,10
4,2.25,2020,4840,1,0,0,5,8,1200,820,47.5576,-122.376,1410,4840,6860,6250,2020,94,94
5,2.75,3500,5040,2,0,2,3,9,2950,550,47.5527,-122.379,1450,5040,8540,6490,3500,92,7
2,1,990,4313,1,0,2,4,6,990,0,47.5677,-122.38,1480,5750,5303,7230,990,102,102
2,1,830,5100,1,0,0,4,7,830,0,47.5259,-122.379,1220,5100,5930,6320,830,77,77
3,1.75,1920,5405,1,0,2,4,7,960,960,47.5583,-122.38,1190,5405,7325,6595,1920,72,72
2,1,810,4560,1,0,0,3,7,810,0,47.5425,-122.376,1490,4560,5370,6050,810,91,91
2,1.5,1490,4080,1,0,0,3,7,930,560,47.5344,-122.381,1320,4080,5570,5400,1490,63,63
2,1,950,6426,1,0,0,3,7,950,0,47.5653,-122.37,1360,2550,7376,3910,950,70,70
4,1.75,1690,7680,1,0,0,5,6,890,800,47.5296,-122.375,1060,7680,9370,8740,1690,73,73
2,0.75,1330,2856,1,0,0,4,7,930,400,47.5671,-122.37,1330,2856,4186,4186,1330,103,103
2,2,1670,7772,1,0,0,4,6,860,810,47.5461,-122.377,1300,7770,9442,9070,1670,100,100
3,2.5,1580,3825,2,0,0,3,8,1580,0,47.5458,-122.369,1380,1500,5405,2880,1580,8,8
4,3.5,3050,7020,2,0,3,3,9,2050,1000,47.571,-122.374,2170,5900,10070,8070,3050,35,35
4,1.75,1320,4978,1,0,0,4,7,940,380,47.5266,-122.379,1260,4693,6298,5953,1320,77,77
2,1,770,4840,1,0,0,4,7,770,0,47.551,-122.376,930,4840,5610,5770,770,92,92
2,1,810,4800,1,0,0,3,7,810,0,47.5232,-122.375,1240,7740,5610,8980,810,71,71
4,1,1550,7740,1,0,0,3,6,1550,0,47.5222,-122.375,1220,7740,9290,8960,1550,65,65
3,1.5,720,7450,1,0,1,1,5,720,0,47.584,-122.375,2600,7360,8170,9960,720,95,95
2,1,1270,9182,1,0,0,3,6,1270,0,47.5365,-122.378,1760,9100,10452,10860,1270,102,102
2,1,1160,5038,1,0,0,5,7,740,420,47.5304,-122.38,1160,5076,6198,6236,1160,77,77
2,1,1280,5250,1,0,0,4,7,1140,140,47.5258,-122.377,1050,5250,6530,6300,1280,77,77
4,3.25,1560,4080,1,0,0,3,7,1560,0,47.5347,-122.38,1370,4080,5640,5450,1560,103,103
2,1.5,940,5000,1,0,0,4,7,810,130,47.5375,-122.374,940,5026,5940,5966,940,94,94
2,1,1140,3834,1,0,0,3,6,1140,0,47.5642,-122.378,1190,5750,4974,6940,1140,108,108
3,1.75,1400,5750,1,0,2,3,6,1100,300,47.5659,-122.38,1500,5175,7150,6675,1400,104,104
3,1.75,1880,5752,1,0,0,4,7,940,940,47.5354,-122.378,1110,5201,7632,6311,1880,74,74
2,1,740,6300,1,0,0,3,6,740,0,47.5158,-122.376,740,6300,7040,7040,740,77,77
3,1.75,1030,4800,1,0,0,3,6,930,100,47.566,-122.373,1540,4800,5830,6340,1030,92,92
2,1,800,7260,1,0,0,3,7,800,0,47.5359,-122.367,1010,7440,8060,8450,800,66,66
4,2.5,1920,9000,2,0,0,2,7,1920,0,47.5153,-122.37,1530,10474,10920,12004,1920,30,30
3,2,1550,6394,1,0,0,5,8,1550,0,47.5222,-122.379,1440,6387,7944,7827,1550,101,101
4,1,1500,6388,1,0,0,4,7,1500,0,47.5303,-122.378,980,5366,7888,6346,1500,68,68
4,1,2150,3588,2,0,3,4,8,1850,300,47.5767,-122.378,1950,3588,5738,5538,2150,93,93
2,1,710,6300,1,0,0,3,6,710,0,47.5155,-122.374,740,6300,7010,7040,710,77,77
4,2,2360,7080,1,0,0,5,6,1180,1180,47.5261,-122.376,1340,7200,9440,8540,2360,94,94
4,2,1660,6150,1,0,0,3,6,850,810,47.5371,-122.368,1110,6250,7810,7360,1660,74,74
3,2,2180,4976,1,0,2,4,8,1680,500,47.573,-122.38,1850,5000,7156,6850,2180,89,89
2,1,1320,6135,1,0,0,4,7,880,440,47.5265,-122.379,1050,4693,7455,5743,1320,77,77
4,2.25,1850,2340,2,0,0,3,8,1850,0,47.543,-122.372,1850,2340,4190,4190,1850,5,5
2,1,720,4840,1,0,0,4,6,720,0,47.5534,-122.375,1510,4840,5560,6350,720,72,72
3,2.5,2260,4550,1,0,0,4,7,1380,880,47.5714,-122.376,1870,4582,6810,6452,2260,91,91
2,1,1390,7740,1,0,0,4,6,1390,0,47.5232,-122.371,1290,7740,9130,9030,1390,94,94
2,1,840,4239,1,0,0,3,7,840,0,47.5319,-122.382,1120,4494,5079,5614,840,71,71
3,1,1250,4800,1,0,0,4,7,1250,0,47.5517,-122.381,1404,4800,6050,6204,1250,68,68
2,1,710,5200,1,0,2,4,6,710,0,47.5376,-122.371,1610,5200,5910,6810,710,77,77
3,3.25,1680,1478,2,0,0,3,8,1360,320,47.5674,-122.369,1530,2753,3158,4283,1680,10,10
3,1.75,1560,4049,1,0,2,3,7,1000,560,47.5666,-122.375,1430,3738,5609,5168,1560,93,93
2,1,720,4758,1,0,0,3,6,720,0,47.5176,-122.376,990,4920,5478,5910,720,72,72
3,1.75,1440,4025,1,0,0,4,6,720,720,47.567,-122.38,1500,5750,5465,7250,1440,102,102
3,1,1200,7800,1,0,0,4,7,1200,0,47.5196,-122.371,1230,7070,9000,8300,1200,65,65
2,1,2100,4480,1,0,0,5,7,1400,700,47.574,-122.372,1570,4400,6580,5970,2100,111,111
4,1,1210,7740,1,0,0,3,7,1210,0,47.5216,-122.374,1100,7740,8950,8840,1210,97,97
3,1,1280,5100,1,0,0,3,7,1280,0,47.5259,-122.38,1380,7140,6380,8520,1280,71,71
1,1,820,1060,1,0,0,3,8,760,60,47.5472,-122.372,1770,1853,1880,3623,820,12,12
3,2.25,1410,7740,1,0,0,5,6,1410,0,47.523,-122.371,1220,7740,9150,8960,1410,96,96
3,2.5,1480,1663,2,0,0,3,9,1180,300,47.5443,-122.375,1380,1537,3143,2917,1480,7,7
3,1,1610,4108,1,0,0,5,7,1610,0,47.5704,-122.376,1680,4467,5718,6147,1610,91,91
2,1,1050,5900,1,0,0,3,7,1050,0,47.5326,-122.376,1280,5900,6950,7180,1050,69,69
2,1,870,5000,1,0,0,3,6,870,0,47.5186,-122.375,820,5000,5870,5820,870,70,70
4,1.5,1690,3245,1,0,0,3,8,1690,0,47.5445,-122.375,1380,1590,4935,2970,1690,90,90
3,1.75,1580,7344,1,0,0,5,7,1580,0,47.5256,-122.38,1580,6207,8924,7787,1580,108,108
3,2,1470,1656,2,0,0,3,8,1310,160,47.5653,-122.369,1470,2288,3126,3758,1470,16,16
2,1,670,6300,1,0,0,4,6,670,0,47.5145,-122.374,740,6300,6970,7040,670,77,77
2,1,720,6400,1,0,0,4,6,720,0,47.5286,-122.368,1030,6400,7120,7430,720,76,76
3,1,1100,4128,1,0,0,4,7,720,380,47.5296,-122.379,1510,4538,5228,6048,1100,77,77
2,1,820,6550,1,0,0,3,7,820,0,47.5478,-122.381,1640,6550,7370,8190,820,70,2
4,1.75,1760,5750,1,0,2,5,7,1070,690,47.5521,-122.373,1860,5750,7510,7610,1760,57,57
1,1,820,1060,1,0,0,3,8,760,60,47.5473,-122.371,1770,1924,1880,3694,820,12,12
2,2.75,730,5000,1,0,0,3,7,730,0,47.5381,-122.374,980,5000,5730,5980,730,90,90
3,2,1550,6039,1,0,0,5,7,830,720,47.5436,-122.378,1330,6042,7589,7372,1550,77,77
3,2.25,1140,977,2,0,0,3,7,850,290,47.5439,-122.375,1140,976,2117,2116,1140,11,11
3,0.75,1330,7020,1,0,0,5,7,1330,0,47.5377,-122.376,1410,5802,8350,7212,1330,95,95
2,1,1080,4725,1,0,0,3,7,1080,0,47.5275,-122.381,1520,4961,5805,6481,1080,75,75
3,2.5,1690,5131,1,0,0,3,7,1690,0,47.5234,-122.38,860,5137,6821,5997,1690,78,16
2,1,970,5750,1,0,0,4,6,970,0,47.5518,-122.37,1650,8625,6720,10275,970,87,87
3,1,1450,3350,1,0,0,4,7,1450,0,47.5607,-122.378,1340,4255,4800,5595,1450,100,100
2,1,810,4080,1,0,0,4,6,810,0,47.5337,-122.379,1400,4080,4890,5480,810,78,78
2,1.5,1850,4945,1,0,2,4,7,1850,0,47.5742,-122.379,1850,4950,6795,6800,1850,112,46
4,2.75,2020,7070,1,0,0,5,7,1010,1010,47.5202,-122.378,1390,6000,9090,7390,2020,61,61
4,3,3410,6541,2,0,2,3,9,2680,730,47.5416,-122.38,2300,6345,9951,8645,3410,12,12
3,2,1060,5750,1,0,0,3,7,1060,0,47.5523,-122.372,1080,5750,6810,6830,1060,38,38
4,2,2210,5572,1,0,3,3,7,1760,450,47.5727,-122.376,1760,4713,7782,6473,2210,108,108
2,1,940,5040,1,0,0,3,7,940,0,47.5375,-122.374,940,5040,5980,5980,940,93,93
3,2,1760,2875,2,0,2,3,7,1290,470,47.5602,-122.378,1760,4830,4635,6590,1760,31,31
5,1,1840,6710,1,0,0,3,7,1840,0,47.5686,-122.378,1410,4880,8550,6290,1840,99,99
4,2.5,2180,6500,2,0,0,3,7,1410,770,47.5365,-122.37,920,6500,8680,7420,2180,74,74
3,3,2440,2076,2,0,0,3,8,1930,510,47.5476,-122.37,2440,2310,4516,4750,2440,13,13
3,1,1310,4163,1,0,0,4,7,1310,0,47.5301,-122.381,1120,4166,5473,5286,1310,55,55
3,1.75,2180,7318,1,0,0,4,7,1210,970,47.5251,-122.37,2140,7560,9498,9700,2180,52,52
2,1,830,6000,1,0,0,3,6,830,0,47.5308,-122.376,830,4960,6830,5790,830,79,79
3,1.75,2100,5058,1,0,2,3,7,1340,760,47.5743,-122.378,1640,5000,7158,6640,2100,78,78
2,2.5,1770,1853,3,0,0,3,8,1770,0,47.5472,-122.371,1770,1924,3623,3694,1770,12,12
2,1,1880,7560,1,0,0,3,6,940,940,47.5261,-122.374,1280,7560,9440,8840,1880,100,100
2,1,1230,7560,1,0,0,3,7,1230,0,47.7298,-122.34,1270,7560,8790,8830,1230,58,58
3,1.5,1240,1221,2,0,0,3,8,1050,190,47.7073,-122.356,1180,887,2461,2067,1240,10,10
3,1,1020,4980,1,0,0,4,7,850,170,47.7039,-122.34,970,4980,6000,5950,1020,78,78
4,2,1780,5043,1,0,0,3,7,870,910,47.7045,-122.342,1350,5044,6823,6394,1780,26,26
2,1,1180,7200,1,0,0,4,6,1180,0,47.7475,-122.342,1180,7200,8380,8380,1180,70,70
3,1.75,1540,8100,1,0,0,4,7,940,600,47.749,-122.351,1840,8100,9640,9940,1540,72,72
3,1,1030,8164,1,0,0,4,7,1030,0,47.7353,-122.334,1340,8164,9194,9504,1030,69,69
7,1.5,2670,11250,1,0,0,4,8,2320,350,47.7121,-122.332,2030,9000,13920,11030,2670,71,71
5,3,2530,5105,1,0,0,3,8,1520,1010,47.7546,-122.341,2290,4011,7635,6301,2530,14,14
3,2.25,2210,7916,2,0,0,3,8,2210,0,47.7175,-122.339,1450,7955,10126,9405,2210,41,41
2,1,1480,6210,1,0,0,3,7,1080,400,47.774,-122.351,1290,7509,7690,8799,1480,69,69
3,1.75,1820,8028,1,0,0,3,7,1220,600,47.7466,-122.355,1940,11100,9848,13040,1820,39,39
3,2.5,1260,1622,3,0,0,3,8,1260,0,47.7325,-122.343,1340,1188,2882,2528,1260,10,10
3,1,1810,7200,1,0,0,4,7,1130,680,47.7493,-122.351,1810,8100,9010,9910,1810,65,65
2,1,820,7475,1,0,0,3,6,820,0,47.7321,-122.341,1030,5720,8295,6750,820,74,74
3,1,1050,6874,1,0,0,3,6,1050,0,47.762,-122.355,1500,8954,7924,10454,1050,65,65
5,2,2330,8586,1,0,0,4,7,1270,1060,47.7671,-122.334,1550,8287,10916,9837,2330,58,58
3,1.75,1380,5060,1,0,0,3,7,1380,0,47.7059,-122.341,1030,5060,6440,6090,1380,33,33
3,2.25,2580,7434,1,0,0,3,7,1630,950,47.7446,-122.332,1920,7737,10014,9657,2580,56,56
2,1,1000,8212,1,0,0,4,7,1000,0,47.7444,-122.341,1620,8214,9212,9834,1000,72,72
3,1,1380,7470,1,0,0,5,7,1380,0,47.7479,-122.343,1440,7473,8850,8913,1380,54,54
3,1.5,1280,5525,1,0,0,3,7,1280,0,47.7339,-122.336,1330,5286,6805,6616,1280,57,57
3,1,860,6635,1,0,0,3,6,860,0,47.7508,-122.339,1170,8000,7495,9170,860,67,67
4,2,1530,5250,1,0,0,3,7,1110,420,47.7336,-122.339,1100,5250,6780,6350,1530,38,38
3,2.5,1490,2478,3,0,0,3,8,1490,0,47.7236,-122.353,1270,1156,3968,2426,1490,10,10
3,2,1790,6800,1,0,0,4,7,1240,550,47.728,-122.339,1470,6800,8590,8270,1790,55,55
4,1.75,1870,8663,1,0,0,5,7,1870,0,47.7366,-122.35,1560,7800,10533,9360,1870,70,70
2,1,1810,8527,1,0,0,4,7,1810,0,47.7275,-122.336,1490,6800,10337,8290,1810,76,76
2,1,1370,8400,1,0,0,3,7,1370,0,47.7344,-122.336,1330,8396,9770,9726,1370,71,71
2,1,1180,6552,1,0,0,4,6,1180,0,47.7477,-122.342,1070,7200,7732,8270,1180,70,70
2,0.75,650,5360,1,0,0,4,5,650,0,47.7281,-122.335,1110,6700,6010,7810,650,88,88
2,2.25,850,1656,2,0,0,3,8,850,0,47.7064,-122.344,850,1312,2506,2162,850,18,18
4,2.5,2740,12106,1,0,0,3,8,1980,760,47.7648,-122.355,2170,11156,14846,13326,2740,27,27
3,1,1980,9540,1,0,0,3,7,1080,900,47.7551,-122.353,1680,9529,11520,11209,1980,70,70
4,2.25,2160,8817,1,0,0,3,7,1460,700,47.7595,-122.356,1880,8817,10977,10697,2160,54,54
5,2,2620,7030,1,0,0,3,8,1420,1200,47.7338,-122.352,1360,7964,9650,9324,2620,54,54
5,1.75,1960,3748,1,0,0,3,7,980,980,47.7027,-122.349,1410,3844,5708,5254,1960,54,54
4,2,1960,10559,2,0,0,4,7,1960,0,47.7494,-122.337,1580,7769,12519,9349,1960,64,64
3,1.75,1510,6360,1,0,0,4,7,1510,0,47.7321,-122.353,1480,7260,7870,8740,1510,65,65
5,2.5,1970,12375,1,0,0,3,8,1570,400,47.7412,-122.354,1970,8941,14345,10911,1970,60,60
3,2,2010,16736,2,0,0,4,6,2010,0,47.7643,-122.352,1890,11477,18746,13367,2010,90,90
1,1,1050,7583,1,0,0,4,6,1050,0,47.7294,-122.341,1420,7560,8633,8980,1050,72,72
3,2.5,2230,3939,2,0,0,3,8,2230,0,47.73,-122.335,2230,4200,6169,6430,2230,5,5
2,1,1510,3844,1,0,0,4,7,1510,0,47.7038,-122.348,1170,3844,5354,5014,1510,96,44
2,1,970,10423,1,0,0,3,7,970,0,47.7252,-122.331,1200,7857,11393,9057,970,72,72
4,1.5,1390,7200,1,0,0,3,7,1140,250,47.7224,-122.332,1630,7702,8590,9332,1390,54,54
3,2.25,1820,9150,1,0,0,3,7,1320,500,47.737,-122.334,1780,8055,10970,9835,1820,58,58
3,1,940,12521,1,0,0,4,7,940,0,47.7169,-122.331,1920,9046,13461,10966,940,70,70
4,1,1640,3844,1,0,0,4,7,1460,180,47.7017,-122.354,1230,3844,5484,5074,1640,91,91
3,1.75,1740,8424,1,0,0,5,7,1040,700,47.7508,-122.352,1370,8424,10164,9794,1740,65,65
3,2.5,2180,7508,1,0,0,4,7,1420,760,47.7606,-122.336,1900,7818,9688,9718,2180,57,57
4,2.5,1900,9075,2,0,0,3,7,1900,0,47.7776,-122.352,1800,8460,10975,10260,1900,31,31
3,1.5,1800,8303,1,0,0,3,7,1200,600,47.7693,-122.357,1800,8171,10103,9971,1800,62,62
3,1.75,1570,8400,1,0,0,4,7,1570,0,47.76,-122.34,1860,8639,9970,10499,1570,60,60
3,1,1470,8400,1,0,0,4,7,1470,0,47.7628,-122.354,1470,8400,9870,9870,1470,66,66
5,1.75,2120,8399,1,0,0,4,7,1320,800,47.7621,-122.335,2120,8398,10519,10518,2120,77,77
2,1,770,9497,1,0,0,3,6,770,0,47.7407,-122.351,1550,7532,10267,9082,770,69,69
7,3.5,2830,8625,1,0,0,4,8,1830,1000,47.7493,-122.355,1570,8400,11455,9970,2830,62,62
5,1.75,2360,8642,1,0,0,5,7,2060,300,47.7617,-122.335,1950,8491,11002,10441,2360,93,93
3,1.75,1500,7200,1,0,0,3,7,1500,0,47.7748,-122.337,1650,7392,8700,9042,1500,62,62
3,1.75,1730,7416,1,0,0,3,7,1730,0,47.76,-122.349,1390,6490,9146,7880,1730,65,65
4,2.25,1820,8255,1,0,0,4,7,1320,500,47.723,-122.337,1550,7628,10075,9178,1820,89,89
3,1,1280,5460,1,0,0,4,7,1280,0,47.7321,-122.334,1390,5500,6740,6890,1280,88,88
3,1.75,1770,10125,2,0,0,3,7,1770,0,47.7289,-122.353,1680,9825,11895,11505,1770,75,36
3,2.25,2160,8114,1,0,0,3,8,1460,700,47.7176,-122.35,2160,8000,10274,10160,2160,59,59
3,1,1830,13900,1,0,0,3,7,1830,0,47.7654,-122.352,1840,10667,15730,12507,1830,68,68
3,1.5,1400,9087,1,0,0,3,7,1400,0,47.7711,-122.34,1490,8380,10487,9870,1400,65,65
2,1,800,6500,1,0,0,4,6,800,0,47.7621,-122.358,1220,7000,7300,8220,800,66,66
3,2,1710,8910,1,0,0,5,7,1710,0,47.7719,-122.338,1430,8493,10620,9923,1710,66,66
2,1,1010,6000,1,0,0,4,6,1010,0,47.771,-122.353,1610,7313,7010,8923,1010,75,75
3,1,1160,7202,1,0,0,4,7,1160,0,47.7675,-122.334,1620,8598,8362,10218,1160,62,62
5,2.5,2180,7875,1,0,0,4,7,1200,980,47.7543,-122.341,1840,5105,10055,6945,2180,64,64
2,1.5,1220,1036,3,0,0,3,7,1220,0,47.7348,-122.347,1210,659,2256,1869,1220,13,13
4,2.5,1900,5001,1,0,0,3,8,1200,700,47.7289,-122.335,1950,4680,6901,6630,1900,11,11
3,2.25,1358,1204,3,0,0,3,7,1358,0,47.7054,-122.346,1358,1196,2562,2554,1358,12,12
4,2.25,2180,10754,1,0,0,5,7,1100,1080,47.7711,-122.341,1810,6929,12934,8739,2180,65,65
2,1,810,5100,1,0,0,3,6,810,0,47.7317,-122.343,1500,5100,5910,6600,810,64,64
3,1.5,1740,6988,1,0,0,3,7,1600,140,47.7211,-122.33,1650,7500,8728,9150,1740,69,69
3,2.5,1620,7410,1,0,0,5,7,1620,0,47.7708,-122.335,1450,8121,9030,9571,1620,64,64
3,1,1020,10200,1,0,0,4,7,1020,0,47.7503,-122.348,1170,8188,11220,9358,1020,65,65
3,1,1520,8320,1,0,0,3,6,1520,0,47.7699,-122.335,1500,8320,9840,9820,1520,66,66
2,1.5,1390,1756,3,0,0,3,7,1390,0,47.7274,-122.357,1340,1756,3146,3096,1390,14,14
3,2.25,1920,4833,1,0,0,4,7,1060,860,47.7067,-122.352,1580,5134,6753,6714,1920,98,98
4,1.75,2180,7560,1,0,0,4,7,1560,620,47.757,-122.336,1810,7352,9740,9162,2180,57,57
3,1,1570,9136,1,0,0,3,7,1570,0,47.7688,-122.337,1380,9127,10706,10507,1570,66,66
3,1.5,1510,16800,1,0,0,5,8,1510,0,47.751,-122.338,1560,7276,18310,8836,1510,63,63
3,1,1110,7000,1,0,0,4,7,1110,0,47.754,-122.341,1800,7000,8110,8800,1110,64,64
3,1,980,7000,1,0,0,3,6,980,0,47.7617,-122.357,1220,7000,7980,8220,980,66,66
3,1.75,1240,8611,1,0,0,4,7,1240,0,47.7175,-122.331,1700,8037,9851,9737,1240,46,46
3,1.75,1950,7260,1,0,0,3,8,1520,430,47.7187,-122.33,1950,7548,9210,9498,1950,62,62
4,1.75,1850,7730,1,0,0,5,7,1100,750,47.7481,-122.355,2260,8581,9580,10841,1850,63,63
4,1,1200,2171,1,0,0,3,7,1200,0,47.7076,-122.342,1130,1598,3371,2728,1200,86,86
3,2.25,1250,952,3,0,0,3,8,1250,0,47.7098,-122.333,1250,1030,2202,2280,1250,11,11
2,1.5,920,1458,2,0,0,3,7,920,0,47.7081,-122.342,1110,1598,2378,2708,920,24,24
2,1,810,7440,1,0,0,5,6,810,0,47.7346,-122.352,830,7500,8250,8330,810,71,71
4,1,1740,11075,1,0,0,3,7,1740,0,47.7458,-122.334,1580,7684,12815,9264,1740,54,54
4,1.75,1650,7775,1,0,0,4,7,1150,500,47.715,-122.354,1390,7200,9425,8590,1650,69,69
2,1.5,1820,7800,1,0,0,4,7,1240,580,47.7513,-122.357,1400,7800,9620,9200,1820,63,63
2,1,1110,6800,1,0,0,5,7,1000,110,47.7184,-122.355,1410,6963,7910,8373,1110,72,72
4,2.5,2040,7260,2,0,0,4,7,2040,0,47.7399,-122.332,2040,7360,9300,9400,2040,56,56
2,2,800,5765,1,0,0,4,6,800,0,47.7024,-122.346,1160,3844,6565,5004,800,83,83
3,1.5,1360,7680,1,0,0,3,7,1360,0,47.7441,-122.337,1630,7679,9040,9309,1360,64,64
3,2.5,2160,9063,2,0,0,3,8,2160,0,47.7296,-122.333,2160,9063,11223,11223,2160,27,27
3,1.5,1400,7550,1,0,0,4,7,1400,0,47.7566,-122.337,1730,7562,8950,9292,1400,66,66
3,1.5,1430,12199,1,0,0,3,7,1130,300,47.7352,-122.33,1490,8196,13629,9686,1430,71,71
3,2.5,1890,11036,1,0,0,3,8,1460,430,47.7426,-122.354,2040,7524,12926,9564,1890,46,46
3,1.75,1470,4950,1,0,0,3,7,1030,440,47.7325,-122.337,1100,5250,6420,6350,1470,35,35
3,2,2040,6880,2,0,0,4,7,2040,0,47.7601,-122.351,1710,7597,8920,9307,2040,65,65
2,2.25,1320,1034,3,0,0,3,7,1320,0,47.7039,-122.344,1330,1206,2354,2536,1320,23,23
3,1,1240,5400,1,0,0,4,7,1060,180,47.7115,-122.355,1429,5400,6640,6829,1240,79,79
3,1,1490,15850,1,0,0,3,7,1490,0,47.7411,-122.347,1950,13228,17340,15178,1490,73,73
2,1,850,6800,1,0,0,3,7,850,0,47.7282,-122.337,870,6800,7650,7670,850,71,71
2,2.75,1370,1140,2,0,0,3,8,1080,290,47.7053,-122.342,1370,1090,2510,2460,1370,10,10
3,2.5,2120,7201,2,0,0,3,8,2120,0,47.7174,-122.337,1930,7206,9321,9136,2120,16,16
4,2.75,2440,12051,1,0,0,5,8,1440,1000,47.7456,-122.351,2030,8006,14491,10036,2440,53,53
2,1,1040,9100,1,0,0,4,7,1040,0,47.7407,-122.347,1950,13228,10140,15178,1040,82,82
3,1,1500,9416,1,0,0,4,8,1500,0,47.7135,-122.332,1440,7200,10916,8640,1500,67,67
4,3,1980,7931,1,0,0,4,7,1160,820,47.7513,-122.334,1910,7931,9911,9841,1980,36,36
2,1,1010,6000,1,0,0,4,6,1010,0,47.771,-122.353,1610,7313,7010,8923,1010,75,75
3,1.75,1680,8648,1,0,0,4,7,1680,0,47.7338,-122.332,1290,8147,10328,9437,1680,56,56
3,2.5,1509,1418,3,0,0,3,8,1509,0,47.7047,-122.34,1509,1991,2927,3500,1509,5,5
5,3,2920,11440,2,0,0,3,8,2920,0,47.7607,-122.354,1720,9348,14360,11068,2920,16,16
2,1,760,6000,1,0,0,4,6,760,0,47.7168,-122.34,950,6000,6760,6950,760,69,69
3,1.5,1410,9000,1,0,0,3,7,1410,0,47.7635,-122.35,1910,7214,10410,9124,1410,66,66
3,3.25,1210,941,2,0,0,3,8,1000,210,47.7114,-122.356,1650,1493,2151,3143,1210,17,17
4,1,1760,7216,1,0,0,3,7,1090,670,47.7041,-122.355,1180,3844,8976,5024,1760,72,72
4,1,1300,8400,1,0,0,4,7,1300,0,47.7612,-122.332,1330,8400,9700,9730,1300,66,66
5,1.75,2190,7500,1,0,0,3,7,1290,900,47.7766,-122.355,1790,8820,9690,10610,2190,40,40
4,1,1200,2171,1,0,0,3,7,1200,0,47.7076,-122.342,1130,1598,3371,2728,1200,86,86
4,1.75,1620,4980,1,0,0,4,7,860,760,47.7025,-122.341,1400,4980,6600,6380,1620,72,72
2,1.5,920,1598,2,0,0,3,7,920,0,47.7081,-122.342,1110,1598,2518,2708,920,24,24
4,2,2560,9390,1,0,0,5,8,1280,1280,47.7169,-122.329,1830,8169,11950,9999,2560,62,62
3,1.75,1540,8925,1,0,0,4,7,1540,0,47.7762,-122.337,1620,10397,10465,12017,1540,62,62
5,3,3010,7357,2,0,0,3,9,3010,0,47.7226,-122.33,2370,8050,10367,10420,3010,11,11
4,1,1300,6075,1,0,0,5,7,1300,0,47.773,-122.349,1450,7320,7375,8770,1300,65,65
4,1,1410,7693,1,0,0,4,7,1410,0,47.7604,-122.331,1330,8395,9103,9725,1410,66,66
4,2.5,2240,9385,2,0,0,3,8,2240,0,47.7125,-122.332,2010,9000,11625,11010,2240,28,28
3,1,990,6750,1,0,0,4,6,990,0,47.7125,-122.331,1440,6860,7740,8300,990,72,72
2,1.5,880,1805,2,0,0,3,7,880,0,47.7064,-122.342,880,5060,2685,5940,880,20,20
4,1.75,1890,8000,1,0,0,4,7,1250,640,47.7576,-122.333,1870,8270,9890,10140,1890,59,59
4,1.75,2200,8545,1,0,0,4,7,1100,1100,47.7481,-122.353,1940,9315,10745,11255,2200,101,32
1,1,710,4725,1,0,0,3,6,710,0,47.7328,-122.34,900,5250,5435,6150,710,80,80
4,1,1330,8184,1,0,0,3,7,1330,0,47.7343,-122.347,1220,660,9514,1880,1330,70,70
2,1,1140,5250,1,0,0,4,6,1140,0,47.731,-122.341,1450,5250,6390,6700,1140,70,70
4,1.75,2520,11017,1,0,0,4,7,1320,1200,47.7604,-122.356,1660,8775,13537,10435,2520,63,63
3,1,1480,7830,1,0,0,3,7,1480,0,47.7703,-122.336,1450,7830,9310,9280,1480,67,67
4,1.75,1800,8385,1,0,0,5,6,900,900,47.7744,-122.338,1770,8385,10185,10155,1800,69,69
5,3.5,2700,11675,1,0,2,4,6,1950,750,47.7172,-122.349,2160,8114,14375,10274,2700,71,71
2,1.5,880,1498,2,0,0,3,7,880,0,47.7063,-122.342,880,5060,2378,5940,880,20,20
3,1,1010,6300,1,0,0,3,7,1010,0,47.7304,-122.352,1480,7480,7310,8960,1010,62,62
3,2.5,1840,6985,1,0,0,3,7,1290,550,47.7586,-122.342,2160,7990,8825,10150,1840,48,48
3,2.5,1553,1991,3,0,0,3,8,1553,0,47.7049,-122.34,1509,2431,3544,3940,1553,5,5
3,1.75,1390,9585,1,0,0,4,7,1390,0,47.752,-122.35,1240,8188,10975,9428,1390,46,46
3,1,1020,7650,1,0,0,3,7,1020,0,47.7198,-122.352,1440,7650,8670,9090,1020,79,79
3,1,1130,8159,1,0,0,4,7,1130,0,47.7362,-122.333,1570,8162,9289,9732,1130,65,65
3,1.5,1560,6774,1,0,0,4,6,1060,500,47.7024,-122.35,1320,3844,8334,5164,1560,92,92
4,2.75,3320,8653,2,0,0,3,8,3320,0,47.7521,-122.334,2140,8727,11973,10867,3320,5,5
4,1.75,1840,9250,1,0,0,4,7,980,860,47.708,-122.337,1520,9250,11090,10770,1840,63,63
3,1.5,1450,7316,1,0,0,3,7,1450,0,47.7725,-122.349,1440,7316,8766,8756,1450,58,58
3,0.75,1240,7200,1,0,0,3,7,1240,0,47.7298,-122.342,1210,7200,8440,8410,1240,72,72
3,2,1470,6950,1,0,0,5,6,1470,0,47.7619,-122.343,1660,5065,8420,6725,1470,87,87
3,3.25,1510,1245,3,0,0,3,7,1510,0,47.7293,-122.343,1510,1245,2755,2755,1510,12,12
3,2.5,2230,4006,2,0,0,3,8,2230,0,47.73,-122.335,2230,4180,6236,6410,2230,5,5
4,2,1650,7200,1,0,0,3,7,1650,0,47.7543,-122.344,1410,7200,8850,8610,1650,55,55
3,1.5,1730,7800,1,0,0,3,7,1330,400,47.7365,-122.337,1780,8309,9530,10089,1730,61,61
3,1,830,3386,1,0,0,3,6,830,0,47.7027,-122.355,1300,3844,4216,5144,830,77,25
3,2.25,1650,10336,1,0,0,3,7,1500,150,47.7757,-122.35,1420,10260,11986,11680,1650,57,57
3,1.5,1600,8040,1,0,0,4,7,1050,550,47.7471,-122.337,1810,7819,9640,9629,1600,54,54
4,2.5,2720,7991,2,0,0,3,9,2720,0,47.7168,-122.331,1590,8611,10711,10201,2720,13,13
3,1,1260,7660,1,0,0,3,6,1260,0,47.7476,-122.35,1990,7861,8920,9851,1260,72,72
3,1,1080,5250,1,0,0,4,7,1080,0,47.7309,-122.336,1100,5250,6330,6350,1080,72,72
3,1.75,2000,8400,1,0,0,4,8,2000,0,47.7535,-122.334,2000,8400,10400,10400,2000,60,60
2,1,1190,6200,1,0,0,3,7,1190,0,47.7634,-122.34,1470,7800,7390,9270,1190,71,71
3,1.5,1650,8676,1,0,0,4,8,1130,520,47.7471,-122.352,1400,8499,10326,9899,1650,40,40
3,1.5,1270,1067,3,0,0,3,8,1270,0,47.7236,-122.353,1090,1118,2337,2208,1270,10,10
4,2.25,1940,8270,2,0,0,5,7,1940,0,47.7567,-122.333,1800,7743,10210,9543,1940,57,57
5,1.75,2110,8500,1,0,0,3,7,1100,1010,47.7737,-122.35,2020,8500,10610,10520,2110,57,57
4,2.5,2400,7292,1,0,0,3,8,1530,870,47.7749,-122.339,1710,7909,9692,9619,2400,39,39
4,1.75,1940,6909,1,0,0,4,7,970,970,47.7108,-122.352,1460,6906,8849,8366,1940,78,78
3,1,1080,7000,1,0,0,4,6,1080,0,47.7637,-122.351,1410,7214,8080,8624,1080,103,103
3,1.75,1980,8100,1,0,0,4,7,1310,670,47.7353,-122.331,1450,8212,10080,9662,1980,70,70
3,1.75,1790,7679,1,0,0,4,7,1790,0,47.7442,-122.338,1560,7680,9469,9240,1790,66,66
4,1.75,2240,7500,1,0,0,4,7,1120,1120,47.7466,-122.34,1440,7500,9740,8940,2240,63,63
3,2,2590,14052,1,0,0,5,8,1720,870,47.7357,-122.333,1570,8162,16642,9732,2590,71,71
4,1.75,1850,7730,1,0,0,5,7,1100,750,47.7481,-122.355,2260,8581,9580,10841,1850,63,63
3,2.25,1470,9140,2,0,2,3,7,1470,0,47.7162,-122.349,1400,8204,10610,9604,1470,37,37
3,1,1380,6591,1,0,0,4,7,1380,0,47.7164,-122.351,1610,6594,7971,8204,1380,72,72
3,2.5,2360,9005,1,0,0,5,7,1340,1020,47.7076,-122.337,1520,9005,11365,10525,2360,90,90
3,1.5,1240,983,3,0,0,3,8,1240,0,47.7235,-122.353,1240,1026,2223,2266,1240,10,10
3,1.75,1680,7250,1,0,0,3,7,930,750,47.7201,-122.35,1340,7250,8930,8590,1680,67,67
3,2.25,1590,7267,1,0,0,4,7,1100,490,47.7457,-122.332,2060,8336,8857,10396,1590,43,43
4,2.25,2180,10754,1,0,0,5,7,1100,1080,47.7711,-122.341,1810,6929,12934,8739,2180,65,65
3,1.75,1400,7405,1,0,0,3,7,1400,0,47.7569,-122.334,1820,7440,8805,9260,1400,58,58
3,1.75,1320,6205,1,0,0,5,7,1320,0,47.7412,-122.343,1210,6205,7525,7415,1320,71,71
3,2.25,1250,1017,3,0,0,3,8,1250,0,47.7099,-122.333,1250,1017,2267,2267,1250,11,11
3,3,1370,1001,3,0,0,3,8,1370,0,47.7302,-122.355,1399,1151,2371,2550,1370,10,10
2,1,1370,10038,1,0,0,4,7,1370,0,47.719,-122.339,1610,8822,11408,10432,1370,97,97
2,1,810,6150,1,0,0,3,7,810,0,47.7289,-122.34,1080,7200,6960,8280,810,69,69
2,2,1230,4800,2,0,0,3,7,1230,0,47.7145,-122.35,1560,7200,6030,8760,1230,67,11
3,2.25,1358,1141,3,0,0,3,7,1358,0,47.7052,-122.346,1358,1196,2499,2554,1358,12,12
2,1,880,12000,1,0,0,3,7,880,0,47.7436,-122.356,1960,9395,12880,11355,880,80,80
4,2,2030,4033,2,0,0,4,7,1630,400,47.7056,-122.342,1350,1340,6063,2690,2030,94,94
3,1.5,1260,1270,2,0,0,3,7,1040,220,47.7111,-122.331,1260,1472,2530,2732,1260,14,14
3,2.25,1260,1488,3,0,0,3,7,1260,0,47.7071,-122.336,1190,1095,2748,2285,1260,10,10
5,3,3230,5167,1,0,0,4,8,2000,1230,47.7053,-122.34,1509,1626,8397,3135,3230,110,110
2,1,840,3844,1,0,0,4,6,840,0,47.7048,-122.347,1040,3844,4684,4884,840,100,100
8,2.75,2790,6695,1,0,0,3,7,1470,1320,47.7565,-122.331,1760,7624,9485,9384,2790,42,42
3,1,1410,5060,1,0,0,4,7,910,500,47.7073,-122.34,1130,5693,6470,6823,1410,63,63
3,1,1000,5454,1,0,0,3,7,1000,0,47.7339,-122.337,1320,5250,6454,6570,1000,65,65
2,1,740,5995,1,0,0,4,7,740,0,47.7291,-122.337,1140,5995,6735,7135,740,70,70
3,1,1080,8214,1,0,0,3,7,1080,0,47.7401,-122.348,1850,13560,9294,15410,1080,75,75
4,1.75,2100,10358,1,0,0,5,8,1280,820,47.7478,-122.338,2080,9000,12458,11080,2100,60,60
2,1,1510,11165,1,0,0,4,7,1510,0,47.7212,-122.331,2210,8851,12675,11061,1510,98,98
2,1,1060,8187,1,0,0,4,6,1060,0,47.7508,-122.349,1260,8188,9247,9448,1060,67,67
2,1,1510,6807,1,0,0,3,7,1090,420,47.711,-122.353,1460,6807,8317,8267,1510,80,80
3,2.25,1780,9672,1,0,0,3,8,1350,430,47.7774,-122.35,1860,10080,11452,11940,1780,59,59
1,1,1230,9300,1,0,0,4,6,1230,0,47.7055,-122.348,1190,6820,10530,8010,1230,101,101
3,2.5,1330,1200,3,0,0,3,7,1330,0,47.7034,-122.344,1330,1206,2530,2536,1330,17,17
5,2,1840,9240,1,0,0,4,7,1540,300,47.7308,-122.34,1200,5250,11080,6450,1840,77,56
3,2.5,1450,5175,1,0,0,3,8,1030,420,47.7082,-122.338,1740,9250,6625,10990,1450,24,24
5,1.75,2290,7900,1,0,0,4,7,1190,1100,47.7577,-122.358,1870,8250,10190,10120,2290,54,54
3,1,1360,6186,1,0,0,4,6,760,600,47.7503,-122.334,1610,7453,7546,9063,1360,78,78
4,2.5,1800,8432,1,0,0,4,7,1200,600,47.7463,-122.336,1780,8432,10232,10212,1800,59,59
1,1,930,7129,1,0,0,3,6,930,0,47.7234,-122.333,1300,8075,8059,9375,930,71,71
4,2,1530,7816,1,0,0,3,7,1530,0,47.7309,-122.332,1480,7816,9346,9296,1530,64,64
3,1.75,1530,10300,1,0,0,4,7,1530,0,47.7767,-122.356,1940,9883,11830,11823,1530,41,41
3,2.25,1570,7187,1,0,0,4,8,1170,400,47.7604,-122.356,1660,8775,8757,10435,1570,39,39
3,3.25,1600,1882,2,0,0,3,8,1360,240,47.7151,-122.355,1390,1379,3482,2769,1600,19,19
3,2.5,1910,4408,3,0,0,3,8,1910,0,47.7634,-122.35,1910,8154,6318,10064,1910,12,12
3,1,1180,7200,1,0,0,4,7,1180,0,47.7121,-122.333,2240,7875,8380,10115,1180,70,70
2,1,1440,7808,1,0,0,4,7,860,580,47.7431,-122.336,1550,7682,9248,9232,1440,70,70
4,1.5,2290,8773,1,0,0,4,7,1330,960,47.7173,-122.33,1740,7058,11063,8798,2290,72,72
3,1.75,2200,11520,1,0,0,4,7,2200,0,47.7659,-122.341,1690,8038,13720,9728,2200,67,67
3,2.5,1420,3542,2,0,0,3,8,1310,110,47.7731,-122.343,1180,1622,4962,2802,1420,12,12
4,2.5,2090,9702,1,0,0,5,7,1320,770,47.7467,-122.339,1850,7200,11792,9050,2090,54,54
3,1,1480,7284,1,0,0,3,7,970,510,47.7757,-122.353,2020,7920,8764,9940,1480,56,56
2,2.25,1950,29347,1,0,0,3,8,1350,600,47.739,-122.351,2125,7751,31297,9876,1950,66,66
4,2.5,3305,16164,1,0,0,5,7,2245,1060,47.7563,-122.338,1620,8883,19469,10503,3305,97,58
4,2,2120,6865,1,0,0,3,7,1060,1060,47.7775,-122.337,1460,7780,8985,9240,2120,65,65
3,1,1400,4980,1,0,0,3,6,950,450,47.7041,-122.34,990,4980,6380,5970,1400,76,76
3,1,1570,11752,1,0,0,5,8,1570,0,47.7686,-122.348,2010,8291,13322,10301,1570,89,89
2,1,1240,7590,1,0,0,4,7,1040,200,47.7061,-122.34,1190,5692,8830,6882,1240,80,80
3,1,1390,4820,1,0,0,4,7,910,480,47.704,-122.343,1320,4820,6210,6140,1390,93,93
3,1,1100,7650,1,0,0,3,7,1100,0,47.7219,-122.354,1430,7650,8750,9080,1100,67,67
3,1,1400,8451,1,0,0,3,7,1400,0,47.7719,-122.337,1590,8433,9851,10023,1400,66,66
5,1.75,2860,12293,1,0,0,4,8,1430,1430,47.7385,-122.348,1920,18110,15153,20030,2860,72,72
2,1.5,1190,1236,3,0,0,3,7,1190,0,47.7274,-122.357,1390,1756,2426,3146,1190,14,14
3,1,1210,9730,1,0,0,4,7,1210,0,47.762,-122.355,1470,9730,10940,11200,1210,66,66
4,2.25,2200,9351,1,0,0,5,7,1290,910,47.7448,-122.333,1910,8660,11551,10570,2200,57,57
2,1.75,1270,7560,1,0,0,4,7,1270,0,47.7083,-122.357,1480,7560,8830,9040,1270,87,87
2,1,1070,6678,1,0,0,4,7,1070,0,47.7315,-122.357,1680,7788,7748,9468,1070,68,68
4,2.75,2200,5207,1,0,0,5,7,1120,1080,47.74,-122.343,1210,6008,7407,7218,2200,68,68
2,1.5,980,1296,2,0,0,3,7,840,140,47.7075,-122.336,1100,1228,2276,2328,980,18,18
3,1.5,1340,7912,1,0,0,3,7,1340,0,47.7658,-122.339,1480,7940,9252,9420,1340,64,64
2,1.75,1340,1050,3,0,0,3,8,1340,0,47.7053,-122.343,1340,1090,2390,2430,1340,10,10
4,2.5,3060,10043,1,0,0,4,8,1700,1360,47.7387,-122.337,1630,8296,13103,9926,3060,51,51
4,1.5,1810,6583,1,0,0,3,7,1500,310,47.7273,-122.351,860,8670,8393,9530,1810,51,51
2,1.5,1190,1265,3,0,0,3,7,1190,0,47.7274,-122.357,1390,1756,2455,3146,1190,14,14
2,1,820,6366,1,0,0,5,6,820,0,47.7512,-122.34,1580,10169,7186,11749,820,67,67
3,1.75,1640,4579,1,0,0,4,6,1640,0,47.7061,-122.352,1580,5040,6219,6620,1640,103,103
2,1,1340,9840,1,0,0,3,7,1340,0,47.7202,-122.339,1610,8949,11180,10559,1340,70,70
2,1.5,990,1380,3,0,0,3,7,990,0,47.7218,-122.356,1050,1380,2370,2430,990,18,18
3,1,1120,8443,1,0,0,3,7,1120,0,47.7715,-122.336,1450,8433,9563,9883,1120,66,66
3,1,1000,3844,1,0,0,5,7,900,100,47.7031,-122.349,1000,3920,4844,4920,1000,91,91
3,2.25,1400,1320,3,0,2,3,8,1400,0,47.7147,-122.356,1490,1449,2720,2939,1400,13,13
4,3.75,2560,5250,2,0,0,3,7,1900,660,47.7326,-122.342,1400,5250,7810,6650,2560,56,9
3,2.5,1930,7120,1,0,0,4,7,1420,510,47.7715,-122.34,1600,8352,9050,9952,1930,58,58
3,1.5,1220,1086,3,0,0,3,8,1220,0,47.7049,-122.353,1220,1422,2306,2642,1220,12,12
2,1,1070,6000,1,0,0,3,7,1070,0,47.7307,-122.332,1490,7622,7070,9112,1070,64,64
4,2.5,2730,9260,2,0,0,3,8,2730,0,47.7222,-122.331,2730,7357,11990,10087,2730,11,11
3,1,1060,9241,1,0,0,4,7,1060,0,47.7465,-122.339,1900,6484,10301,8384,1060,63,63
3,3.25,1380,1225,3,0,0,3,7,1380,0,47.7035,-122.351,1380,1704,2605,3084,1380,19,19
2,2.5,1370,1140,2,0,0,3,8,1080,290,47.7055,-122.342,1340,1050,2510,2390,1370,10,10
3,1,1810,7200,1,0,0,4,7,1130,680,47.7493,-122.351,1810,8100,9010,9910,1810,65,65
3,2.5,2160,10200,1,0,0,3,7,1360,800,47.7295,-122.331,2010,7850,12360,9860,2160,41,41
1,1,700,5621,1,0,0,4,6,700,0,47.734,-122.353,1020,5621,6321,6641,700,74,74
2,1.5,1160,1103,2,0,0,3,7,890,270,47.7677,-122.315,1160,1086,2263,2246,1160,13,13
3,2,1310,1361,3,0,0,3,7,1310,0,47.7337,-122.343,1370,1608,2671,2978,1310,16,16
3,1.5,1460,5040,1,0,0,3,7,1100,360,47.7112,-122.357,2330,7560,6500,9890,1460,48,48
5,2.75,2600,8160,2,0,0,3,8,2600,0,47.7348,-122.34,1600,8160,10760,9760,2600,4,4
4,1.75,1950,10219,1,0,0,3,7,1950,0,47.7492,-122.336,1500,9099,12169,10599,1950,57,57
4,2.25,1450,7245,1,0,0,5,7,1450,0,47.7643,-122.343,1660,7800,8695,9460,1450,69,31
2,1,830,5720,1,0,0,4,6,830,0,47.7339,-122.339,1150,5250,6550,6400,830,69,69
3,1.75,1430,9750,1,0,0,5,7,1430,0,47.7441,-122.357,1630,9282,11180,10912,1430,57,57
3,3.25,1651,1779,2,0,0,3,8,1341,310,47.7076,-122.346,1650,2908,3430,4558,1651,11,11
2,1,1250,9270,1,0,0,4,7,1250,0,47.7284,-122.339,1130,6800,10520,7930,1250,71,71
3,1,960,3844,1,0,0,3,7,960,0,47.7027,-122.346,1020,3844,4804,4864,960,47,47
2,1,780,8160,1,0,0,4,6,780,0,47.7356,-122.34,1310,8160,8940,9470,780,66,66
3,1,1130,7200,1,0,0,4,6,1130,0,47.7298,-122.355,1350,1358,8330,2708,1130,77,77
4,2.5,2240,5402,2,0,0,3,8,2240,0,47.772,-122.35,2240,7560,7642,9800,2240,14,14
4,3.25,2780,7875,2,0,0,3,9,2780,0,47.7294,-122.352,1000,7500,10655,8500,2780,13,13
4,2.75,1700,7495,1,0,0,4,7,1200,500,47.7589,-122.354,1650,7495,9195,9145,1700,55,55
3,2.25,1660,8307,1,0,0,4,8,1660,0,47.7575,-122.352,2510,7800,9967,10310,1660,58,58
4,2.5,2400,7092,2,0,0,3,7,2400,0,47.7522,-122.338,2350,8310,9492,10660,2400,22,22
3,1.75,1890,9100,2,0,0,4,7,1890,0,47.7676,-122.339,1640,9100,10990,10740,1890,67,67
5,2.5,2990,9240,2,0,0,3,8,2990,0,47.7384,-122.348,1970,18110,12230,20080,2990,4,4
3,2.5,1650,1793,3,0,0,3,8,1650,0,47.7107,-122.332,1650,1863,3443,3513,1650,12,12
4,2.5,2180,7204,2,0,0,3,8,2180,0,47.7221,-122.352,1500,7650,9384,9150,2180,5,5
4,2.5,2000,5962,2,0,0,3,8,2000,0,47.7695,-122.35,1790,10500,7962,12290,2000,20,20
3,2,1260,7560,2,0,0,5,6,1260,0,47.7225,-122.351,1260,7595,8820,8855,1260,76,76
2,1,1130,8081,1,0,0,4,7,1130,0,47.7064,-122.355,1220,7800,9211,9020,1130,98,98
4,1.75,1590,10523,2,0,0,4,7,1590,0,47.7358,-122.342,1610,8568,12113,10178,1590,97,97
2,1.5,1090,847,3,0,0,3,8,1090,0,47.7235,-122.352,1090,1118,1937,2208,1090,10,10
4,2,1970,7451,1,0,0,3,8,1350,620,47.765,-122.335,1980,7510,9421,9490,1970,57,57
3,2,1750,9000,1,0,0,4,5,1750,0,47.7489,-122.35,1830,8100,10750,9930,1750,83,83
4,1.75,2020,6200,1,0,0,4,6,1010,1010,47.7013,-122.35,1440,4158,8220,5598,2020,71,71
4,2.5,2620,8960,1,0,0,5,7,1520,1100,47.7642,-122.335,1880,8960,11580,10840,2620,64,64
3,2.25,2280,6150,2,0,2,3,8,2280,0,47.5423,-122.385,1920,6150,8430,8070,2280,35,35
5,2.25,2240,5500,1,0,0,3,7,1490,750,47.5305,-122.391,2010,6050,7740,8060,2240,60,60
4,2,1920,4822,1,0,0,2,6,920,1000,47.5507,-122.381,1120,4822,6742,5942,1920,105,105
2,1,610,4560,1,0,0,3,5,610,0,47.5498,-122.383,930,1392,5170,2322,610,101,101
3,1.75,1530,4000,2,0,0,3,8,1530,0,47.5239,-122.388,2140,5000,5530,7140,1530,34,34
2,3,1410,1240,2,0,0,3,8,1140,270,47.5221,-122.39,1410,1273,2650,2683,1410,13,13
3,1.75,1680,6200,1,0,0,3,7,1680,0,47.5338,-122.384,1680,5100,7880,6780,1680,103,103
2,1,610,4000,1,0,0,4,6,610,0,47.5469,-122.391,870,5160,4610,6030,610,101,101
2,2,1250,1178,2,0,0,3,7,980,270,47.5426,-122.387,1270,1242,2428,2512,1250,23,23
2,1,1010,14244,1,1,4,1,5,1010,0,47.5476,-122.399,1820,15792,15254,17612,1010,93,93
3,1,1040,6250,1,0,0,3,7,1040,0,47.5526,-122.385,1770,6250,7290,8020,1040,77,77
4,2.75,3520,19200,1,1,4,4,9,1950,1570,47.525,-122.393,2450,7000,22720,9450,3520,68,68
3,1,1070,4505,1,0,2,4,7,1070,0,47.5305,-122.384,1380,4505,5575,5885,1070,100,100
3,3.5,2270,4088,2,0,0,3,8,1880,390,47.5356,-122.384,1760,5425,6358,7185,2270,23,23
4,1,1200,6600,1,0,2,3,7,1200,0,47.5372,-122.382,1810,6600,7800,8410,1200,111,111
2,2.25,1350,1493,2,0,0,3,8,1050,300,47.5421,-122.388,1250,1202,2843,2452,1350,12,12
2,1,690,5200,1,0,0,3,6,690,0,47.556,-122.395,1380,5700,5890,7080,690,101,101
3,1,1100,4184,1,0,0,4,7,1100,0,47.5309,-122.382,1630,4366,5284,5996,1100,54,54
4,2,1820,7200,1,0,0,3,7,1300,520,47.5161,-122.388,1770,8149,9020,9919,1820,43,43
2,1,840,892,2,0,0,3,7,840,0,47.5396,-122.387,1030,1007,1732,2037,840,13,13
2,1.75,1060,1202,2,0,0,3,7,760,300,47.5426,-122.388,1060,1493,2262,2553,1060,16,16
1,1.5,1010,5750,1,0,0,3,7,1010,0,47.5411,-122.392,1230,5750,6760,6980,1010,108,66
2,1,970,3279,2,0,0,3,7,790,180,47.5469,-122.383,1150,1351,4249,2501,970,12,12
2,1.5,1160,8060,1,0,0,4,7,1160,0,47.5146,-122.386,1500,8060,9220,9560,1160,69,69
3,1,1660,5100,1,0,0,3,7,1260,400,47.5323,-122.383,1230,5100,6760,6330,1660,62,62
1,1,750,4000,1,0,0,3,6,750,0,47.5243,-122.39,1770,4850,4750,6620,750,101,101
5,1.5,2540,6660,2,0,3,4,8,2340,200,47.5144,-122.393,2460,9000,9200,11460,2540,65,65
3,2,2460,6600,1,0,2,4,8,1370,1090,47.5215,-122.383,2150,6600,9060,8750,2460,67,67
4,1,1660,10656,1,0,0,4,7,1180,480,47.5391,-122.385,1120,8816,12316,9936,1660,99,99
2,2,1180,3200,1,0,1,4,6,590,590,47.5275,-122.383,1350,4000,4380,5350,1180,74,74
3,1.75,1710,5000,1,0,0,4,7,1360,350,47.5492,-122.389,1490,6250,6710,7740,1710,101,101
4,3.5,2490,5500,2,0,0,3,9,1780,710,47.5499,-122.393,1710,5500,7990,7210,2490,4,4
2,1.5,830,1333,2,0,0,3,7,830,0,47.5506,-122.381,1120,4822,2163,5942,830,14,14
2,1.5,1840,9000,1,0,2,3,8,1340,500,47.5281,-122.388,1880,7560,10840,9440,1840,62,62
5,1.75,1910,5428,1,0,0,3,8,1390,520,47.5333,-122.392,1820,5900,7338,7720,1910,65,65
4,1.5,1780,8400,1,0,0,3,7,1080,700,47.5173,-122.385,1660,8400,10180,10060,1780,50,50
4,2.25,2770,5320,2,0,1,3,9,2440,330,47.5283,-122.385,2100,6011,8090,8111,2770,6,6
3,1.75,1820,3140,2,0,0,5,8,1820,0,47.5271,-122.384,2030,5499,4960,7529,1820,70,24
4,3,1490,6766,1,0,1,5,7,1490,0,47.5446,-122.382,1990,6526,8256,8516,1490,104,104
4,1.5,1440,3200,1,0,1,4,7,960,480,47.5269,-122.383,1650,6400,4640,8050,1440,59,59
2,1,1170,5000,1,0,0,4,7,1030,140,47.5449,-122.388,1170,5850,6170,7020,1170,99,99
2,1,850,6213,1,0,0,3,6,750,100,47.5282,-122.384,1880,5500,7063,7380,850,103,103
2,2.25,1300,2104,2,0,0,3,8,1010,290,47.5477,-122.388,1430,1850,3404,3280,1300,8,8
2,1,1120,12625,1,0,3,3,7,1120,0,47.5397,-122.385,1880,6828,13745,8708,1120,79,79
4,3.75,2130,34689,1,1,4,3,9,2130,0,47.5489,-122.398,3030,28598,36819,31628,2130,64,64
1,1,640,4800,1,0,0,3,6,640,0,47.5551,-122.382,1250,2847,5440,4097,640,101,101
3,2,1980,2674,3,0,0,3,8,1980,0,47.5524,-122.382,1440,2674,4654,4114,1980,12,12
2,2,1110,1155,3,0,0,3,7,980,130,47.5496,-122.388,1110,1089,2265,2199,1110,11,11
4,3,1986,6000,2,0,2,4,8,1746,240,47.5374,-122.39,1930,6200,7986,8130,1986,97,97
2,1,2280,37500,2,0,0,3,7,2280,0,47.525,-122.389,2360,6000,39780,8360,2280,87,87
3,2,1870,3378,1,0,0,3,7,1120,750,47.5371,-122.393,1870,1872,5248,3742,1870,106,106
3,1.75,1940,7313,1,0,1,4,8,1440,500,47.5239,-122.387,2160,7200,9253,9360,1940,59,59
4,1,1490,6000,1,0,0,3,7,1490,0,47.5518,-122.385,1700,6000,7490,7700,1490,101,101
3,1.75,2150,4333,1,0,0,3,7,1200,950,47.5537,-122.388,1480,6500,6483,7980,2150,63,63
3,1,1290,6859,1,0,0,4,7,1290,0,47.5317,-122.387,1560,6369,8149,7929,1290,78,78
4,1,1010,6000,1,0,0,3,6,750,260,47.5518,-122.383,1450,6000,7010,7450,1010,94,94
3,1,1210,5750,1,0,0,4,7,1210,0,47.5403,-122.391,1160,5000,6960,6160,1210,109,109
4,2.5,2560,7210,2,0,0,3,9,2560,0,47.5535,-122.395,2160,10439,9770,12599,2560,13,13
2,2.5,1233,1244,2,0,0,3,7,963,270,47.5533,-122.381,1230,1300,2477,2530,1233,12,12
2,1.75,1030,1066,2,0,0,3,7,765,265,47.5394,-122.387,1030,1106,2096,2136,1030,13,13
3,2,1300,6000,1,0,0,5,7,1300,0,47.5482,-122.392,1230,6000,7300,7230,1300,76,76
2,1,1570,4704,1,0,1,3,8,1570,0,47.5256,-122.392,1820,4704,6274,6524,1570,88,88
2,1,1220,6300,1,0,0,3,7,760,460,47.5299,-122.387,1850,4886,7520,6736,1220,77,77
2,1,920,5120,1,0,0,5,7,920,0,47.5569,-122.394,1190,5120,6040,6310,920,67,67
2,2.5,1278,987,2,0,0,3,7,1002,276,47.5532,-122.381,1220,1287,2265,2507,1278,12,12
2,1,1000,6500,1,0,0,4,7,1000,0,47.5474,-122.388,1280,6500,7500,7780,1000,101,101
3,2.5,1520,1304,2,0,0,3,8,1180,340,47.5446,-122.385,1270,1718,2824,2988,1520,13,13
2,1,780,4132,1,0,0,3,7,780,0,47.5324,-122.387,1100,5100,4912,6200,780,77,77
3,1.75,1710,4080,1,0,0,4,7,1130,580,47.5563,-122.392,1200,4080,5790,5280,1710,40,40
3,2.5,1500,5412,1,0,0,5,7,900,600,47.5499,-122.394,1090,5412,6912,6502,1500,99,99
3,2.25,1670,1596,3,0,0,3,8,1670,0,47.5402,-122.387,1640,1310,3266,2950,1670,5,5
2,2,1540,7290,2,0,0,3,7,1540,0,47.551,-122.395,1540,7072,8830,8612,1540,71,31
2,1,790,5120,1,0,0,3,6,790,0,47.557,-122.395,1250,5120,5910,6370,790,69,69
2,1,770,4800,1,0,0,3,7,770,0,47.527,-122.383,1390,4800,5570,6190,770,76,76
3,1.5,2230,6000,1,0,1,3,8,1260,970,47.5373,-122.395,2120,7200,8230,9320,2230,51,51
5,1,1950,6250,1,0,0,4,7,1450,500,47.5511,-122.386,1950,6250,8200,8200,1950,102,102
3,1.75,1760,8400,1,0,0,4,8,1460,300,47.5355,-122.39,1980,8400,10160,10380,1760,59,59
3,2.5,3310,5300,2,0,2,3,8,2440,870,47.5178,-122.389,2140,7500,8610,9640,3310,11,11
2,1,910,7200,1,0,1,4,7,830,80,47.5145,-122.39,1700,7200,8110,8900,910,83,83
3,2.5,2510,5503,2,0,2,3,9,2510,0,47.5419,-122.383,1790,6099,8013,7889,2510,24,24
2,1.5,1860,5100,1,0,0,3,7,1060,800,47.5573,-122.392,1710,5100,6960,6810,1860,79,79
2,2,1280,4095,2,0,0,4,8,1280,0,47.5501,-122.393,1470,5500,5375,6970,1280,101,101
3,2.25,1590,926,3,0,0,3,8,1590,0,47.5402,-122.387,1640,1321,2516,2961,1590,5,5
4,2.5,2300,9900,1,0,2,3,8,1600,700,47.5256,-122.385,2510,7500,12200,10010,2300,58,58
4,2.75,1670,6000,1,0,0,5,7,840,830,47.5496,-122.385,1100,6000,7670,7100,1670,102,102
3,2,1150,700,2,0,0,3,7,800,350,47.5552,-122.381,1060,1910,1850,2970,1150,19,19
2,1,1010,4000,1,0,0,3,7,1010,0,47.5311,-122.382,1480,4366,5010,5846,1010,72,72
4,2.75,2900,6400,2,0,0,3,7,2040,860,47.5563,-122.393,1340,6144,9300,7484,2900,108,44
2,1,1040,6900,1,0,0,4,7,1040,0,47.5411,-122.391,1620,6280,7940,7900,1040,104,104
2,1,900,8556,1,0,0,3,6,760,140,47.5148,-122.386,1500,8556,9456,10056,900,78,78
3,1.75,2060,5721,1,0,2,3,9,1140,920,47.5268,-122.388,2060,8124,7781,10184,2060,55,55
4,2.75,3370,8103,1,0,3,3,9,1970,1400,47.5232,-122.383,2120,6360,11473,8480,3370,49,0
3,1.5,1660,5100,1,0,0,4,7,1210,450,47.5345,-122.383,1440,5100,6760,6540,1660,65,65
3,1.5,1520,4288,1,0,0,3,7,1020,500,47.5284,-122.387,1660,4288,5808,5948,1520,70,70
4,2.5,2700,5100,1,0,0,4,8,1440,1260,47.5331,-122.384,1880,5100,7800,6980,2700,51,51
3,2.75,1250,1655,2,0,0,3,7,830,420,47.5554,-122.382,1520,3001,2905,4521,1250,13,13
4,1,1280,4840,1,0,0,3,7,940,340,47.5477,-122.395,1360,4840,6120,6200,1280,69,69
2,1,840,5510,1,0,0,3,7,840,0,47.5247,-122.391,1630,5510,6350,7140,840,64,64
2,1,820,4234,1,0,1,3,6,820,0,47.5294,-122.386,1550,4236,5054,5786,820,68,68
3,2,1610,4160,1,0,0,4,7,1010,600,47.5421,-122.388,1040,4400,5770,5440,1610,102,102
2,2,1300,3850,1,0,0,3,7,800,500,47.5395,-122.39,950,5500,5150,6450,1300,56,56
4,2,2060,6000,1,0,1,4,8,1370,690,47.5237,-122.383,2060,6600,8060,8660,2060,65,65
4,3.5,3210,5000,3,0,0,3,9,3210,0,47.5203,-122.393,1360,5000,8210,6360,3210,5,5
3,3.25,2130,2306,2,0,1,5,7,1420,710,47.5424,-122.391,1560,4500,4436,6060,2130,95,95
2,2.75,1350,1252,2,0,0,3,8,1120,230,47.522,-122.39,1410,1265,2602,2675,1350,13,13
4,1.75,1570,3250,1,0,0,5,8,1570,0,47.5405,-122.393,1570,5720,4820,7290,1570,91,91
3,2,1160,3441,1,0,0,4,6,580,580,47.5314,-122.392,1160,4000,4601,5160,1160,89,89
3,2.75,1970,5200,1,0,3,3,8,1970,0,47.5374,-122.388,2140,5200,7170,7340,1970,104,13
2,1,940,9839,1,0,0,3,6,940,0,47.5379,-122.386,1330,8740,10779,10070,940,109,109
3,1.75,1720,5899,1,0,1,3,8,1220,500,47.5399,-122.385,1900,6244,7619,8144,1720,33,33
4,3,1960,5000,1,0,0,5,7,1050,910,47.5208,-122.393,1360,5000,6960,6360,1960,54,54
3,2.5,1690,1310,2,0,0,3,8,1140,550,47.5404,-122.387,1640,1321,3000,2961,1690,15,15
3,2.5,2530,7000,2,0,4,3,9,2530,0,47.5465,-122.398,2380,7000,9530,9380,2530,104,16
2,1,1620,9855,1,0,4,3,8,1320,300,47.5264,-122.384,1820,7700,11475,9520,1620,71,71
3,1.5,1730,6240,1,0,1,3,8,1000,730,47.5282,-122.391,1620,6240,7970,7860,1730,65,65
3,2.5,2380,16080,1,0,2,4,9,1340,1040,47.5262,-122.386,2560,10070,18460,12630,2380,55,55
3,2.5,1400,2036,2,0,0,3,7,1400,0,47.5516,-122.382,1500,2036,3436,3536,1400,16,16
3,2.5,1420,814,2,0,0,3,8,1140,280,47.5429,-122.387,1340,1382,2234,2722,1420,11,11
3,1,1400,4800,1,0,0,4,6,700,700,47.5499,-122.391,1470,6000,6200,7470,1400,102,102
3,1.75,2360,7291,1,0,0,4,8,1360,1000,47.5274,-122.384,1860,5499,9651,7359,2360,71,71
3,2.5,1720,1715,2,0,0,3,7,1240,480,47.5481,-122.384,1610,1626,3435,3236,1720,15,15
3,1.75,1490,5000,1,0,1,3,8,1250,240,47.5257,-122.392,1980,5000,6490,6980,1490,65,65
3,2,1060,1184,2,0,0,3,7,730,330,47.5443,-122.385,1270,1601,2244,2871,1060,13,13
3,1.75,2190,6450,1,0,0,3,8,1480,710,47.5284,-122.391,2190,6450,8640,8640,2190,62,62
2,1,720,7500,1,0,2,3,6,720,0,47.5185,-122.392,1390,5000,8220,6390,720,94,94
2,1.75,1490,4800,1,0,0,4,7,750,740,47.5496,-122.391,1400,6000,6290,7400,1490,101,101
3,1.75,1240,7200,1,0,0,5,7,1240,0,47.5142,-122.389,1640,7200,8440,8840,1240,77,77
4,2,2490,4700,1,0,0,4,7,1690,800,47.5254,-122.392,2240,5000,7190,7240,2490,67,67
3,1,1260,24550,1,0,2,4,7,1260,0,47.5442,-122.396,2500,12320,25810,14820,1260,82,82
3,3,2920,23085,1,0,2,3,7,1540,1380,47.5159,-122.395,2270,18180,26005,20450,2920,111,111
3,1.5,1350,6000,1,0,2,3,7,900,450,47.5275,-122.391,1730,6012,7350,7742,1350,69,69
2,1,960,6250,1,0,0,3,6,960,0,47.5491,-122.386,1350,6250,7210,7600,960,103,103
2,1,870,7500,1,0,0,3,7,870,0,47.5465,-122.384,1240,5709,8370,6949,870,72,72
5,1,2230,16800,1,0,3,4,7,1700,530,47.5161,-122.395,2730,18400,19030,21130,2230,96,96
5,3.25,5210,35765,2,0,4,5,10,4940,270,47.5463,-122.397,2590,10250,40975,12840,5210,108,108
2,1,760,6035,1,0,0,3,6,760,0,47.5443,-122.382,2110,6046,6795,8156,760,99,99
4,1,2080,3500,1,0,0,5,7,1260,820,47.5445,-122.383,1380,5900,5580,7280,2080,93,93
2,1,1080,7775,1,0,0,3,6,1080,0,47.5447,-122.394,1730,7350,8855,9080,1080,64,64
3,2.25,2940,6500,3,0,0,3,9,2940,0,47.5482,-122.388,1680,6500,9440,8180,2940,5,5
3,2.5,2060,8778,1,0,0,3,8,1160,900,47.5245,-122.384,1990,7560,10838,9550,2060,66,4
3,1,1590,6420,1,0,0,3,7,1590,0,47.5355,-122.392,1780,5900,8010,7680,1590,75,75
3,1.75,1340,6250,1,0,0,4,7,1090,250,47.5427,-122.386,1550,1755,7590,3305,1340,78,78
3,2.25,1430,800,2,0,0,3,8,1140,290,47.5477,-122.388,1430,1387,2230,2817,1430,8,8
3,1.75,2160,5760,1,0,0,4,8,1260,900,47.5346,-122.391,2090,5760,7920,7850,2160,65,65
2,1.75,960,6200,1,0,0,4,7,960,0,47.5551,-122.396,1000,6000,7160,7000,960,73,73
3,2,2000,7000,2,0,0,3,7,2000,0,47.5452,-122.393,1840,7000,9000,8840,2000,103,28
2,1,720,5750,1,0,0,2,6,720,0,47.5535,-122.393,980,6125,6470,7105,720,76,76
2,1,1030,4366,1,0,0,3,7,1030,0,47.5311,-122.384,1890,4499,5396,6389,1030,107,107
3,2,1840,6000,1,0,0,4,6,1840,0,47.5508,-122.392,2010,6000,7840,8010,1840,111,70
2,1,1210,5600,1,0,0,3,7,1210,0,47.5322,-122.392,1400,5028,6810,6428,1210,97,97
3,1.75,1120,5500,1,0,0,4,7,1120,0,47.5445,-122.391,1490,5500,6620,6990,1120,94,94
2,1.75,1550,7800,1,0,0,3,7,1050,500,47.5436,-122.39,1370,5000,9350,6370,1550,79,79
3,2,3030,9374,1,0,1,4,7,2100,930,47.5289,-122.391,1990,6012,12404,8002,3030,60,60
3,1.75,1300,4800,2,0,1,4,7,1300,0,47.5457,-122.383,1300,4800,6100,6100,1300,107,107
3,2.5,1350,874,3,0,0,3,8,1270,80,47.549,-122.387,1350,886,2224,2236,1350,13,13
3,1,1480,17360,1,0,1,3,8,1480,0,47.5179,-122.387,2250,8720,18840,10970,1480,65,65
1,1,1370,6250,1,0,0,4,7,1370,0,47.5571,-122.385,1450,6250,7620,7700,1370,98,98
4,1.5,2810,7140,1,0,2,3,8,1490,1320,47.5252,-122.382,2240,6825,9950,9065,2810,65,65
3,2.5,1970,23180,1,1,4,3,8,1100,870,47.5495,-122.398,3030,34689,25150,37719,1970,82,16
4,1.5,1810,6000,1,0,1,3,8,1350,460,47.5233,-122.386,2020,6000,7810,8020,1810,67,67
3,2.5,1350,886,3,0,0,3,8,1270,80,47.5491,-122.387,1350,886,2236,2236,1350,13,13
4,2.75,2840,4000,1,0,0,5,8,1960,880,47.5846,-122.291,2750,4000,6840,6750,2840,107,107
5,2,2080,4000,1,0,0,4,6,1040,1040,47.5858,-122.308,1940,6000,6080,7940,2080,110,110
4,2.5,2880,3091,2,0,0,3,9,1940,940,47.5711,-122.286,1560,4080,5971,5640,2880,5,5
5,2.5,2840,5000,1,0,0,4,7,1620,1220,47.5817,-122.291,2200,5000,7840,7200,2840,106,106
3,2,2060,4080,1,0,0,5,7,1060,1000,47.574,-122.289,1400,4080,6140,5480,2060,98,98
3,3.5,1820,1501,2,0,0,3,8,1430,390,47.596,-122.298,1550,1501,3321,3051,1820,5,5
4,2.75,2880,4000,1,0,0,3,9,2100,780,47.5843,-122.293,2110,4000,6880,6110,2880,107,14
3,2.5,1300,1362,2,0,0,3,8,880,420,47.5893,-122.317,1300,1251,2662,2551,1300,11,11
4,1.75,1580,5340,1,0,0,3,7,1130,450,47.6003,-122.306,830,980,6920,1810,1580,72,72
2,1,1050,4125,1,0,0,4,7,1050,0,47.5736,-122.307,1650,4125,5175,5775,1050,110,110
4,2.75,2220,5310,1,0,0,5,7,1170,1050,47.5801,-122.294,1540,4200,7530,5740,2220,68,68
5,1.75,2740,9600,1,0,0,4,7,1370,1370,47.5738,-122.315,1990,4800,12340,6790,2740,74,74
3,2,1500,2506,1,0,0,3,7,870,630,47.5962,-122.301,1500,4662,4006,6162,1500,16,16
3,2,2540,7200,1,0,3,4,8,1600,940,47.5972,-122.292,2040,5900,9740,7940,2540,114,114
3,2.25,1400,1078,2,0,0,3,8,940,460,47.5701,-122.288,1420,1230,2478,2650,1400,10,10
2,1.25,860,1277,2,0,0,3,7,860,0,47.5842,-122.314,1280,1265,2137,2545,860,12,12
5,2.5,2000,3600,1,0,0,3,6,1150,850,47.5971,-122.295,1410,3600,5600,5010,2000,32,32
3,3.25,3990,8505,2,0,2,3,9,2870,1120,47.5744,-122.283,3640,8505,12495,12145,3990,97,15
4,1.75,1690,4080,1,0,0,4,7,870,820,47.572,-122.289,1320,4080,5770,5400,1690,35,35
4,2.25,2200,7200,1,0,2,4,8,1220,980,47.5818,-122.296,1940,6000,9400,7940,2200,61,61
5,2.75,2220,4000,1,0,0,3,7,1230,990,47.5754,-122.305,1580,4000,6220,5580,2220,46,46
3,1.75,1760,3520,1,0,0,3,7,1160,600,47.5773,-122.303,1840,5000,5280,6840,1760,53,53
3,2,1400,2445,1,0,0,3,7,840,560,47.5926,-122.299,1400,3200,3845,4600,1400,17,17
4,2.75,2620,13777,1,0,2,4,9,1720,900,47.58,-122.285,3530,9287,16397,12817,2620,93,93
5,2,2020,4000,2,0,0,3,7,2020,0,47.5799,-122.305,1960,4000,6020,5960,2020,69,69
2,1,670,1675,1,0,0,5,6,670,0,47.5918,-122.295,1220,1740,2345,2960,670,59,59
4,3.5,3090,4060,2,0,0,3,8,2420,670,47.5733,-122.287,1720,4080,7150,5800,3090,27,27
3,2.5,1300,812,2,0,0,3,8,880,420,47.5893,-122.317,1300,824,2112,2124,1300,11,11
5,4.25,4830,8050,2,0,2,4,11,3710,1120,47.5789,-122.286,4470,9194,12880,13664,4830,105,105
2,1,1010,3916,1,0,2,4,6,810,200,47.5728,-122.306,1580,3888,4926,5468,1010,101,101
3,1,1190,3600,1,0,0,3,6,1190,0,47.5985,-122.298,1680,3600,4790,5280,1190,115,115
5,2.5,2340,6000,2,0,0,4,10,2340,0,47.5764,-122.287,2350,6000,8340,8350,2340,97,97
5,3.25,3840,4800,3,0,3,3,10,2750,1090,47.5929,-122.29,2060,4800,8640,6860,3840,11,11
2,1.5,950,676,2,0,0,3,7,850,100,47.6005,-122.306,950,1280,1626,2230,950,16,16
2,1,670,2356,1,0,0,5,6,670,0,47.5918,-122.295,1220,1740,3026,2960,670,59,59
2,2.25,3900,14864,1,0,3,3,8,1950,1950,47.5884,-122.291,2580,5184,18764,7764,3900,72,72
5,3.75,5340,10655,2,0,3,4,10,3740,1600,47.5795,-122.285,3910,9418,15995,13328,5340,107,107
2,2.5,2330,3000,2,0,3,3,8,2330,0,47.5953,-122.294,1760,4000,5330,5760,2330,104,21
5,3.25,2700,3650,2,0,2,3,9,2070,630,47.5959,-122.291,1940,4000,6350,5940,2700,93,0
2,1,1290,1289,2,0,0,3,7,1030,260,47.6006,-122.305,1290,1332,2579,2622,1290,14,14
3,2.5,1495,936,3,0,0,3,8,1405,90,47.593,-122.295,1495,1186,2431,2681,1495,13,13
6,2.5,3550,6533,2,0,0,3,8,3550,0,47.5719,-122.284,3140,6234,10083,9374,3550,94,94
3,1.5,1310,2996,2,0,0,3,7,1310,0,47.5879,-122.299,1310,2997,4306,4307,1310,21,21
3,2.5,3000,5000,1,0,0,4,7,2110,890,47.5781,-122.293,1970,5000,8000,6970,3000,101,101
3,1,1050,5402,1,0,0,4,7,1050,0,47.5867,-122.311,1510,4685,6452,6195,1050,113,113
2,1,1150,3600,1,0,0,3,6,1150,0,47.5729,-122.31,1160,4000,4750,5160,1150,109,109
3,3.5,2480,3200,2,0,0,3,10,2480,0,47.5951,-122.307,1980,3200,5680,5180,2480,9,9
4,3.25,1900,2631,2,0,0,3,9,1250,650,47.5869,-122.311,1710,4502,4531,6212,1900,5,5
4,2.75,2990,7389,1,0,0,4,8,2090,900,47.5711,-122.284,2510,6157,10379,8667,2990,96,96
3,1,1240,3600,1,0,0,3,7,1240,0,47.5986,-122.298,1680,3600,4840,5280,1240,117,117
5,3.5,4870,7700,2,0,3,5,10,3650,1220,47.5832,-122.29,3220,7700,12570,10920,4870,90,90
3,1.75,2160,5863,1,0,0,4,7,1260,900,47.5729,-122.315,1590,3000,8023,4590,2160,91,91
3,2.25,1322,1796,2,0,0,3,8,1087,235,47.5976,-122.298,1690,2025,3118,3715,1322,14,14
3,1.75,1880,5978,1,0,0,5,7,940,940,47.5793,-122.294,1930,4770,7858,6700,1880,62,62
1,1.5,1120,912,3,0,0,3,7,1120,0,47.5924,-122.299,1380,3200,2032,4580,1120,8,8
4,1.5,1980,3240,1,0,0,4,8,1780,200,47.584,-122.294,2250,4000,5220,6250,1980,89,89
2,1.75,2320,5500,1,0,2,3,8,1720,600,47.586,-122.292,2380,5000,7820,7380,2320,94,14
3,2.5,2230,4000,2,0,0,3,7,2230,0,47.5801,-122.306,1310,4000,6230,5310,2230,65,65
3,2,1340,1951,1,0,0,3,6,670,670,47.5763,-122.309,1520,2248,3291,3768,1340,104,104
4,3,3000,4000,1,0,3,3,8,1970,1030,47.5744,-122.307,1900,4000,7000,5900,3000,106,0
3,3,3420,7826,2,0,0,4,8,2430,990,47.5873,-122.29,980,6300,11246,7280,3420,80,80
3,2.75,1160,1073,2,0,0,3,7,880,280,47.5788,-122.315,1250,5400,2233,6650,1160,12,12
3,1,1130,3600,1,0,0,3,6,1130,0,47.5978,-122.299,1710,2231,4730,3941,1130,111,111
4,2,2670,3240,1,0,0,4,9,1780,890,47.5841,-122.294,1820,4000,5910,5820,2670,89,89
3,1.75,2070,5000,1,0,0,3,8,2070,0,47.5828,-122.291,2630,5000,7070,7630,2070,99,99
2,1,1100,3598,1,0,0,4,7,1100,0,47.5738,-122.313,1240,3598,4698,4838,1100,93,93
4,2.5,2080,4080,1,0,0,5,7,1040,1040,47.572,-122.29,1340,4080,6160,5420,2080,57,57
2,1.5,820,1270,2,0,0,3,7,820,0,47.5925,-122.295,1130,1201,2090,2331,820,10,10
3,2.5,1540,1564,2,0,0,3,7,1300,240,47.586,-122.313,1540,2875,3104,4415,1540,21,21
3,1,1790,3876,1,0,0,5,7,1090,700,47.575,-122.288,1360,4080,5666,5440,1790,115,115
3,2,1610,3600,2,0,2,5,8,1610,0,47.5969,-122.293,2540,6600,5210,9140,1610,94,94
3,2.5,1480,1165,3,0,0,3,8,1480,0,47.6199,-122.3,1480,1231,2645,2711,1480,13,13
2,1.5,940,1768,2,0,0,3,7,940,0,47.5925,-122.295,1130,1159,2708,2289,940,10,10
4,2.75,2640,8400,1,0,2,3,8,1440,1200,47.5882,-122.29,2610,6000,11040,8610,2640,72,72
3,2.25,3650,5353,2,0,4,4,7,2200,1450,47.5949,-122.291,1950,4970,9003,6920,3650,72,72
2,1.5,1040,3500,1,0,0,4,6,1040,0,47.588,-122.304,1340,1213,4540,2553,1040,115,115
4,3.5,3160,4200,2,0,4,3,8,2180,980,47.5963,-122.292,2180,5200,7360,7380,3160,20,20
4,2,1880,3840,1,0,0,3,7,970,910,47.5929,-122.303,1670,1820,5720,3490,1880,115,115
3,3.75,1580,1303,2,0,0,3,8,1340,240,47.5875,-122.315,1560,1294,2883,2854,1580,9,9
3,2,1490,1286,3,0,0,3,8,1490,0,47.57,-122.288,1420,1230,2776,2650,1490,5,5
3,2.25,1310,915,2,0,0,3,7,1060,250,47.5738,-122.293,1500,1215,2225,2715,1310,12,12
4,2.5,1530,2248,1,0,0,3,7,1530,0,47.5766,-122.309,1340,3700,3778,5040,1530,105,105
3,1.75,2340,4206,1,0,0,5,7,1170,1170,47.5759,-122.288,1360,4725,6546,6085,2340,102,102
3,1,1280,6726,1,0,0,3,6,1280,0,47.5724,-122.301,1630,5000,8006,6630,1280,61,61
3,1.75,1900,3783,1,0,0,5,7,1110,790,47.5742,-122.315,1530,5098,5683,6628,1900,92,92
3,1.5,1010,1546,2,0,0,3,8,1010,0,47.5998,-122.311,1010,1517,2556,2527,1010,48,1
3,2.5,2670,5000,2,0,3,5,9,2000,670,47.5855,-122.292,2320,5000,7670,7320,2670,77,19
2,1.5,1620,3760,2,0,0,5,7,1170,450,47.6012,-122.291,2130,4000,5380,6130,1620,95,95
2,1.5,1160,1648,2,0,0,3,7,1160,0,47.5916,-122.293,1458,2351,2808,3809,1160,17,17
3,1.75,1458,858,2,0,0,3,8,950,508,47.592,-122.293,1458,3000,2316,4458,1458,5,5
3,2,1320,6000,1,0,0,4,7,1320,0,47.5752,-122.304,1620,4000,7320,5620,1320,99,99
2,1,1090,6000,1,0,0,3,7,1090,0,47.5886,-122.292,1960,5000,7090,6960,1090,97,97
5,2.75,1970,5400,1,0,0,3,7,1320,650,47.5868,-122.308,1280,2150,7370,3430,1970,33,33
4,1,2320,4000,1,0,0,3,6,1310,1010,47.573,-122.312,1750,4000,6320,5750,2320,98,98
3,2.25,1530,1840,2,0,0,3,8,1240,290,47.587,-122.301,1800,3431,3370,5231,1530,11,11
4,1.75,1720,4240,1,0,0,4,7,1460,260,47.579,-122.294,1930,4280,5960,6210,1720,94,94
3,1.75,1510,6597,1,0,0,4,6,950,560,47.5938,-122.315,1460,5320,8107,6780,1510,80,80
2,1.5,1240,1892,2,0,0,3,7,1240,0,47.5915,-122.295,1220,1740,3132,2960,1240,17,17
4,1.75,1500,1856,1,0,0,5,7,750,750,47.5917,-122.296,1220,1739,3356,2959,1500,118,118
2,1.5,1000,1075,2,0,0,3,7,840,160,47.5708,-122.288,1000,1083,2075,2083,1000,12,12
4,2.75,2930,4408,1,0,0,5,8,1660,1270,47.5841,-122.295,2200,4000,7338,6200,2930,80,80
2,1.5,830,920,2,0,0,3,7,830,0,47.5998,-122.306,830,1200,1750,2030,830,14,14
4,1.5,3390,6200,2,0,0,4,8,2530,860,47.58,-122.29,3080,6000,9590,9080,3390,103,103
3,1,1410,7200,2,0,0,4,6,1410,0,47.5924,-122.302,1640,7200,8610,8840,1410,118,118
5,3.5,2880,3750,2,0,2,3,8,2270,610,47.5905,-122.292,2060,4000,6630,6060,2880,18,18
3,1.5,1220,4080,1,0,0,5,7,1220,0,47.5746,-122.289,1320,4080,5300,5400,1220,105,105
3,1.75,1340,2805,1,0,0,3,7,1340,0,47.5922,-122.297,1650,2805,4145,4455,1340,100,100
4,1.75,1620,4240,1,0,0,5,7,1620,0,47.5746,-122.311,1450,4240,5860,5690,1620,103,103
3,1,1200,4000,1,0,0,4,6,1200,0,47.5881,-122.299,1390,4000,5200,5390,1200,96,96
2,1,1840,4322,1,0,0,4,7,1160,680,47.5764,-122.289,1750,4322,6162,6072,1840,105,105
4,2,1960,5008,1,0,0,3,6,980,980,47.5958,-122.299,1175,2315,6968,3490,1960,119,27
2,2.5,1050,1609,2,0,0,3,7,1050,0,47.5854,-122.313,1120,1693,2659,2813,1050,14,14
4,2,2410,8712,1,0,0,3,7,1260,1150,47.5729,-122.302,2220,6038,11122,8258,2410,61,61
3,1.5,1420,1192,2,0,0,3,8,1140,280,47.5881,-122.304,1340,1213,2612,2553,1420,11,11
3,1.75,2700,5040,1,0,2,3,8,1560,1140,47.5834,-122.29,3010,5000,7740,8010,2700,72,72
3,2.5,1550,930,2,0,0,3,8,1060,490,47.5857,-122.314,1550,1301,2480,2851,1550,13,13
3,2.25,2580,6000,2,0,0,3,8,1780,800,47.5778,-122.289,2300,5995,8580,8295,2580,94,94
3,2.5,1200,813,3,0,0,3,9,1200,0,47.5894,-122.315,1750,4365,2013,6115,1200,9,9
4,2,2090,4000,1,0,0,3,6,1060,1030,47.5893,-122.299,1590,4000,6090,5590,2090,112,112
3,1.75,2870,5000,1,0,0,4,8,1840,1030,47.5788,-122.292,2200,5000,7870,7200,2870,112,112
2,1.5,1240,1101,2,0,0,3,8,1080,160,47.5758,-122.309,1530,1209,2341,2739,1240,10,10
2,1,770,5040,1,0,0,3,5,770,0,47.5964,-122.299,1330,2580,5810,3910,770,89,89
4,2,1660,4788,1,0,0,3,7,1660,0,47.5878,-122.312,1150,5000,6448,6150,1660,51,51
1,1,730,1942,1,0,0,3,7,730,0,47.5943,-122.299,1020,2044,2672,3064,730,10,10
2,1,1070,2196,1,0,0,4,7,880,190,47.5726,-122.308,1160,3600,3266,4760,1070,102,102
3,3.5,1820,1991,2,0,0,3,8,1430,390,47.596,-122.298,1550,1460,3811,3010,1820,5,5
3,1.75,1530,825,3,0,0,3,8,1530,0,47.5929,-122.308,1580,1915,2355,3495,1530,4,4
3,2.5,1260,972,2,0,0,3,8,840,420,47.5872,-122.316,1270,925,2232,2195,1260,11,11
1,1,730,1942,1,0,0,3,7,730,0,47.5939,-122.299,1020,2183,2672,3203,730,11,11
3,1.5,1240,4080,1,0,0,3,8,1240,0,47.5745,-122.291,1420,4080,5320,5500,1240,105,105
4,2.25,2300,4600,1,0,0,4,7,1340,960,47.5895,-122.311,1540,3000,6900,4540,2300,115,115
5,1.75,2510,6000,1,0,0,5,8,2010,500,47.5798,-122.292,2240,5000,8510,7240,2510,99,99
2,2.25,1230,1280,2,0,0,3,8,960,270,47.5942,-122.298,1130,1357,2510,2487,1230,7,7
3,2.25,1430,2003,2,0,0,3,8,980,450,47.5908,-122.292,2210,4000,3433,6210,1430,23,23
2,1,1310,4000,1,0,0,3,7,950,360,47.5798,-122.306,1310,4000,5310,5310,1310,77,77
5,3,2510,4125,1,0,3,5,8,1590,920,47.5968,-122.29,2190,5415,6635,7605,2510,94,94
2,1.5,830,1119,2,0,0,3,7,830,0,47.5828,-122.314,1480,3622,1949,5102,830,14,14
3,3.25,5020,12431,2,1,4,3,10,3420,1600,47.5925,-122.287,3680,12620,17451,16300,5020,78,12
3,2.25,1780,4252,2,0,0,4,8,1540,240,47.6004,-122.292,2220,4000,6032,6220,1780,30,30
2,1,760,3001,1,0,0,3,6,760,0,47.5874,-122.311,1750,5000,3761,6750,760,106,106
4,2.5,2500,4000,2,0,0,3,8,2500,0,47.5902,-122.311,1480,4300,6500,5780,2500,5,5
3,2,2260,7200,1,0,3,3,7,1130,1130,47.5886,-122.288,2260,6000,9460,8260,2260,78,78
3,1.75,2080,5687,1,0,0,4,8,2080,0,47.5776,-122.289,2300,5995,7767,8295,2080,95,95
2,2,1730,4248,2,0,0,3,7,1730,0,47.5933,-122.308,1380,4000,5978,5380,1730,114,114
4,1,2290,6300,1,0,4,4,7,2150,140,47.5917,-122.29,2390,6300,8590,8690,2290,98,98
2,1.5,1300,4000,1,0,0,4,6,1300,0,47.5937,-122.301,1480,4000,5300,5480,1300,119,119
2,1,1270,3700,1,0,0,3,7,1270,0,47.5949,-122.307,1980,3200,4970,5180,1270,110,110
3,2.5,2550,4954,1,0,0,4,7,1850,700,47.5758,-122.287,1700,4954,7504,6654,2550,95,95
1,1,620,5100,1,0,0,3,6,620,0,47.5699,-122.287,1540,2676,5720,4216,620,65,65
4,2,2230,5000,1,0,0,4,7,1510,720,47.5772,-122.292,2140,5000,7230,7140,2230,97,97
3,2.25,1350,980,2,0,0,3,8,1050,300,47.5998,-122.312,1350,1245,2330,2595,1350,12,12
4,1.5,2430,4995,1,0,0,4,7,1730,700,47.5782,-122.292,2240,5000,7425,7240,2430,91,91
4,4.25,4250,6552,2,0,3,4,10,2870,1380,47.5747,-122.283,3640,8841,10802,12481,4250,11,11
4,2,1490,5300,1,0,0,3,7,1110,380,47.5949,-122.296,1330,1499,6790,2829,1490,42,42
2,1.5,800,2142,2,0,0,3,7,800,0,47.5917,-122.297,1320,2742,2942,4062,800,13,13
2,1.5,980,853,2,0,0,3,7,820,160,47.5925,-122.295,1130,1270,1833,2400,980,10,10
4,2.75,2300,3175,1,0,0,3,6,1340,960,47.5732,-122.305,1260,3175,5475,4435,2300,53,53
2,1.5,1180,844,2,0,0,3,7,990,190,47.5998,-122.3,1170,1400,2024,2570,1180,14,14
2,3,1160,1073,2,0,0,3,7,880,280,47.5788,-122.315,1250,4812,2233,6062,1160,12,12
5,1.75,1650,3000,1,0,0,3,8,1650,0,47.5955,-122.306,1740,4000,4650,5740,1650,117,117
2,1,1790,3760,1,0,0,4,8,1490,300,47.5926,-122.293,1458,3760,5550,5218,1790,107,107
3,1,1380,4635,1,0,0,4,6,1380,0,47.57,-122.285,1790,4635,6015,6425,1380,100,100
4,2.5,2200,3141,2,0,0,3,7,2060,140,47.5726,-122.305,1660,3175,5341,4835,2200,25,25
3,1,810,4600,1,0,0,3,6,810,0,47.5712,-122.316,1520,4800,5410,6320,810,101,101
2,1,870,2676,1,0,0,3,7,820,50,47.5702,-122.287,1500,1719,3546,3219,870,15,15
3,3.25,3030,5600,2,0,2,3,9,2220,810,47.5978,-122.292,2040,6600,8630,8640,3030,114,10
1,1,1160,5000,2,0,0,3,7,1160,0,47.5883,-122.311,2060,5000,6160,7060,1160,19,19
4,1,1610,2982,1,0,0,4,7,1610,0,47.587,-122.294,1610,4040,4592,5650,1610,94,94
3,1,950,3621,1,0,0,4,6,950,0,47.575,-122.289,1540,4080,4571,5620,950,72,72
4,2.5,3070,7830,2,0,2,3,11,1970,1100,47.593,-122.291,2440,4682,10900,7122,3070,10,10
4,3.5,2830,4000,1,0,0,3,7,1840,990,47.5842,-122.292,2340,4000,6830,6340,2830,100,1
3,1.75,1680,4240,1,0,0,4,7,1680,0,47.5745,-122.311,1460,4240,5920,5700,1680,93,93
4,1,1400,3600,1,0,0,4,6,700,700,47.5972,-122.295,1690,3600,5000,5290,1400,118,118
4,3.5,3190,5040,2,0,3,3,10,2160,1030,47.5928,-122.29,2390,4800,8230,7190,3190,16,16
3,1.5,1320,3145,2,0,0,3,7,1320,0,47.5909,-122.297,1320,3002,4465,4322,1320,21,21
2,1,1040,4000,1,0,0,3,6,1040,0,47.5753,-122.303,1740,4000,5040,5740,1040,105,105
2,1,780,1133,2,0,0,3,7,780,0,47.5924,-122.295,1130,1270,1913,2400,780,10,10
4,3.5,4440,8125,2,0,3,5,10,3140,1300,47.5744,-122.283,3990,8505,12565,12495,4440,97,97
2,0.75,1020,1076,2,0,0,3,7,1020,0,47.5941,-122.299,1020,1357,2096,2377,1020,11,11
3,2,1990,3000,1,0,2,5,8,1430,560,47.5891,-122.293,1780,5000,4990,6780,1990,92,92
2,1,900,2728,2,0,0,3,7,900,0,47.5877,-122.298,900,2728,3628,3628,900,21,21
6,3.75,2740,6924,1,0,2,3,7,1640,1100,47.5816,-122.296,1940,6000,9664,7940,2740,57,57
2,2.25,1240,1172,2,0,0,3,8,1000,240,47.5877,-122.316,1260,1111,2412,2371,1240,11,11
2,2.5,1950,2457,3,0,0,3,8,1950,0,47.5925,-122.302,1650,1639,4407,3289,1950,10,10
2,1,930,3100,1,0,0,3,6,930,0,47.5943,-122.302,1670,3800,4030,5470,930,108,108
4,2,2050,4000,1,0,0,5,7,1210,840,47.5799,-122.306,1310,4000,6050,5310,2050,78,78
5,2,2220,6000,1,0,0,4,7,1390,830,47.5822,-122.295,1600,6000,8220,7600,2220,94,94
4,2.5,1720,3515,2,0,2,3,8,1470,250,47.591,-122.293,1140,2208,5235,3348,1720,19,19
4,1,980,3000,1,0,0,4,7,980,0,47.5892,-122.312,1525,3000,3980,4525,980,105,105
3,3.5,3350,5025,2,0,2,3,8,2670,680,47.5699,-122.296,2030,5117,8375,7147,3350,5,5
2,1.5,1660,4680,1,0,0,5,6,830,830,47.5134,-122.388,1930,5400,6340,7330,1660,111,111
4,2.5,2090,7434,1,0,0,3,7,1090,1000,47.4962,-122.349,1260,8404,9524,9664,2090,26,26
4,2.5,2620,4050,2,0,0,3,8,2620,0,47.5017,-122.34,2030,3944,6670,5974,2620,5,5
2,1,1040,4590,1,0,0,3,7,1040,0,47.5078,-122.337,1040,6120,5630,7160,1040,65,65
3,1.75,1420,7200,1,0,0,3,7,1000,420,47.5069,-122.367,1550,8640,8620,10190,1420,40,40
3,1.5,1200,5000,1,0,0,3,6,1200,0,47.5122,-122.357,1440,2500,6200,3940,1200,40,40
3,1,1110,7962,1,0,0,3,7,1110,0,47.5035,-122.36,1200,8094,9072,9294,1110,57,57
3,1,1640,8100,1,0,0,3,6,1040,600,47.482,-122.34,1600,8100,9740,9700,1640,80,80
4,1,1460,18599,1,0,0,3,5,1460,0,47.5006,-122.351,1320,8100,20059,9420,1460,79,79
3,2.5,2370,9000,1,0,3,4,8,1570,800,47.4922,-122.365,2120,9500,11370,11620,2370,67,67
3,1,1370,6000,1,0,0,3,7,1370,0,47.4879,-122.339,1370,9520,7370,10890,1370,64,64
2,1,1030,8786,1,0,0,3,6,1030,0,47.4814,-122.341,1480,8121,9816,9601,1030,63,63
3,2.5,1730,3600,2,0,0,3,8,1730,0,47.5014,-122.34,2030,3600,5330,5630,1730,5,5
3,1,1120,5000,1,0,0,3,6,1120,0,47.5109,-122.357,1050,5000,6120,6050,1120,102,102
4,2.75,2180,8480,1,0,3,4,7,1210,970,47.4961,-122.366,2240,8497,10660,10737,2180,60,60
3,1,1160,8636,1,0,0,3,6,1160,0,47.5097,-122.357,1300,8636,9796,9936,1160,96,96
4,2.5,2960,20240,2,0,4,4,10,2960,0,47.5075,-122.389,2500,14960,23200,17460,2960,34,34
3,1,840,4495,1,0,0,3,6,840,0,47.496,-122.349,1260,7434,5335,8694,840,98,98
3,1,770,6552,1,0,0,3,6,670,100,47.5133,-122.372,920,7200,7322,8120,770,77,77
3,1,1010,10215,1,0,0,3,6,1010,0,47.4872,-122.345,1320,10245,11225,11565,1010,64,64
3,1,1300,7200,1,0,0,4,7,1300,0,47.5063,-122.369,1740,7100,8500,8840,1300,67,67
4,2,2070,7980,1,0,0,4,7,2070,0,47.5092,-122.386,1600,7980,10050,9580,2070,79,79
4,2.5,1620,5280,2,0,0,4,7,1620,0,47.5132,-122.384,1590,5280,6900,6870,1620,95,43
3,3.5,2620,10137,2,0,0,3,8,1970,650,47.4979,-122.371,1960,7680,12757,9640,2620,27,27
3,2,1700,11475,1,0,0,5,6,970,730,47.4851,-122.338,1560,11475,13175,13035,1700,74,74
4,2,2630,9099,1,0,0,3,7,1830,800,47.5067,-122.361,1430,6825,11729,8255,2630,75,5
4,2.5,2240,6920,1,0,0,5,8,1380,860,47.5011,-122.375,1540,7000,9160,8540,2240,45,45
3,3,3610,17483,2,0,2,4,8,3610,0,47.4852,-122.357,2230,12600,21093,14830,3610,65,65
2,1.5,800,5192,1,0,0,5,7,800,0,47.5119,-122.386,1190,5320,5992,6510,800,68,68
2,1,940,8384,1,0,0,3,5,940,0,47.5065,-122.364,1290,8384,9324,9674,940,72,72
3,2.5,1950,3000,2,0,0,3,7,1950,0,47.4938,-122.337,1620,6000,4950,7620,1950,18,18
2,1,890,8100,1,0,0,3,6,890,0,47.4839,-122.34,1260,8100,8990,9360,890,77,77
3,1,1070,8179,1,0,0,3,6,1070,0,47.5015,-122.349,1050,8177,9249,9227,1070,70,70
4,3.5,2530,3000,2,0,0,3,8,1850,680,47.4919,-122.336,1470,6000,5530,7470,2530,5,5
2,0.75,900,3527,1,0,0,3,6,900,0,47.5083,-122.336,1220,4080,4427,5300,900,80,80
4,2,1220,9147,1,0,0,5,7,1220,0,47.5011,-122.336,1220,8576,10367,9796,1220,66,66
3,2,960,9380,1,0,0,3,6,960,0,47.4852,-122.343,1460,9240,10340,10700,960,70,70
3,1.5,1490,10367,1,0,0,3,7,1010,480,47.4973,-122.347,1000,8254,11857,9254,1490,62,62
4,2.5,1960,14242,1,0,1,4,8,1290,670,47.4947,-122.369,2490,10907,16202,13397,1960,61,61
2,1,1170,8254,1,0,0,2,6,1170,0,47.497,-122.346,1820,8922,9424,10742,1170,70,70
4,1,2240,7620,1,0,0,3,7,1120,1120,47.5089,-122.346,1080,7620,9860,8700,2240,53,53
3,2.5,2600,23361,1,1,4,3,8,2150,450,47.4997,-122.379,1700,14700,25961,16400,2600,107,107
2,1,1240,12092,1,0,0,3,6,960,280,47.4957,-122.352,1820,7460,13332,9280,1240,97,31
4,1,1310,8640,1,0,0,3,6,910,400,47.5104,-122.342,1310,8640,9950,9950,1310,71,71
4,2.5,2420,10285,1,0,4,3,8,1700,720,47.4871,-122.36,2540,9900,12705,12440,2420,61,61
3,2.25,1630,9145,1,0,0,3,7,1630,0,47.5,-122.347,1630,9206,10775,10836,1630,59,59
3,1,1040,6860,2,0,0,3,6,1040,0,47.5121,-122.375,1030,6512,7900,7542,1040,77,77
2,1,810,8382,1,0,0,4,5,810,0,47.5033,-122.358,1040,8382,9192,9422,810,77,77
3,2,2330,6346,1,0,0,3,6,1600,730,47.5135,-122.38,1380,8400,8676,9780,2330,85,0
2,1,780,5000,1,0,0,4,6,780,0,47.5112,-122.357,1030,5000,5780,6030,780,76,76
3,0.75,850,8573,1,0,0,3,6,600,250,47.503,-122.356,850,8382,9423,9232,850,74,74
3,2.5,2290,6328,2,0,0,3,8,2290,0,47.5103,-122.382,1600,6180,8618,7780,2290,18,18
3,1.75,1820,15570,1,0,2,3,8,1820,0,47.5068,-122.386,2490,9480,17390,11970,1820,71,71
3,3.25,2260,7701,2,0,0,3,8,1760,500,47.5053,-122.377,1880,7529,9961,9409,2260,19,19
4,1,1290,5000,1,0,0,3,7,1290,0,47.5128,-122.358,1440,2500,6290,3940,1290,62,62
3,1,1700,8645,1,0,0,3,6,1700,0,47.4899,-122.337,1500,7980,10345,9480,1700,64,64
4,2.25,3500,13875,1,0,4,4,9,1830,1670,47.5083,-122.388,2960,15000,17375,17960,3500,81,81
3,1,1790,6120,1,0,0,3,6,1790,0,47.508,-122.337,830,6120,7910,6950,1790,82,50
3,1,960,8291,1,0,0,3,6,960,0,47.5006,-122.334,1110,8231,9251,9341,960,69,69
2,1,1130,5236,1,0,0,4,6,1130,0,47.5103,-122.386,1010,5320,6366,6330,1130,77,77
3,1,1190,5280,1,0,0,4,7,1190,0,47.5131,-122.383,1280,5280,6470,6560,1190,62,62
3,2,1580,5080,1,0,0,4,6,800,780,47.4963,-122.35,1580,7114,6660,8694,1580,77,77
3,1,1050,6300,1,0,0,3,6,1050,0,47.5128,-122.374,740,6300,7350,7040,1050,77,77
4,2.5,2750,13950,1,0,3,4,8,1380,1370,47.4938,-122.364,2460,13950,16700,16410,2750,71,71
5,3,2420,11250,2,0,0,3,8,2420,0,47.5082,-122.362,1510,9950,13670,11460,2420,6,6
3,2.25,1330,7200,1,0,0,3,7,900,430,47.5102,-122.364,1380,9570,8530,10950,1330,45,45
3,1.75,1270,8100,1,0,0,3,6,880,390,47.4828,-122.344,1650,8173,9370,9823,1270,69,69
3,3.5,3030,11550,2,0,2,3,8,3030,0,47.5051,-122.381,2340,10560,14580,12900,3030,48,3
3,1,1130,12212,1,0,0,3,6,1130,0,47.4952,-122.34,1190,9240,13342,10430,1130,77,77
2,1,900,5220,1,0,0,4,6,900,0,47.5105,-122.387,1480,6660,6120,8140,900,63,63
2,1,920,8341,1,0,0,3,7,920,0,47.5015,-122.38,2330,9792,9261,12122,920,80,80
5,2.25,2060,8632,1,0,0,3,7,1030,1030,47.4877,-122.335,1010,11680,10692,12690,2060,57,57
3,1.75,1250,8100,1,0,0,3,7,1250,0,47.5016,-122.348,1300,8175,9350,9475,1250,68,11
2,1,740,6460,1,0,0,3,6,740,0,47.5077,-122.344,1170,6975,7200,8145,740,66,66
3,1,1050,6240,1,0,0,5,5,1050,0,47.4933,-122.338,1410,6240,7290,7650,1050,71,71
4,2.25,2420,11120,1,0,2,4,8,1620,800,47.4954,-122.366,2210,8497,13540,10707,2420,67,67
5,2.75,3060,7015,1,0,0,5,8,1600,1460,47.5052,-122.372,2190,7600,10075,9790,3060,40,40
4,2.5,2120,13780,2,0,0,3,8,2120,0,47.4987,-122.365,1880,12000,15900,13880,2120,26,26
2,1.75,1440,11210,1,0,0,4,6,1130,310,47.498,-122.35,1250,9381,12650,10631,1440,84,84
3,1,910,6000,1,0,0,2,6,910,0,47.5065,-122.338,1090,6957,6910,8047,910,63,63
2,2,1190,7570,1,0,0,3,6,1190,0,47.5113,-122.338,1190,7635,8760,8825,1190,80,80
1,0.75,410,8636,1,0,0,2,4,410,0,47.5077,-122.357,1190,8636,9046,9826,410,66,66
2,1,600,4000,1,0,0,3,5,600,0,47.5065,-122.339,1290,6973,4600,8263,600,86,86
2,2,2180,18525,1,1,4,5,9,1580,600,47.5036,-122.387,2480,21503,20705,23983,2180,67,67
3,1.75,1480,9375,1,0,0,4,7,1480,0,47.5076,-122.366,1370,9000,10855,10370,1480,62,62
3,2.5,1400,3368,2,0,0,3,7,1400,0,47.5134,-122.342,1400,4316,4768,5716,1400,6,6
3,2.75,2730,38869,1,1,4,3,9,1940,790,47.4857,-122.361,2630,28188,41599,30818,2730,56,13
3,2.5,1930,8254,2,0,0,3,7,1930,0,47.4973,-122.346,1540,8849,10184,10389,1930,5,5
2,1,670,10920,1,0,0,3,6,670,0,47.5128,-122.372,900,7425,11590,8325,670,77,77
3,1.75,1780,5000,1,0,0,3,6,1080,700,47.5105,-122.36,1500,5000,6780,6500,1780,62,62
3,3,3250,5093,2,0,3,3,10,3250,0,47.5123,-122.39,2820,7752,8343,10572,3250,15,15
4,2.25,2270,9464,1,0,0,4,7,1520,750,47.5007,-122.359,1770,9464,11734,11234,2270,79,79
5,1.75,2440,15143,1,0,4,4,8,1740,700,47.4948,-122.37,2390,10907,17583,13297,2440,75,75
4,2.25,1720,7803,1,0,0,3,8,1350,370,47.5119,-122.337,1720,7803,9523,9523,1720,64,64
2,0.75,550,7980,1,0,0,3,5,550,0,47.511,-122.348,1330,7980,8530,9310,550,67,67
3,2.5,1970,14876,1,0,0,3,7,1320,650,47.5031,-122.372,2030,8008,16846,10038,1970,38,38
3,1,1140,8775,1,0,0,3,6,990,150,47.4824,-122.336,1300,8775,9915,10075,1140,77,77
4,2.5,2130,4028,2,0,0,3,8,2130,0,47.5108,-122.363,1830,7817,6158,9647,2130,5,5
3,1.5,1890,9450,1,0,0,3,7,1090,800,47.4829,-122.341,1470,8100,11340,9570,1890,62,62
3,1,1060,5600,1,0,0,4,6,760,300,47.5116,-122.379,1310,5600,6660,6910,1060,76,76
6,1.5,1930,8400,1,0,0,3,7,1030,900,47.4869,-122.34,1780,9520,10330,11300,1930,48,48
3,2.25,1250,7500,1,0,0,5,7,1250,0,47.5123,-122.373,1280,7392,8750,8672,1250,77,77
3,1,1090,6320,1,0,0,3,6,890,200,47.4976,-122.35,1460,7080,7410,8540,1090,65,65
3,1.5,1200,8040,1,0,0,4,7,1200,0,47.4901,-122.341,1450,9315,9240,10765,1200,60,60
4,1.5,1730,8505,1,0,0,4,7,1730,0,47.4905,-122.347,1510,8505,10235,10015,1730,58,58
5,2,2500,7804,1,0,0,3,7,1570,930,47.5031,-122.348,1170,7676,10304,8846,2500,98,98
3,1,990,8100,1,0,0,3,6,990,0,47.4839,-122.341,1210,8100,9090,9310,990,70,70
3,1.75,1260,17000,1,0,0,3,7,1260,0,47.5114,-122.361,1540,7213,18260,8753,1260,25,25
3,1,840,4495,1,0,0,3,6,840,0,47.496,-122.349,1260,7434,5335,8694,840,98,98
3,1.5,1210,12500,1,0,0,3,7,1210,0,47.503,-122.351,1210,12500,13710,13710,1210,57,57
3,2,1480,6600,1,0,2,3,7,740,740,47.5081,-122.385,1250,7300,8080,8550,1480,76,76
4,2,1300,7054,1,0,0,3,7,1300,0,47.5071,-122.369,1560,7100,8354,8660,1300,69,1
3,1.5,2400,8215,1,0,0,3,7,1200,1200,47.5001,-122.338,1460,8217,10615,9677,2400,58,58
2,1,2320,11250,2,0,0,4,6,2320,0,47.504,-122.362,1620,11250,13570,12870,2320,77,77
4,2.5,2130,4000,2,0,0,3,8,2130,0,47.5108,-122.362,1830,7217,6130,9047,2130,5,5
2,1.5,2340,13380,1,0,0,4,7,1280,1060,47.5017,-122.377,1490,8100,15720,9590,2340,65,65
3,1,1580,8308,1,0,0,3,7,1580,0,47.5075,-122.379,1200,8308,9888,9508,1580,71,71
3,1,1630,8308,1,0,0,3,7,1630,0,47.5075,-122.378,1170,8308,9938,9478,1630,71,71
2,1,2020,7200,1,0,3,4,7,1700,320,47.506,-122.384,2020,7200,9220,9220,2020,72,72
2,1.5,1300,6120,1,0,0,3,6,820,480,47.5088,-122.338,1250,6120,7420,7370,1300,74,74
3,1.75,1740,9500,1,0,3,4,8,1150,590,47.4919,-122.365,2110,9450,11240,11560,1740,61,61
2,1,860,5000,1,0,0,3,6,860,0,47.5133,-122.356,1220,5000,5860,6220,860,104,70
4,1.75,1490,9112,1,0,0,3,6,970,520,47.4991,-122.345,1650,8411,10602,10061,1490,79,79
3,1,990,9145,1,0,0,4,6,990,0,47.5022,-122.36,1640,8320,10135,9960,990,80,80
5,2.5,2070,9600,1,0,0,3,7,1270,800,47.4997,-122.364,1950,7800,11670,9750,2070,57,57
4,2.25,2870,5453,2,0,1,4,8,2220,650,47.5129,-122.388,1660,4800,8323,6460,2870,93,93
5,1.75,1710,11900,1,0,0,3,7,1070,640,47.506,-122.365,1030,10360,13610,11390,1710,61,61
4,1,1400,8684,1,0,0,3,7,1400,0,47.4887,-122.344,1520,8712,10084,10232,1400,62,62
3,1,860,10426,1,0,0,3,6,860,0,47.4987,-122.341,1140,11250,11286,12390,860,65,65
5,1.5,1950,9000,1,0,0,3,7,1130,820,47.4882,-122.339,1680,9526,10950,11206,1950,55,55
2,1,740,6250,1,0,0,3,6,740,0,47.506,-122.335,980,6957,6990,7937,740,77,77
2,1,770,8636,1,0,0,2,6,770,0,47.5075,-122.358,1110,8636,9406,9746,770,68,68
5,1,1260,8382,1,0,0,3,7,1260,0,47.5058,-122.355,910,8382,9642,9292,1260,101,101
4,1,2370,30200,1,0,0,4,7,1570,800,47.5108,-122.366,1640,9719,32570,11359,2370,71,71
4,2.5,2220,4228,2,0,0,3,8,2220,0,47.5014,-122.341,2220,4157,6448,6377,2220,5,5
3,2,1080,9225,1,0,0,2,7,1080,0,47.4842,-122.346,1410,9840,10305,11250,1080,64,64
6,2.75,3200,9200,1,0,2,4,8,1600,1600,47.492,-122.364,2220,9500,12400,11720,3200,66,66
3,1.5,1190,8726,1,0,0,3,7,1190,0,47.4887,-122.343,1390,8741,9916,10131,1190,63,63
4,2.5,1630,3060,2,0,0,3,7,1630,0,47.5072,-122.336,1270,4590,4690,5860,1630,16,16
1,1,720,7140,1,0,0,3,6,720,0,47.5119,-122.339,1140,7577,7860,8717,720,89,89
2,1,1510,19874,1,0,0,3,7,1510,0,47.4924,-122.34,1540,10000,21384,11540,1510,68,68
4,2.75,2360,15100,1,0,0,3,8,2360,0,47.5117,-122.365,1440,13346,17460,14786,2360,5,5
3,1,940,4700,1,0,0,4,6,940,0,47.5117,-122.378,1020,5700,5640,6720,940,77,77
3,2,1030,7260,1,0,0,3,6,1030,0,47.5113,-122.347,1380,8100,8290,9480,1030,72,72
5,1,1460,11726,1,0,0,3,6,1290,170,47.5039,-122.361,1460,10450,13186,11910,1460,83,83
5,2.75,2910,13332,2,0,0,4,8,2910,0,47.4977,-122.359,1760,8900,16242,10660,2910,79,23
3,1.75,1100,9452,1,0,0,3,6,1100,0,47.4864,-122.337,1350,9452,10552,10802,1100,77,77
1,1,1020,6871,1,0,0,3,6,1020,0,47.5051,-122.338,1260,6933,7891,8193,1020,82,68
4,1,1370,7140,2,0,0,3,6,1370,0,47.512,-122.376,1090,6300,8510,7390,1370,77,77
4,1.75,2030,5688,2,0,4,4,9,1730,300,47.5071,-122.387,2320,11107,7718,13427,2030,80,80
3,1,1030,4700,1,0,0,3,7,1030,0,47.5118,-122.377,1030,4700,5730,5730,1030,67,67
3,1,1000,9295,1,0,0,3,7,1000,0,47.484,-122.346,1320,13500,10295,14820,1000,64,64
3,1,1400,8710,1,0,0,4,7,1400,0,47.5066,-122.377,1460,8710,10110,10170,1400,71,71
3,2.5,1680,11312,1,0,0,3,7,1080,600,47.5051,-122.344,1390,10700,12992,12090,1680,60,60
6,2.75,2520,54160,2,1,4,3,7,2520,0,47.4969,-122.376,2790,26809,56680,29599,2520,65,65
2,1,1240,12092,1,0,0,3,6,960,280,47.4957,-122.352,1820,7460,13332,9280,1240,97,30
2,1,1500,8015,1,0,0,3,6,1500,0,47.5027,-122.348,1130,8015,9515,9145,1500,72,72
2,1.5,1670,9880,1,0,0,4,7,1670,0,47.4864,-122.348,1670,9807,11550,11477,1670,78,51
3,2,1420,6060,1,0,0,5,7,830,590,47.5102,-122.372,1420,6360,7480,7780,1420,77,77
3,1,940,7980,1,0,0,3,6,940,0,47.5107,-122.345,1050,7980,8920,9030,940,58,58
3,1.75,2140,13260,1,0,0,3,7,1240,900,47.5074,-122.353,1640,13260,15400,14900,2140,71,71
3,1.75,1660,5987,1,0,0,3,7,960,700,47.5107,-122.381,1510,6000,7647,7510,1660,37,37
3,2.5,1690,7460,1,0,0,3,7,870,820,47.4964,-122.353,1900,7302,9150,9202,1690,22,22
2,1,1310,7697,1,0,0,3,6,850,460,47.4982,-122.348,1270,6410,9007,7680,1310,69,69
3,2,2190,19800,1,0,0,3,7,2190,0,47.5106,-122.365,1640,9719,21990,11359,2190,25,25
3,1,860,10426,1,0,0,3,6,860,0,47.4987,-122.341,1140,11250,11286,12390,860,65,65
3,1,1780,5236,1,0,0,5,6,1050,730,47.5119,-122.386,1260,5320,7016,6580,1780,75,75
3,1,1250,8800,1,0,0,3,7,1250,0,47.497,-122.357,1480,8200,10050,9680,1250,64,64
3,1,940,8571,1,0,0,3,6,940,0,47.5006,-122.336,1100,8573,9511,9673,940,69,69
4,1,1120,8763,1,0,0,3,6,1120,0,47.508,-122.358,1120,8636,9883,9756,1120,48,48
3,1,1000,18513,1,0,0,3,6,1000,0,47.5118,-122.348,1280,8113,19513,9393,1000,79,79
4,1.75,2190,11625,1,0,0,4,8,2020,170,47.4979,-122.363,1920,8855,13815,10775,2190,63,63
4,1.75,2340,7200,1,0,0,3,8,1590,750,47.497,-122.369,1970,7800,9540,9770,2340,59,59
2,1.75,1660,11437,2,0,0,3,7,1660,0,47.4899,-122.339,1290,7860,13097,9150,1660,61,22
3,2.25,1900,7250,1,0,0,3,7,1250,650,47.4869,-122.344,1560,9420,9150,10980,1900,52,52
3,1.75,1830,9425,1,0,0,3,8,1590,240,47.5038,-122.379,1670,8430,11255,10100,1830,73,73
4,2.5,2510,7245,2,0,0,3,9,2510,0,47.5096,-122.363,1830,8900,9755,10730,2510,12,12
3,1,1280,9000,1,0,0,4,6,1280,0,47.4915,-122.338,1430,4500,10280,5930,1280,65,65
3,2,2168,12616,2,0,1,4,7,2168,0,47.4933,-122.367,2168,9750,14784,11918,2168,69,69
3,1,1700,8645,1,0,0,3,6,1700,0,47.4899,-122.337,1500,7980,10345,9480,1700,64,64
3,1,1780,7470,1,0,0,3,7,1050,730,47.5123,-122.337,1780,8113,9250,9893,1780,59,59
3,1,1120,7500,1,0,0,3,7,1120,0,47.5112,-122.359,1120,5000,8620,6120,1120,54,54
3,1,1120,7320,1,0,0,4,7,1120,0,47.5103,-122.382,1410,6328,8440,7738,1120,65,65
2,1,860,8636,1,0,0,3,6,860,0,47.5081,-122.356,1100,8636,9496,9736,860,95,95
2,2.5,2390,6928,2,0,3,4,8,1810,580,47.5101,-122.391,2390,12852,9318,15242,2390,70,32
2,1,940,6000,1,0,0,3,6,940,0,47.4907,-122.336,1310,6000,6940,7310,940,76,76
4,1.75,2290,10290,1,0,0,3,7,1340,950,47.5045,-122.369,1800,7605,12580,9405,2290,59,59
2,2,970,9750,1,0,0,5,6,970,0,47.5073,-122.372,1850,9000,10720,10850,970,79,79
3,2.5,1440,2500,2,0,0,3,7,1440,0,47.5123,-122.358,1440,5000,3940,6440,1440,11,11
4,1,1250,9102,1,0,0,3,7,1250,0,47.4258,-122.327,1260,9180,10352,10440,1250,64,64
3,2.25,1610,10454,1,0,0,3,7,1610,0,47.4517,-122.331,1720,9583,12064,11303,1610,42,42
3,1.5,1010,7755,1,0,0,3,6,1010,0,47.4238,-122.332,1270,8350,8765,9620,1010,66,66
3,1,1240,9300,1,0,0,3,7,1240,0,47.4363,-122.333,1250,9300,10540,10550,1240,65,65
3,2.5,1730,4004,2,0,0,3,7,1730,0,47.4317,-122.328,1730,5523,5734,7253,1730,20,20
2,1,930,10505,1,0,0,3,6,930,0,47.4337,-122.329,1520,8881,11435,10401,930,89,89
3,1.75,1580,9750,1,0,0,5,7,1580,0,47.427,-122.331,1460,9750,11330,11210,1580,65,65
3,1.5,1320,9750,1,0,0,3,7,1320,0,47.4267,-122.331,1530,9750,11070,11280,1320,65,65
3,1,890,9465,1,0,0,3,6,890,0,47.4388,-122.328,1590,9147,10355,10737,890,62,62
4,2.5,2490,11650,1,0,0,3,7,1390,1100,47.4416,-122.332,2010,10495,14140,12505,2490,29,29
3,2.5,1660,8125,1,0,0,3,7,1150,510,47.4373,-122.333,1250,8125,9785,9375,1660,20,20
3,2,1380,8682,1,0,0,4,7,1380,0,47.4238,-122.322,1410,10594,10062,12004,1380,53,53
3,1.5,1400,7582,1,0,0,3,7,1400,0,47.4536,-122.33,1280,7872,8982,9152,1400,63,63
2,1,1180,10200,1,0,0,4,7,1180,0,47.4358,-122.336,1330,10200,11380,11530,1180,64,64
2,1,930,7740,1,0,0,1,5,930,0,47.4611,-122.324,1620,8584,8670,10204,930,87,87
4,2.25,2400,7738,1,0,0,3,8,2400,0,47.4562,-122.33,2170,8452,10138,10622,2400,55,55
3,1.5,1510,9898,1,0,0,3,7,1110,400,47.4303,-122.334,1420,9250,11408,10670,1510,65,65
2,2,1140,8400,1,0,0,2,7,1140,0,47.4351,-122.335,1130,9375,9540,10505,1140,65,65
4,2.25,2000,10679,1,0,0,3,7,1350,650,47.4238,-122.329,1650,8875,12679,10525,2000,59,59
3,2,1380,8536,2,0,0,4,7,1380,0,47.4374,-122.335,1260,8750,9916,10010,1380,64,64
2,1,730,6728,1,0,0,3,6,730,0,47.4275,-122.324,1170,7034,7458,8204,730,66,66
4,2.5,2040,5523,2,0,0,3,7,2040,0,47.432,-122.328,1720,6646,7563,8366,2040,20,20
4,2.5,2210,9427,2,0,0,3,7,2210,0,47.4323,-122.327,1770,8770,11637,10540,2210,20,20
3,1.75,1770,8235,1,0,0,3,7,1030,740,47.4323,-122.328,1560,8918,10005,10478,1770,59,59
3,1.5,1180,9048,1,0,0,3,7,1180,0,47.4327,-122.328,1460,8942,10228,10402,1180,59,59
4,2.5,2670,8279,2,0,0,3,7,2670,0,47.4292,-122.328,2290,7504,10949,9794,2670,20,20
3,2.25,2170,8480,1,0,0,3,8,2170,0,47.4562,-122.33,2080,8452,10650,10532,2170,54,54
3,2.5,1760,8584,1,0,0,5,7,1760,0,47.4612,-122.325,2160,8584,10344,10744,1760,82,82
3,1.5,1460,9908,1,0,0,3,7,1460,0,47.4275,-122.331,1420,9582,11368,11002,1460,67,67
4,1.75,1320,7694,1,0,0,3,7,1320,0,47.4297,-122.325,1620,8468,9014,10088,1320,91,43
2,1,940,6000,1,0,0,2,7,940,0,47.4631,-122.329,1890,8547,6940,10437,940,65,65
3,1.75,1570,8750,1,0,0,3,7,1570,0,47.4425,-122.333,1890,8825,10320,10715,1570,59,59
4,1.5,2170,9948,2,0,0,3,7,2170,0,47.4263,-122.331,1500,9750,12118,11250,2170,67,67
3,1,1690,13825,1,0,0,3,7,1210,480,47.4256,-122.322,1190,9450,15515,10640,1690,64,64
3,1.5,1030,8223,1,0,0,4,7,1030,0,47.4282,-122.331,1460,9463,9253,10923,1030,67,67
3,1.5,1260,7964,1,0,0,4,7,1260,0,47.4307,-122.334,1510,8776,9224,10286,1260,64,64
5,4.25,3380,7805,2,0,0,3,8,3380,0,47.4349,-122.328,2790,7805,11185,10595,3380,5,5
3,1,1520,8870,1,0,0,4,7,1520,0,47.7638,-122.317,1520,7800,10390,9320,1520,68,68
2,1,1140,8340,1,0,0,3,7,1140,0,47.7448,-122.3,1030,8149,9480,9179,1140,71,71
3,2.75,2550,11160,2,0,0,3,8,2550,0,47.7351,-122.323,1020,7440,13710,8460,2550,25,25
3,1.75,1850,9655,1,0,0,3,7,1100,750,47.7358,-122.319,1480,8683,11505,10163,1850,60,60
2,1,890,8180,1,0,0,3,7,890,0,47.737,-122.3,1130,8180,9070,9310,890,72,72
3,1,1240,6090,1,0,0,4,7,1240,0,47.7542,-122.307,1550,9096,7330,10646,1240,69,69
4,1.75,1740,12204,1,0,0,3,7,1270,470,47.7675,-122.277,2190,12204,13944,14394,1740,58,58
4,1.75,1530,8152,1,0,0,5,6,910,620,47.7557,-122.328,1310,8152,9682,9462,1530,71,71
4,2.5,3830,11972,1,1,4,3,11,2370,1460,47.7404,-122.284,3080,12297,15802,15377,3830,38,38
4,1.75,2430,9747,1,0,0,3,8,1780,650,47.7687,-122.276,2340,10296,12177,12636,2430,45,45
2,1,770,8149,1,0,0,4,6,770,0,47.7439,-122.301,820,8149,8919,8969,770,71,71
4,2.5,2170,10500,1,0,0,3,7,1570,600,47.7512,-122.295,1850,11127,12670,12977,2170,57,57
3,1,1390,9624,1,0,0,4,7,1390,0,47.7758,-122.301,1440,9624,11014,11064,1390,65,65
5,2,2740,8230,1,0,0,3,7,2210,530,47.7352,-122.297,2130,8232,10970,10362,2740,57,57
4,2,1310,8454,1,0,0,4,7,1310,0,47.7572,-122.318,1320,8274,9764,9594,1310,66,66
3,1.5,1030,8414,1,0,0,4,7,1030,0,47.7654,-122.297,1750,8414,9444,10164,1030,52,52
3,1.75,1250,7710,1,0,0,4,7,1250,0,47.7623,-122.317,1340,7710,8960,9050,1250,72,72
2,2,1390,12530,1,0,0,3,8,970,420,47.7499,-122.29,1940,12530,13920,14470,1390,60,60
4,1.5,1250,8400,1,0,0,3,7,960,290,47.7505,-122.315,1560,8400,9650,9960,1250,68,68
3,1.5,1490,12186,1,0,0,4,7,1490,0,47.7739,-122.322,1180,14285,13676,15465,1490,69,69
3,3.5,2460,14155,2,0,0,3,8,1900,560,47.7743,-122.279,2440,14080,16615,16520,2460,5,5
2,1.5,1160,982,2,0,0,3,7,890,270,47.7675,-122.315,1160,1008,2142,2168,1160,13,13
6,4.5,3500,8504,2,0,0,3,7,3500,0,47.7351,-122.295,1550,8460,12004,10010,3500,39,39
3,1.75,1250,17493,1,0,0,3,7,1250,0,47.7613,-122.274,2180,19553,18743,21733,1250,47,47
3,2,1540,6000,1,0,0,4,6,1540,0,47.7372,-122.307,1490,8213,7540,9703,1540,66,66
4,1.75,2180,13529,1,0,0,3,7,1090,1090,47.7516,-122.294,2000,13529,15709,15529,2180,63,63
4,2.5,2820,8408,2,0,0,3,9,2820,0,47.7538,-122.325,1300,8408,11228,9708,2820,5,5
5,3.25,2860,20790,1,0,0,4,7,1800,1060,47.7757,-122.295,1920,9612,23650,11532,2860,54,54
4,2.25,1400,7341,1,0,0,3,7,1300,100,47.7565,-122.305,2090,7410,8741,9500,1400,58,58
4,2.5,2470,8536,2,0,0,3,8,2470,0,47.7699,-122.292,1690,8840,11006,10530,2470,17,17
3,1.5,1640,8301,1,0,0,3,7,1290,350,47.7443,-122.327,1640,8955,9941,10595,1640,61,61
4,1,1020,11383,1,0,0,5,6,1020,0,47.7429,-122.321,1290,11213,12403,12503,1020,72,72
3,2.5,2480,6031,2,0,0,3,8,2480,0,47.772,-122.297,1850,7704,8511,9554,2480,18,18
3,1.75,1600,8156,1,0,0,5,7,1600,0,47.7397,-122.3,1200,8156,9756,9356,1600,71,71
3,1.5,1270,20700,1,0,0,2,7,1150,120,47.7576,-122.296,1990,15000,21970,16990,1270,71,71
3,1.75,1490,10344,1,0,0,3,7,1490,0,47.7517,-122.326,1450,8632,11834,10082,1490,34,34
3,1.5,1180,8353,1,0,0,3,7,1180,0,47.7652,-122.274,1710,8748,9533,10458,1180,59,59
3,1.75,1170,8148,1,0,0,3,7,1170,0,47.7479,-122.318,1200,8147,9318,9347,1170,67,67
3,1.75,1830,10954,1,0,0,3,7,1830,0,47.7554,-122.306,1850,8624,12784,10474,1830,56,56
4,3,1900,9077,2,0,0,3,7,1900,0,47.7684,-122.304,1900,12868,10977,14768,1900,65,0
4,2.75,2870,8625,1,0,1,4,8,1860,1010,47.7425,-122.289,2430,8479,11495,10909,2870,60,60
2,1,1170,7142,1,0,0,3,7,1170,0,47.7497,-122.313,1170,7615,8312,8785,1170,68,68
2,1,840,7870,1,0,0,3,6,840,0,47.7389,-122.326,1442,8131,8710,9573,840,70,70
3,2.25,2210,11585,1,0,0,4,7,1510,700,47.7574,-122.279,1870,14092,13795,15962,2210,61,61
2,1,770,6731,1,0,0,4,6,770,0,47.7505,-122.312,1120,9212,7501,10332,770,76,76
3,1,1280,6967,1,0,0,3,7,1280,0,47.7512,-122.329,1280,7245,8247,8525,1280,70,70
4,3,2240,8504,2,0,0,3,7,2240,0,47.7348,-122.295,1570,8460,10744,10030,2240,27,27
2,1,1160,8504,1,0,0,4,7,1160,0,47.7364,-122.295,1320,8504,9664,9824,1160,70,70
3,1,1470,8200,1,0,0,3,7,1040,430,47.7347,-122.302,1420,8200,9670,9620,1470,66,66
3,2.75,2150,6576,1,0,0,4,7,1900,250,47.7539,-122.308,2150,9071,8726,11221,2150,93,93
3,1,1210,7649,1,0,0,4,7,1210,0,47.7693,-122.32,1210,6760,8859,7970,1210,63,63
4,1.75,1710,7724,1,0,0,3,8,1710,0,47.7721,-122.293,1940,7724,9434,9664,1710,36,36
3,1,1540,9800,1,0,0,4,7,1540,0,47.7604,-122.329,1560,9450,11340,11010,1540,69,69
2,1,700,8100,1,0,0,3,6,700,0,47.7492,-122.311,1230,8100,8800,9330,700,70,70
3,1,1040,8199,1,0,0,3,7,1040,0,47.7348,-122.302,1420,8200,9239,9620,1040,66,66
3,2,1230,8450,1,0,0,3,7,1230,0,47.7548,-122.305,2110,8536,9680,10646,1230,30,30
3,1.5,2330,11740,1,0,0,3,8,1330,1000,47.7481,-122.292,2630,11740,14070,14370,2330,65,65
3,1.75,1900,11407,1,0,0,3,8,1900,0,47.7455,-122.294,1710,11407,13307,13117,1900,56,56
3,1.75,1900,7076,1,0,0,3,7,1130,770,47.7569,-122.326,1540,10113,8976,11653,1900,42,42
3,1,960,8855,1,0,0,4,7,960,0,47.7689,-122.328,1250,8855,9815,10105,960,61,61
3,1,1010,7903,1,0,0,3,6,1010,0,47.766,-122.32,1010,7903,8913,8913,1010,71,71
3,1,1450,9586,2,0,0,3,7,1450,0,47.7443,-122.326,1500,8592,11036,10092,1450,69,69
3,1,950,13475,1,0,0,3,7,950,0,47.7543,-122.306,1240,8910,14425,10150,950,69,69
3,1,1010,7200,1,0,0,5,6,1010,0,47.7601,-122.307,1590,7663,8210,9253,1010,71,71
3,2.25,1750,15528,1,0,0,3,8,1270,480,47.7739,-122.274,2170,12000,17278,14170,1750,56,56
2,1,1440,8842,1,0,0,3,7,840,600,47.7443,-122.325,1650,8461,10282,10111,1440,69,69
4,2,1780,12161,1,0,0,5,7,1160,620,47.7746,-122.323,1780,8170,13941,9950,1780,69,69
3,1.5,1720,7119,1,0,0,4,7,1720,0,47.7535,-122.314,1590,7616,8839,9206,1720,67,67
2,1,1200,8750,1,0,0,3,6,1200,0,47.7548,-122.327,1100,8408,9950,9508,1200,71,71
2,1,770,9370,1,0,0,3,7,770,0,47.762,-122.321,1060,9352,10140,10412,770,72,72
3,1,1130,8201,1,0,0,5,6,1130,0,47.7359,-122.306,1180,8203,9331,9383,1130,71,71
2,1.75,2080,13054,1,0,1,3,7,2080,0,47.7435,-122.292,2440,13054,15134,15494,2080,68,68
3,1,1060,10228,1,0,0,3,7,1060,0,47.7481,-122.3,1570,10228,11288,11798,1060,71,71
3,1.75,1170,8182,1,0,0,3,7,1170,0,47.7368,-122.298,1610,8183,9352,9793,1170,57,57
4,1.75,2500,7690,1,0,0,3,7,1250,1250,47.7713,-122.307,2040,8646,10190,10686,2500,46,46
4,2.5,2160,7826,1,0,0,4,7,1390,770,47.7754,-122.276,2190,9900,9986,12090,2160,43,43
4,3,2270,7245,1,0,0,3,7,1410,860,47.7722,-122.315,1740,7571,9515,9311,2270,40,40
4,2.5,4260,36360,1,0,0,4,8,4100,160,47.764,-122.302,2430,17888,40620,20318,4260,84,84
3,1.75,1660,9697,1,0,0,4,7,1660,0,47.7564,-122.286,2060,20624,11357,22684,1660,67,67
5,2.5,2520,27951,1,0,0,3,7,1890,630,47.7733,-122.318,1830,14373,30471,16203,2520,77,45
3,1,910,8658,1,0,0,3,7,910,0,47.7586,-122.303,1170,10200,9568,11370,910,64,64
5,2.5,2840,9425,1,0,0,4,7,1590,1250,47.7609,-122.297,1900,11600,12265,13500,2840,57,57
4,3,1940,8170,1,0,0,4,7,1940,0,47.7381,-122.302,1310,8169,10110,9479,1940,71,71
3,2.5,2650,9380,1,0,0,5,8,1680,970,47.7756,-122.273,2310,9600,12030,11910,2650,44,44
4,2.5,2430,11870,1,0,0,5,8,1590,840,47.7761,-122.285,2430,9600,14300,12030,2430,51,51
3,2.25,1830,7500,1,0,0,4,7,1330,500,47.7574,-122.31,1830,8720,9330,10550,1830,51,51
3,2,1430,6000,1,0,0,5,7,1430,0,47.7564,-122.316,1630,6315,7430,7945,1430,74,74
4,2.25,2860,15054,1,0,0,3,8,1460,1400,47.7655,-122.3,1730,18525,17914,20255,2860,62,62
3,2,1840,3432,2,0,0,3,7,1840,0,47.7368,-122.295,1280,7573,5272,8853,1840,7,7
2,1,1360,9367,1,0,0,4,6,680,680,47.7689,-122.315,1360,7543,10727,8903,1360,95,95
2,1,1120,7440,1,0,0,4,7,1120,0,47.7405,-122.323,1170,7440,8560,8610,1120,80,80
3,1.75,1510,11234,1,0,0,3,7,1210,300,47.7571,-122.328,2080,9076,12744,11156,1510,54,54
5,2.5,2210,10772,1,0,2,3,9,1430,780,47.7383,-122.288,2720,9858,12982,12578,2210,55,55
3,1.75,1490,9844,1,0,0,4,7,1190,300,47.7626,-122.297,1840,10150,11334,11990,1490,60,60
2,1.5,1400,11245,1,0,0,5,7,1400,0,47.7469,-122.321,1220,11241,12645,12461,1400,72,72
4,2,1820,9450,1,0,0,3,7,1100,720,47.7607,-122.329,1540,9450,11270,10990,1820,57,57
3,2.5,1600,6510,1,0,0,3,7,940,660,47.7679,-122.308,1600,10507,8110,12107,1600,36,36
3,1,1010,8108,1,0,0,3,7,1010,0,47.735,-122.309,1110,8108,9118,9218,1010,64,64
3,2.5,1950,6871,2,0,0,3,8,1950,0,47.7603,-122.307,1950,7663,8821,9613,1950,22,22
2,1,770,11084,1,0,0,4,6,770,0,47.7482,-122.321,1010,11084,11854,12094,770,72,72
3,1,1020,8484,1,0,0,3,6,1020,0,47.7719,-122.31,1180,9660,9504,10840,1020,70,70
4,2.25,2490,8700,1,0,0,3,7,1890,600,47.7397,-122.324,1470,7975,11190,9445,2490,43,43
3,1.5,1010,8108,1,0,0,5,7,1010,0,47.7359,-122.309,1300,8108,9118,9408,1010,65,65
2,1,1120,6236,1,0,0,4,6,1120,0,47.763,-122.291,1340,7784,7356,9124,1120,65,65
3,2.25,2620,10659,1,0,0,3,7,1660,960,47.7643,-122.273,1820,12071,13279,13891,2620,43,43
3,1.75,1670,12075,1,0,0,3,7,1370,300,47.7681,-122.307,1800,12123,13745,13923,1670,61,61
3,1,800,5760,1,0,0,3,6,700,100,47.7505,-122.317,1060,6628,6560,7688,800,70,70
3,1.5,1880,7400,1,0,0,3,8,1480,400,47.7743,-122.27,1820,8660,9280,10480,1880,51,51
3,1.5,1540,7506,1,0,0,5,7,1540,0,47.7565,-122.325,2180,7653,9046,9833,1540,58,58
5,2.5,2670,14455,2,0,0,5,9,2670,0,47.7565,-122.284,1810,14455,17125,16265,2670,61,61
2,1,790,9784,1,0,0,3,6,790,0,47.7634,-122.284,2350,10102,10574,12452,790,87,87
4,2.25,2470,7447,2,0,0,3,8,2470,0,47.7514,-122.286,2270,7400,9917,9670,2470,35,35
5,2.5,1940,9389,1,0,0,4,7,1290,650,47.7438,-122.328,1810,9390,11329,11200,1940,59,59
4,2,1640,7200,1,0,0,3,7,1640,0,47.7471,-122.324,1500,9000,8840,10500,1640,56,56
2,1,830,8183,1,0,0,5,6,830,0,47.7366,-122.302,1180,8184,9013,9364,830,69,69
4,2.5,1570,9600,1,0,0,3,7,800,770,47.7757,-122.303,1340,9110,11170,10450,1570,47,47
3,1.5,1430,8000,1,0,0,5,7,1430,0,47.772,-122.322,1410,9820,9430,11230,1430,71,71
4,1,1390,9023,1,0,0,3,7,1390,0,47.7754,-122.296,1760,9023,10413,10783,1390,64,64
2,1,1050,8220,1,0,0,4,6,780,270,47.7598,-122.316,1340,7651,9270,8991,1050,72,72
2,1,720,9520,1,0,0,4,6,720,0,47.7678,-122.316,1450,8612,10240,10062,720,72,72
4,2,1370,8100,1,0,0,2,7,1370,0,47.749,-122.312,1280,8100,9470,9380,1370,72,72
4,1.5,1890,7540,1,0,0,4,7,1890,0,47.7534,-122.318,1890,8515,9430,10405,1890,52,52
3,2.25,2060,10160,1,0,0,4,8,1340,720,47.7712,-122.285,2320,11186,12220,13506,2060,52,52
3,1.75,1590,9636,1,0,0,4,6,1590,0,47.754,-122.321,1800,9975,11226,11775,1590,66,66
5,3,2240,15435,1,0,1,5,7,1390,850,47.7426,-122.288,2240,10750,17675,12990,2240,67,67
3,1,1210,7440,1,0,0,3,7,1210,0,47.7402,-122.323,1120,7440,8650,8560,1210,70,70
3,1,1090,8280,1,0,0,3,6,1090,0,47.7562,-122.318,1060,7609,9370,8669,1090,72,8
3,1,880,9238,1,0,0,5,6,880,0,47.7494,-122.319,1170,9238,10118,10408,880,73,73
3,2.25,2220,9800,2,0,0,3,8,2220,0,47.7635,-122.286,2420,10232,12020,12652,2220,32,32
3,2.5,1830,6807,2,0,0,5,7,1830,0,47.7613,-122.322,1340,6807,8637,8147,1830,65,65
3,1,960,9624,1,0,0,3,7,960,0,47.7758,-122.301,1540,9624,10584,11164,960,66,66
3,2.5,2650,11250,2,0,0,3,9,2650,0,47.7644,-122.29,2200,10013,13900,12213,2650,14,14
2,1,1120,7350,1,0,0,3,7,1120,0,47.7648,-122.31,1320,7545,8470,8865,1120,77,77
3,1.75,1600,10530,1,0,2,3,8,1600,0,47.7437,-122.291,2590,8274,12130,10864,1600,57,57
3,1.75,1800,6000,1,0,0,5,6,900,900,47.7505,-122.317,1060,6628,7800,7688,1800,69,69
5,3.25,2440,15815,2,0,0,3,8,1990,450,47.774,-122.28,2500,14201,18255,16701,2440,5,5
4,2.5,3020,17810,1,0,0,3,9,1600,1420,47.7735,-122.281,2500,15815,20830,18315,3020,40,40
6,2.75,2520,9324,1,0,0,4,7,1320,1200,47.7636,-122.294,1820,11000,11844,12820,2520,57,57
3,1.5,1530,7200,1,0,0,3,8,1530,0,47.7691,-122.297,2150,7216,8730,9366,1530,44,44
4,2.75,2750,15450,1,0,0,3,8,1800,950,47.7749,-122.283,2750,10620,18200,13370,2750,41,41
3,1.75,1260,7500,1,0,0,3,6,840,420,47.772,-122.323,1340,7500,8760,8840,1260,72,72
2,2,1040,5796,1,0,2,4,6,1040,0,47.7362,-122.29,2300,5796,6836,8096,1040,98,98
2,1,1010,11919,1,0,0,3,6,1010,0,47.7461,-122.322,1220,11240,12929,12460,1010,72,72
4,2.5,3440,14554,2,1,4,3,8,2170,1270,47.7364,-122.286,3170,11810,17994,14980,3440,7,7
3,2.5,1780,4050,2,0,0,3,7,1780,0,47.7346,-122.308,1571,4976,5830,6547,1780,18,18
3,1.5,1070,9331,1,0,0,3,6,1070,0,47.7633,-122.313,1480,8400,10401,9880,1070,63,63
2,1,700,5559,1,0,0,5,6,700,0,47.7492,-122.311,1230,8100,6259,9330,700,70,70
3,1.75,3860,9000,1,0,2,3,9,1930,1930,47.7431,-122.29,2960,9000,12860,11960,3860,49,49
4,1,1510,7200,1,0,0,4,7,1510,0,47.761,-122.307,1950,10656,8710,12606,1510,64,64
4,2.5,2670,20894,2,0,0,3,9,2330,340,47.7735,-122.281,2440,15815,23564,18255,2670,17,17
3,2.75,2770,54707,1,0,0,3,8,2370,400,47.7555,-122.289,1640,54707,57477,56347,2770,81,81
5,1.5,1830,9000,1,0,2,3,7,1030,800,47.7488,-122.292,2610,11175,10830,13785,1830,64,64
2,1,770,7906,1,0,0,4,6,770,0,47.766,-122.32,990,7906,8676,8896,770,71,71
4,1,1190,8875,1,0,0,4,7,1190,0,47.7487,-122.303,1190,8875,10065,10065,1190,73,73
3,1,1080,8100,1,0,0,4,7,1080,0,47.777,-122.307,1080,8100,9180,9180,1080,64,64
4,1.75,2080,8215,2,0,0,4,7,2080,0,47.737,-122.305,1550,8215,10295,9765,2080,71,71
2,1,1210,7040,1,0,0,3,7,1210,0,47.745,-122.297,1210,7205,8250,8415,1210,67,67
4,3.25,3330,33826,2,0,0,5,8,3330,0,47.7596,-122.275,2580,28707,37156,31287,3330,95,95
3,1,940,7913,1,0,0,3,6,940,0,47.7657,-122.321,940,7913,8853,8853,940,71,71
3,1,1720,8910,1,0,0,4,7,1720,0,47.7736,-122.296,1870,8640,10630,10510,1720,65,65
3,2,1940,16300,1,0,0,3,7,1140,800,47.774,-122.283,1940,11250,18240,13190,1940,41,41
2,1,1560,10125,1,0,0,4,7,1130,430,47.7488,-122.304,1680,10125,11685,11805,1560,65,65
3,2,1450,6081,1,0,0,4,7,1450,0,47.7522,-122.278,1880,6000,7531,7880,1450,50,50
4,2.5,1770,9858,1,0,2,3,8,1770,0,47.7382,-122.287,2470,9858,11628,12328,1770,48,48
2,1,1060,7868,1,0,0,3,7,1060,0,47.7414,-122.295,1530,10728,8928,12258,1060,67,67
3,1.5,1470,6867,1,0,0,3,8,1470,0,47.7495,-122.327,1470,6523,8337,7993,1470,64,64
3,1.5,1530,23660,1,0,0,3,7,1530,0,47.7467,-122.295,1800,11407,25190,13207,1530,67,67
3,2,1150,6249,1,0,0,3,7,1150,0,47.7489,-122.284,2470,7751,7399,10221,1150,67,8
4,1.75,2050,10920,1,0,3,3,8,1450,600,47.7431,-122.286,2440,10920,12970,13360,2050,45,45
3,1.75,1260,11224,1,0,0,5,7,1260,0,47.7444,-122.321,1570,11052,12484,12622,1260,72,72
2,1,1060,7200,1,0,0,4,6,1060,0,47.7463,-122.315,1850,8291,8260,10141,1060,68,68
3,1,1020,5870,1,0,0,3,6,1020,0,47.741,-122.314,1160,6901,6890,8061,1020,78,78
3,1,890,5965,1,0,0,3,7,890,0,47.7518,-122.279,1930,7500,6855,9430,890,69,69
3,1.5,1040,9997,1,0,0,4,7,1040,0,47.7583,-122.302,1040,8699,11037,9739,1040,64,64
2,1,1210,7440,1,0,0,3,6,780,430,47.7376,-122.322,1070,7440,8650,8510,1210,79,79
4,2,1820,8400,1,0,0,5,7,1300,520,47.7615,-122.329,1700,9450,10220,11150,1820,63,63
3,1.75,2020,10031,1,0,0,5,7,1370,650,47.7487,-122.319,1500,8456,12051,9956,2020,67,67
3,2,2200,21890,1,0,2,3,8,1200,1000,47.7584,-122.271,2600,15162,24090,17762,2200,58,58
4,2.5,2710,12138,1,0,0,3,8,1700,1010,47.7657,-122.29,2390,10052,14848,12442,2710,51,51
5,3,3670,10583,1,0,0,5,8,2060,1610,47.7589,-122.277,2720,13865,14253,16585,3670,67,67
3,1,1100,8138,1,0,0,3,7,1100,0,47.7393,-122.325,1440,8131,9238,9571,1100,70,70
3,2,1540,6000,1,0,0,4,6,1540,0,47.7372,-122.307,1490,8213,7540,9703,1540,66,66
4,2.5,2550,19017,1,0,0,4,7,1300,1250,47.7682,-122.284,2080,21100,21567,23180,2550,58,58
4,2.5,2570,13450,1,0,4,3,8,1510,1060,47.7429,-122.285,3470,12615,16020,16085,2570,71,71
3,1.75,1020,7020,1,0,0,4,7,1020,0,47.7362,-122.314,1020,5871,8040,6891,1020,66,66
4,2.75,2340,11034,1,0,0,3,8,1720,620,47.7686,-122.278,2370,11941,13374,14311,2340,52,52
3,2.75,1750,9166,1,0,0,4,7,1170,580,47.7696,-122.325,1810,8760,10916,10570,1750,40,40
6,4.5,3500,8504,2,0,0,3,7,3500,0,47.7351,-122.295,1550,8460,12004,10010,3500,39,39
3,1.75,1900,10454,1,0,0,3,7,1390,510,47.7748,-122.291,2000,12000,12354,14000,1900,41,41
3,2,2050,9396,1,0,0,5,7,1170,880,47.7447,-122.328,1680,9391,11446,11071,2050,59,59
5,1,1680,9383,1,0,0,3,7,1400,280,47.7523,-122.311,1680,9458,11063,11138,1680,90,90
3,1,1180,5002,1,0,0,3,7,1180,0,47.7529,-122.324,1470,8410,6182,9880,1180,73,73
2,1,1060,6504,1,0,0,3,6,1060,0,47.7412,-122.327,1100,7200,7564,8300,1060,69,69
4,1,1200,11111,1,0,0,3,7,1200,0,47.7529,-122.306,1350,9113,12311,10463,1200,70,70
2,1,1140,10404,1,0,0,3,5,1140,0,47.7497,-122.286,2200,11550,11544,13750,1140,84,84
2,1,1150,8138,1,0,0,3,7,1150,0,47.737,-122.325,1300,8139,9288,9439,1150,65,65
4,2.25,1930,7925,1,0,0,3,8,1300,630,47.7626,-122.312,1930,7200,9855,9130,1930,59,59
4,3.25,4690,14930,2,0,2,3,10,3680,1010,47.7718,-122.283,2910,13320,19620,16230,4690,24,24
3,1.75,2650,7500,1,0,0,4,7,1590,1060,47.7716,-122.317,1340,7500,10150,8840,2650,57,57
2,1.5,1040,8526,1,0,0,5,6,1040,0,47.7349,-122.295,1310,8504,9566,9814,1040,66,66
3,1,1580,13912,1,0,0,4,8,1580,0,47.7552,-122.276,2130,16420,15492,18550,1580,64,64
2,1,920,8612,1,0,0,5,7,920,0,47.734,-122.301,1500,7956,9532,9456,920,72,72
4,1.5,1870,7220,2,0,0,3,7,1870,0,47.77,-122.319,1550,7592,9090,9142,1870,63,63
2,1,810,8494,1,0,0,3,6,810,0,47.7389,-122.324,1050,7975,9304,9025,810,70,70
3,1,1630,10304,1,0,0,5,7,1630,0,47.7548,-122.317,1480,8515,11934,9995,1630,66,66
3,1,1400,6879,1,0,0,3,7,1400,0,47.7508,-122.286,1950,7400,8279,9350,1400,68,68
4,1.75,1810,9750,2,0,0,4,7,1810,0,47.7681,-122.311,1570,10000,11560,11570,1810,42,42
2,1,770,7434,1,0,0,3,6,770,0,47.7606,-122.32,1060,7453,8204,8513,770,72,72
4,1,1430,5909,1,0,0,3,6,1070,360,47.7623,-122.313,1460,8433,7339,9893,1430,72,72
2,0.5,1180,7750,1,0,0,4,6,590,590,47.769,-122.316,1380,8976,8930,10356,1180,74,74
2,2.5,1770,7155,2,1,4,3,8,1770,0,47.7345,-122.285,2410,10476,8925,12886,1770,62,11
3,2.75,2340,12282,1,0,2,3,8,1470,870,47.7379,-122.289,2640,8887,14622,11527,2340,41,41
3,1,850,6906,1,0,0,3,6,850,0,47.7441,-122.314,1150,6907,7756,8057,850,71,71
4,3.5,3270,15160,1,0,2,3,8,1660,1610,47.7437,-122.287,2790,15160,18430,17950,3270,22,22
2,1,770,8149,1,0,0,3,6,770,0,47.7458,-122.298,1160,8149,8919,9309,770,71,71
3,2.5,1640,5097,2,0,0,3,7,1640,0,47.7522,-122.278,1880,6000,6737,7880,1640,50,50
3,1,1010,11244,1,0,0,4,7,1010,0,47.7467,-122.321,1220,11242,12254,12462,1010,72,72
3,2,1570,7200,1,0,0,4,7,1570,0,47.7501,-122.314,1410,7434,8770,8844,1570,67,67
2,1,1130,8184,1,0,0,3,6,1130,0,47.7473,-122.32,1010,8184,9314,9194,1130,72,72
3,2,1360,6685,1,0,0,3,7,1360,0,47.7365,-122.324,1300,8138,8045,9438,1360,67,67
4,1.75,2480,14782,1,0,3,3,8,1460,1020,47.7646,-122.271,2910,10800,17262,13710,2480,61,61
3,1,1660,8839,1,0,0,4,7,1660,0,47.7485,-122.3,1230,9236,10499,10466,1660,72,72
4,1.75,2040,9322,1,0,0,3,8,1440,600,47.7611,-122.298,1910,10026,11362,11936,2040,42,42
4,2.25,2370,11310,1,0,0,3,8,1550,820,47.7684,-122.289,1890,8621,13680,10511,2370,51,51
4,2.5,1160,16008,1,0,0,4,7,1160,0,47.7643,-122.295,1570,12645,17168,14215,1160,30,30
5,3,2980,10064,1,0,0,3,7,1680,1300,47.7372,-122.316,1590,7800,13044,9390,2980,79,79
6,1.75,2400,7500,1,0,0,3,7,1400,1000,47.7661,-122.313,1980,7500,9900,9480,2400,44,44
2,1,940,9458,1,0,0,3,6,940,0,47.7523,-122.311,1450,9458,10398,10908,940,71,71
3,1.75,1630,9403,1,0,0,3,7,1630,0,47.757,-122.316,1430,8461,11033,9891,1630,36,36
5,2.5,3260,24300,1,0,1,4,8,2310,950,47.7587,-122.274,2390,32057,27560,34447,3260,69,69
3,1.5,1700,8067,1,0,0,3,7,1250,450,47.7384,-122.324,1340,7869,9767,9209,1700,63,63
2,1,840,10465,1,0,0,3,6,840,0,47.755,-122.317,1320,8515,11305,9835,840,68,68
5,3.25,2480,10277,2,0,0,5,8,1640,840,47.7726,-122.286,2270,10277,12757,12547,2480,26,26
4,1.5,1660,6617,1,0,0,5,7,1660,0,47.739,-122.323,950,7440,8277,8390,1660,72,72
2,1,1010,7200,1,0,0,3,7,1010,0,47.7651,-122.291,1890,9248,8210,11138,1010,44,44
4,2,1650,7552,1,0,0,4,7,860,790,47.7765,-122.324,1410,7199,9202,8609,1650,42,42
2,1.75,1820,8409,1,0,0,4,6,910,910,47.7538,-122.327,1300,8409,10229,9709,1820,71,71
4,2,1190,7877,1,0,0,5,7,1190,0,47.7538,-122.322,1480,9975,9067,11455,1190,73,73
4,2.75,3130,8920,2,0,0,3,8,3130,0,47.7397,-122.316,1450,9183,12050,10633,3130,5,5
4,2,1400,7140,1,0,0,3,7,1400,0,47.7719,-122.309,1610,10500,8540,12110,1400,50,50
4,2,1780,8149,1,0,0,4,7,1780,0,47.745,-122.302,1180,8149,9929,9329,1780,71,71
3,1.5,1460,11407,1,0,0,3,7,1460,0,47.746,-122.294,1470,11407,12867,12877,1460,65,65
4,2.75,2700,9882,2,0,0,3,7,2700,0,47.7671,-122.291,2250,10797,12582,13047,2700,61,26
3,2.25,1880,7279,1,0,0,3,7,1280,600,47.7574,-122.322,2020,8274,9159,10294,1880,57,57
3,1,1250,6180,1,0,0,3,7,1250,0,47.7474,-122.327,1490,6180,7430,7670,1250,64,64
3,1.75,1790,9813,2,0,0,3,7,1790,0,47.749,-122.305,1520,10125,11603,11645,1790,70,70
4,1,1370,8499,1,0,0,3,7,1370,0,47.736,-122.301,1370,8187,9869,9557,1370,70,70
3,1.75,1460,7862,1,0,0,3,7,1460,0,47.7755,-122.299,2200,9293,9322,11493,1460,54,54
3,2.25,3340,13805,1,0,0,3,8,3340,0,47.744,-122.292,2060,12304,17145,14364,3340,69,22
3,1,1300,8879,1,0,0,3,7,920,380,47.7465,-122.326,1530,6960,10179,8490,1300,69,69
4,2.5,2590,9530,1,0,0,4,8,1640,950,47.7752,-122.285,2710,10970,12120,13680,2590,41,41
3,1.5,1610,8375,2,0,0,3,7,1610,0,47.7527,-122.306,1610,9107,9985,10717,1610,92,92
3,2,1130,16875,1,0,0,4,7,1130,0,47.7489,-122.3,1600,14300,18005,15900,1130,72,72
4,2.5,2430,5203,2,0,0,3,8,2430,0,47.7402,-122.317,2260,7474,7633,9734,2430,16,16
3,1.75,1640,8529,1,0,0,5,7,1640,0,47.7751,-122.32,1730,7769,10169,9499,1640,68,68
3,1.75,1170,8148,1,0,0,3,7,1170,0,47.7479,-122.318,1200,8147,9318,9347,1170,67,67
4,1,1360,5900,1,0,0,4,7,1360,0,47.7512,-122.318,1050,5900,7260,6950,1360,70,70
6,4.5,3500,8504,2,0,0,3,7,3500,0,47.7349,-122.295,1550,8460,12004,10010,3500,39,39
4,1,2180,10617,1,0,0,3,7,2180,0,47.7522,-122.307,1360,9519,12797,10879,2180,69,69
5,3.5,5170,7197,3,1,4,3,11,3520,1650,47.7561,-122.271,3020,12880,12367,15900,5170,21,21
3,1.75,1520,12282,1,0,0,3,8,1220,300,47.7516,-122.299,1860,13500,13802,15360,1520,41,41
3,1,960,8100,1,0,0,3,7,960,0,47.7766,-122.307,1120,8100,9060,9220,960,64,64
3,1.75,1650,7145,2,0,0,5,8,1300,350,47.7733,-122.324,1760,7206,8795,8966,1650,42,42
3,1,1300,8184,2,0,0,3,6,1300,0,47.7469,-122.319,1120,8184,9484,9304,1300,72,72
3,2,1720,8145,2,0,0,5,7,1720,0,47.7393,-122.325,1400,8138,9865,9538,1720,70,70
3,1,1140,8144,1,0,0,3,7,1140,0,47.7464,-122.317,1150,8144,9284,9294,1140,63,63
4,2,1920,7803,1,0,0,3,7,1080,840,47.758,-122.325,1940,8147,9723,10087,1920,57,57
4,2.25,1750,10270,1,0,0,4,8,1750,0,47.7612,-122.31,1750,10127,12020,11877,1750,51,51
4,2.5,1670,5116,2,0,0,3,8,1670,0,47.7667,-122.33,1910,7210,6786,9120,1670,20,20
7,3,2940,8624,1,0,0,3,8,1690,1250,47.7555,-122.307,1850,8031,11564,9881,2940,42,42
4,2.25,2200,8292,2,0,0,3,7,2200,0,47.7456,-122.315,1090,8290,10492,9380,2200,29,29
4,1.75,1820,22043,2,0,0,4,7,1820,0,47.7606,-122.28,1880,19961,23863,21841,1820,101,101
3,1,1560,7552,1,0,0,4,6,910,650,47.7552,-122.327,1200,8152,9112,9352,1560,71,71
2,1,710,9000,1,0,0,5,6,710,0,47.4811,-122.339,1230,9000,9710,10230,710,76,76
4,2.5,3270,9650,1,0,3,4,9,2320,950,47.409,-122.333,2340,17357,12920,19697,3270,48,48
4,2.25,2410,14985,1,0,1,4,7,1950,460,47.4278,-122.343,2510,15256,17395,17766,2410,54,54
3,3.5,3940,11632,2,0,0,3,10,3940,0,47.438,-122.344,2015,11632,15572,13647,3940,5,5
4,2.25,4220,24186,1,0,0,3,8,2600,1620,47.445,-122.347,2410,30617,28406,33027,4220,35,35
2,2.5,2720,26761,2,1,4,3,7,2720,0,47.4499,-122.376,1870,12396,29481,14266,2720,29,29
3,3.5,3190,29982,1,0,3,4,8,2630,560,47.458,-122.368,2600,19878,33172,22478,3190,78,78
3,1.5,1950,7620,1,0,0,4,7,1010,940,47.4594,-122.346,1850,7620,9570,9470,1950,63,63
2,1,710,14000,1,0,0,4,6,710,0,47.4379,-122.337,1500,10540,14710,12040,710,66,66
2,1,950,8100,1,0,0,3,6,950,0,47.4572,-122.351,1620,7630,9050,9250,950,64,64
2,1,1420,21158,1,0,0,3,7,1420,0,47.4594,-122.359,1220,8625,22578,9845,1420,66,66
3,1.75,2140,15030,1,0,0,4,7,1570,570,47.4181,-122.338,2170,15030,17170,17200,2140,61,61
4,1.5,2993,19400,2,0,0,4,7,2233,760,47.4692,-122.365,2060,15100,22393,17160,2993,98,98
3,2.75,2300,12197,2,0,0,3,8,2300,0,47.4369,-122.338,1710,11220,14497,12930,2300,30,30
3,1.75,1240,7620,1,0,0,3,7,1240,0,47.4576,-122.348,1150,7620,8860,8770,1240,51,0
3,1.5,1690,10250,1,0,0,4,7,1690,0,47.4531,-122.344,1990,11084,11940,13074,1690,64,64
3,1.75,2000,9900,1,0,2,4,8,1480,520,47.4436,-122.339,2310,10200,11900,12510,2000,62,62
3,2,3080,17700,1,0,0,4,8,1740,1340,47.4695,-122.366,2100,15100,20780,17200,3080,54,54
4,1.5,2150,23568,1,0,0,4,7,2150,0,47.4522,-122.355,2150,10125,25718,12275,2150,69,69
4,1.75,1400,8374,1,0,0,3,7,1400,0,47.4735,-122.344,1420,8360,9774,9780,1400,66,66
3,1,810,5240,1,0,0,3,6,810,0,47.4734,-122.35,1700,5245,6050,6945,810,77,77
4,2.75,2450,15002,1,0,0,5,9,2450,0,47.4268,-122.343,2650,15055,17452,17705,2450,45,45
4,1.5,1460,8760,1,0,0,3,7,1460,0,47.4698,-122.36,1610,9375,10220,10985,1460,61,61
5,2.25,2570,13054,1,0,1,3,8,1470,1100,47.4487,-122.352,2570,19807,15624,22377,2570,69,22
3,2.25,2150,21235,1,0,3,4,8,1590,560,47.4336,-122.339,2570,18900,23385,21470,2150,60,60
2,0.75,900,9600,1,0,0,3,6,900,0,47.4604,-122.339,1250,14280,10500,15530,900,78,78
7,6.75,7480,41664,2,0,2,3,11,5080,2400,47.4643,-122.368,2810,33190,49144,36000,7480,66,66
4,1.75,2090,12750,1,0,0,3,8,1360,730,47.4792,-122.357,2040,12300,14840,14340,2090,52,52
4,2,2060,13400,1,0,2,4,8,2060,0,47.4404,-122.34,1950,10370,15460,12320,2060,62,62
6,2.25,2820,15600,1,0,2,5,7,1970,850,47.4635,-122.362,2520,7797,18420,10317,2820,79,79
4,2.5,2050,9143,2,0,0,3,8,2050,0,47.4597,-122.355,1510,9484,11193,10994,2050,27,27
3,1,960,7200,1,0,0,4,6,960,0,47.4583,-122.353,1060,7620,8160,8680,960,61,61
4,2,1970,10500,1,0,0,3,8,1820,150,47.479,-122.356,2090,12300,12470,14390,1970,58,58
3,1.5,1150,13200,1,0,0,3,7,1150,0,47.4752,-122.345,1220,13066,14350,14286,1150,63,63
3,1,1400,7410,1,0,0,3,6,1400,0,47.4798,-122.343,1070,7410,8810,8480,1400,75,75
3,1,1320,8100,1,0,0,3,6,880,440,47.4697,-122.351,1000,8100,9420,9100,1320,76,76
3,2.75,2000,7200,1,0,0,3,7,1000,1000,47.4531,-122.352,1440,7200,9200,8640,2000,65,1
1,1,1100,4373,1,0,0,2,6,820,280,47.4653,-122.338,1100,7500,5473,8600,1100,72,72
2,2.75,3690,32044,2,1,4,3,12,3690,0,47.4485,-122.369,2310,26988,35734,29298,3690,30,30
4,2.5,2990,10400,2,0,0,3,9,2990,0,47.4508,-122.359,2140,17449,13390,19589,2990,17,17
3,2,2950,12196,2,0,0,4,7,2310,640,47.4702,-122.365,2320,19844,15146,22164,2950,101,101
3,1,1520,7200,1,0,0,3,7,1030,490,47.4527,-122.352,1530,7201,8720,8731,1520,65,65
4,1.75,2030,15400,1,0,1,3,9,1130,900,47.4603,-122.365,2040,12425,17430,14465,2030,44,44
2,1,700,10540,1,0,0,3,6,700,0,47.438,-122.336,890,10540,11240,11430,700,66,66
5,2.75,3230,13572,1,0,2,3,8,1880,1350,47.4393,-122.347,2910,15292,16802,18202,3230,54,54
3,1.75,2220,22081,1,0,0,4,7,2220,0,47.4693,-122.364,2010,12360,24301,14370,2220,97,97
3,2,1960,13100,1,0,2,5,8,1650,310,47.4419,-122.34,1960,10518,15060,12478,1960,62,62
3,1.75,2870,26500,1,0,1,3,8,2870,0,47.4485,-122.355,2420,20500,29370,22920,2870,71,33
3,2,1420,16000,1,0,0,3,7,1420,0,47.478,-122.358,1900,12630,17420,14530,1420,53,53
4,3.25,3276,10801,2,0,0,3,9,3276,0,47.4585,-122.361,2010,11656,14077,13666,3276,11,11
3,2,1220,7620,1,0,0,3,6,720,500,47.4564,-122.352,1640,7620,8840,9260,1220,72,0
3,1.5,1490,6604,1,0,0,4,6,1490,0,47.4683,-122.351,1330,6604,8094,7934,1490,101,101
3,3.25,3320,15022,2,0,0,3,10,3320,0,47.429,-122.341,3430,15018,18342,18448,3320,30,30
2,1,1460,7832,1,0,0,3,6,1460,0,47.4617,-122.346,1460,7632,9292,9092,1460,95,95
4,2.25,2170,10500,1,0,2,4,8,1270,900,47.4394,-122.338,2080,11019,12670,13099,2170,59,59
5,1.75,1940,6654,1,0,0,4,7,1940,0,47.4663,-122.359,2300,9500,8594,11800,1940,66,66
5,3.5,2790,16952,2,0,2,3,10,1970,820,47.4384,-122.347,2980,17281,19742,20261,2790,28,28
2,1,720,8040,1,0,0,3,6,720,0,47.4662,-122.359,2300,9500,8760,11800,720,76,76
4,1.75,2400,9900,1,0,0,3,7,1250,1150,47.4631,-122.362,1960,9900,12300,11860,2400,62,62
5,2.5,3600,20001,2,0,0,4,9,3600,0,47.4484,-122.339,2860,21780,23601,24640,3600,43,43
5,1.75,2320,8100,1,0,0,4,7,1160,1160,47.4631,-122.341,1410,7271,10420,8681,2320,63,63
4,3,2690,28300,1,0,0,3,8,2690,0,47.4458,-122.343,2820,27100,30990,29920,2690,65,15
3,1.75,1320,9450,1,0,0,5,7,1320,0,47.4557,-122.348,1320,8315,10770,9635,1320,76,76
3,2,2320,17688,1,0,0,3,8,2320,0,47.4519,-122.363,1610,14482,20008,16092,2320,67,20
3,2,1510,7884,1,0,0,3,6,1510,0,47.4683,-122.348,1050,7620,9394,8670,1510,77,0
4,1.75,2790,17476,1,0,2,3,7,1450,1340,47.4556,-122.369,2790,16401,20266,19191,2790,63,63
3,1,1290,11250,1,0,0,3,7,1290,0,47.4743,-122.341,1410,11196,12540,12606,1290,63,63
3,1,1840,8100,1,0,0,4,7,920,920,47.455,-122.35,1250,8100,9940,9350,1840,66,66
4,2.5,2660,8887,1,0,0,4,8,1880,780,47.439,-122.342,1910,9620,11547,11530,2660,52,52
3,1.75,1050,5850,1,0,0,3,7,1050,0,47.4574,-122.358,1220,8880,6900,10100,1050,39,39
3,2.75,2020,10744,1,0,0,5,7,1270,750,47.4403,-122.343,2020,11069,12764,13089,2020,65,65
3,2.5,5403,24069,2,1,4,4,12,5403,0,47.4169,-122.348,3980,104374,29472,108354,5403,43,43
4,1.75,2500,20868,1,0,2,3,8,1600,900,47.431,-122.338,2170,15026,23368,17196,2500,63,63
5,2.5,2140,15950,1,0,2,4,8,1370,770,47.4797,-122.358,2600,14273,18090,16873,2140,51,51
3,2.5,1820,16300,1,0,0,4,7,1220,600,47.4582,-122.365,1870,16300,18120,18170,1820,64,64
4,1.5,2210,10497,1,0,0,4,8,1650,560,47.4321,-122.347,1840,12697,12707,14537,2210,66,66
3,3.5,4660,21164,2,1,4,3,12,4660,0,47.4418,-122.354,3140,24274,25824,27414,4660,44,24
3,1.75,1450,7620,1,0,0,4,7,1050,400,47.4569,-122.354,1380,7620,9070,9000,1450,64,64
3,2.25,2300,12430,1,0,2,4,8,1580,720,47.435,-122.347,2500,12430,14730,14930,2300,59,59
2,1,790,11234,1,0,0,4,6,790,0,47.4413,-122.349,1930,11871,12024,13801,790,77,77
3,1.75,1570,15330,1,0,0,3,7,1080,490,47.4608,-122.34,1250,13330,16900,14580,1570,63,63
4,1,1670,8102,1,0,0,3,6,1670,0,47.4692,-122.355,1310,7906,9772,9216,1670,75,75
3,2,1860,7400,1,0,0,3,8,930,930,47.4598,-122.352,1640,8461,9260,10101,1860,97,10
4,1,1230,7410,1,0,0,3,7,1230,0,47.4798,-122.344,1020,7648,8640,8668,1230,75,75
4,2,1640,7200,1,0,0,5,6,820,820,47.4791,-122.347,1640,8200,8840,9840,1640,75,75
4,2,1710,7490,2,0,0,3,7,1320,390,47.4544,-122.357,1880,7704,9200,9584,1710,63,63
4,1.75,1770,12462,1,0,2,4,8,1770,0,47.4355,-122.338,2310,14810,14232,17120,1770,57,57
4,2.25,3380,9900,1,0,2,4,8,1690,1690,47.4438,-122.34,2390,9900,13280,12290,3380,50,50
3,1,1840,8100,1,0,0,4,7,920,920,47.455,-122.35,1250,8100,9940,9350,1840,66,66
4,1.75,1440,6720,1,0,0,5,6,720,720,47.4571,-122.345,1820,6784,8160,8604,1440,65,65
4,1,800,8775,1,0,0,3,6,800,0,47.48,-122.336,1310,8775,9575,10085,800,76,76
4,1,1560,8450,1,0,0,4,6,1560,0,47.4552,-122.354,1380,8100,10010,9480,1560,65,65
3,2.75,3070,5280,2,0,1,3,7,2360,710,47.4486,-122.353,2570,18983,8350,21553,3070,69,28
3,2,2500,30056,1,0,0,5,8,1840,660,47.4468,-122.337,2500,30000,32556,32500,2500,65,65
3,1,1470,6500,1,0,0,4,7,1470,0,47.473,-122.362,1470,9300,7970,10770,1470,66,66
3,1,2710,19000,2,0,3,4,7,2710,0,47.4462,-122.359,2150,19000,21710,21150,2710,69,69
3,2,1740,9300,1,0,0,4,7,1740,0,47.4526,-122.357,1540,9638,11040,11178,1740,67,67
3,1,1040,8000,1,0,0,4,7,1040,0,47.4711,-122.35,1170,9450,9040,10620,1040,63,63
3,3.25,5480,57990,2,1,4,3,11,5480,0,47.4558,-122.371,2500,22954,63470,25454,5480,28,28
4,1.5,1680,7620,1,0,0,4,7,1180,500,47.4578,-122.351,1460,7620,9300,9080,1680,54,54
3,1,1000,6020,1,0,0,3,6,1000,0,47.4793,-122.346,1300,8640,7020,9940,1000,75,75
4,2,2010,9474,2,0,0,3,7,2010,0,47.4234,-122.342,2140,10164,11484,12304,2010,66,12
1,1,620,7620,1,0,0,3,6,620,0,47.4697,-122.349,1160,7620,8240,8780,620,93,93
3,1,1750,7800,1,0,0,4,7,1150,600,47.4596,-122.343,1750,7560,9550,9310,1750,63,63
2,1.75,1840,14874,1,0,2,3,8,1300,540,47.4382,-122.348,2920,15084,16714,18004,1840,67,67
3,1.75,2040,15695,1,0,0,4,8,2040,0,47.4155,-122.339,2280,14400,17735,16680,2040,60,60
3,3.25,3740,136915,2,0,0,3,11,3100,640,47.4549,-122.363,2400,16104,140655,18504,3740,29,29
3,2,1769,9300,1,0,0,4,7,1769,0,47.441,-122.342,1870,10226,11069,12096,1769,64,5
3,2.25,2600,14810,1,0,2,4,8,1490,1110,47.4326,-122.341,2450,16715,17410,19165,2600,63,63
3,1,1900,14400,1,0,0,4,7,1300,600,47.4147,-122.337,1940,14400,16300,16340,1900,65,65
2,1,1390,8336,1,0,0,4,6,910,480,47.4646,-122.361,1610,7847,9726,9457,1390,73,73
3,2.25,2860,11250,1,0,1,5,8,2290,570,47.4534,-122.372,2030,11250,14110,13280,2860,63,63
3,1,1000,7636,1,0,0,2,7,1000,0,47.472,-122.344,1150,7600,8636,8750,1000,67,67
5,1.75,1940,6654,1,0,0,4,7,1940,0,47.4663,-122.359,2300,9500,8594,11800,1940,66,66
2,1,790,11234,1,0,0,4,6,790,0,47.4413,-122.349,1930,11871,12024,13801,790,77,77
3,2,2580,15653,1,0,0,3,9,2580,0,47.4561,-122.361,1920,9840,18233,11760,2580,29,29
4,2.5,2230,26989,1,0,1,4,8,1400,830,47.4285,-122.345,2570,17702,29219,20272,2230,57,57
3,3.5,2050,21744,2,1,4,4,9,1750,300,47.4536,-122.376,2300,12200,23794,14500,2050,89,89
5,1.75,2280,43560,1,0,1,4,8,1380,900,47.4558,-122.362,1940,17664,45840,19604,2280,70,70
4,2.75,2090,14141,1,0,0,4,8,1680,410,47.4333,-122.347,1990,12920,16231,14910,2090,78,78
4,1,1550,15239,1,1,4,3,6,1370,180,47.4502,-122.378,1790,22047,16789,23837,1550,89,89
3,1,910,5250,1,0,0,4,6,910,0,47.4729,-122.352,1650,10442,6160,12092,910,48,48
3,2.5,2080,8690,1,0,0,3,8,1430,650,47.4424,-122.344,2400,9625,10770,12025,2080,45,45
3,2,1810,17006,2,1,4,3,8,1810,0,47.4663,-122.369,2180,24911,18816,27091,1810,106,27
3,2.5,1730,1803,2,0,0,3,7,1730,0,47.4648,-122.335,1190,7980,3533,9170,1730,14,14
4,1.75,1680,9244,2,0,0,3,8,1680,0,47.4612,-122.352,1840,9387,10924,11227,1680,28,28
3,1.5,1550,7260,1,0,0,2,6,1550,0,47.4693,-122.349,1190,7620,8810,8810,1550,94,94
3,2.75,1650,5700,2,0,0,4,7,1650,0,47.4563,-122.348,1320,7620,7350,8940,1650,31,31
2,1,1010,7200,1,0,0,3,6,1010,0,47.4815,-122.339,1290,9000,8210,10290,1010,63,63
4,1.5,1570,8775,1,0,0,3,7,1570,0,47.4789,-122.335,980,8775,10345,9755,1570,76,76
3,4.5,4380,47044,2,1,3,3,9,3720,660,47.4734,-122.365,2460,18512,51424,20972,4380,51,24
2,1,740,8853,1,0,0,3,6,740,0,47.4793,-122.336,850,8775,9593,9625,740,76,76
4,2,1750,7800,1,0,0,4,6,1750,0,47.4791,-122.347,1270,7800,9550,9070,1750,75,75
3,1,1690,13184,1,0,0,4,7,1690,0,47.476,-122.343,1130,13451,14874,14581,1690,60,60
3,1.5,1570,12412,1,0,3,3,8,1570,0,47.438,-122.349,2130,12412,13982,14542,1570,65,65
3,1,1110,6060,1,0,0,3,6,1110,0,47.4705,-122.352,1480,8100,7170,9580,1110,70,70
3,2.75,2980,27144,1,1,2,5,8,2180,800,47.4522,-122.378,1890,12514,30124,14404,2980,102,102
3,1.75,2080,7800,1,0,0,5,7,1220,860,47.4536,-122.355,1770,7860,9880,9630,2080,64,64
3,1.75,1410,15210,1,0,0,3,7,1410,0,47.4181,-122.339,1970,16290,16620,18260,1410,69,0
3,2,1520,7456,1,0,0,3,7,1520,0,47.4745,-122.343,1740,8464,8976,10204,1520,70,70
4,1.5,2230,11536,1,0,1,4,7,1220,1010,47.4409,-122.348,2170,12465,13766,14635,2230,65,65
3,2.5,4530,22873,2,0,2,5,8,3220,1310,47.4567,-122.369,3100,18210,27403,21310,4530,107,107
4,2,1400,7632,1,0,0,5,6,1400,0,47.4625,-122.345,1400,7632,9032,9032,1400,89,89
4,2.5,1820,11325,1,0,0,3,8,1390,430,47.4574,-122.361,1990,10802,13145,12792,1820,43,43
3,2.5,1980,17342,2,1,4,3,10,1580,400,47.4551,-122.373,2060,17313,19322,19373,1980,35,35
3,1,1190,9486,1,0,0,4,7,1190,0,47.4319,-122.339,2100,10400,10676,12500,1190,66,66
3,1,1460,43000,1,0,0,3,7,1460,0,47.4434,-122.347,2250,20023,44460,22273,1460,67,67
5,2,2280,19000,1,0,0,3,6,2280,0,47.4683,-122.359,1790,11800,21280,13590,2280,95,95
3,1.75,1660,8160,1,0,0,4,7,1660,0,47.4608,-122.358,1490,8100,9820,9590,1660,68,68
4,2.5,2310,6650,2,0,2,3,8,2310,0,47.4513,-122.267,1800,9819,8960,11619,2310,7,7
5,3.5,4050,13495,1,0,2,4,9,2230,1820,47.4384,-122.352,3210,13495,17545,16705,4050,31,31
3,1.75,1570,15330,1,0,0,3,7,1080,490,47.4608,-122.34,1250,13330,16900,14580,1570,63,63
3,1.75,1900,10225,1,0,0,4,8,1220,680,47.4781,-122.357,1850,12630,12125,14480,1900,56,56
2,1.75,1450,15798,2,1,4,3,7,1230,220,47.4497,-122.375,2030,13193,17248,15223,1450,104,37
3,2.5,1930,6604,2,0,0,3,7,1930,0,47.4692,-122.351,910,6604,8534,7514,1930,5,5
3,2,1130,7200,1,0,0,4,6,1130,0,47.4779,-122.342,1270,7500,8330,8770,1130,75,75
5,1.75,2190,27260,1,0,0,4,7,2190,0,47.4546,-122.337,1620,39480,29450,41100,2190,72,40
3,1.75,1750,14400,1,0,0,4,7,1750,0,47.4535,-122.361,2030,14400,16150,16430,1750,68,68
3,2.25,1940,8312,1,0,1,4,7,1220,720,47.4556,-122.346,2060,9503,10252,11563,1940,56,56
3,1,860,7632,1,0,0,3,6,860,0,47.4623,-122.345,890,7632,8492,8522,860,99,99
3,1.5,1190,20672,1,0,3,3,7,1190,0,47.4459,-122.359,2150,16239,21862,18389,1190,71,71
3,1.5,1460,8710,1,0,0,3,7,1460,0,47.4561,-122.357,1400,8645,10170,10045,1460,64,64
4,2.5,1890,15770,2,0,0,4,7,1890,0,47.4281,-122.343,2410,15256,17660,17666,1890,51,51
4,2.5,3420,21344,2,0,0,3,9,3420,0,47.45,-122.334,2110,21344,24764,23454,3420,17,17
5,2.5,3600,17300,1,0,0,4,8,2410,1190,47.4468,-122.341,2620,30200,20900,32820,3600,51,51
4,2.25,2450,21000,1,0,2,4,8,1650,800,47.4559,-122.344,1820,12480,23450,14300,2450,65,65
3,3,4230,54977,2,0,3,3,9,3780,450,47.4176,-122.343,2880,27201,59207,30081,4230,68,14
5,2.25,2550,9200,1,0,0,4,8,1580,970,47.4673,-122.363,2090,9200,11750,11290,2550,44,44
2,1,930,7623,1,0,0,2,6,930,0,47.467,-122.349,1300,7641,8553,8941,930,77,77
1,1,790,13062,1,0,0,3,6,790,0,47.4919,-122.311,1240,7137,13852,8377,790,77,77
2,1,860,6600,1,0,0,5,6,860,0,47.4878,-122.324,1030,6732,7460,7762,860,70,70
2,1,840,11600,1,0,0,3,6,840,0,47.492,-122.302,1610,9120,12440,10730,840,67,67
3,1,1080,8580,1,0,0,3,6,1080,0,47.4716,-122.262,1800,12672,9660,14472,1080,119,119
2,1,2060,8398,1,0,0,3,7,1260,800,47.509,-122.324,1690,13495,10458,15185,2060,57,57
3,2,1300,11374,1,0,0,5,7,1300,0,47.4839,-122.302,1480,9670,12674,11150,1300,86,86
4,2,1560,8800,2,0,0,5,6,1560,0,47.4927,-122.312,1480,10000,10360,11480,1560,77,48
2,1,850,16400,1,0,0,3,6,850,0,47.4889,-122.299,1100,14459,17250,15559,850,96,96
4,3,2460,9606,1,0,0,3,8,2460,0,47.4889,-122.317,1730,7500,12066,9230,2460,7,7
5,1,1500,9282,1,0,0,5,6,1500,0,47.4702,-122.281,1520,9639,10782,11159,1500,53,53
3,1.75,1900,8540,1,0,0,3,6,950,950,47.4868,-122.303,1370,10204,10440,11574,1900,39,39
3,1,980,12812,1,0,0,3,7,980,0,47.4892,-122.306,1430,8986,13792,10416,980,63,63
3,1.75,1770,9000,1,0,0,3,7,1090,680,47.4997,-122.326,1520,21141,10770,22661,1770,65,65
3,1,1820,8142,1,0,0,3,7,1040,780,47.505,-122.316,1820,8142,9962,9962,1820,58,58
3,1,1910,8710,1,0,0,3,7,1080,830,47.5038,-122.3,1460,8944,10620,10404,1910,65,65
3,1,1400,6600,1,0,0,3,6,1280,120,47.4845,-122.331,1730,6600,8000,8330,1400,65,65
3,1.5,1150,11571,1,0,0,3,7,1150,0,47.4931,-122.298,1630,11571,12721,13201,1150,58,58
3,2,1340,8505,1,0,0,3,6,1340,0,47.4727,-122.297,1370,9000,9845,10370,1340,88,88
4,2,2200,13320,1,0,0,3,6,1100,1100,47.481,-122.292,1330,6099,15520,7429,2200,75,75
3,1.5,1370,10176,1,0,0,3,6,1370,0,47.4738,-122.263,1650,10176,11546,11826,1370,72,72
1,1,800,16306,1,0,0,2,6,680,120,47.4916,-122.308,1270,8666,17106,9936,800,88,88
2,1,1240,7200,1,0,0,3,7,1240,0,47.4971,-122.282,1130,9200,8440,10330,1240,52,52
3,2.25,1890,9646,1,0,0,3,8,1890,0,47.4838,-122.299,1580,9488,11536,11068,1890,53,53
2,1,880,9750,1,0,0,5,6,880,0,47.4885,-122.298,1220,9406,10630,10626,880,81,81
3,1,1500,6600,1,0,0,2,6,1500,0,47.4845,-122.33,1730,6600,8100,8330,1500,49,49
3,2,2270,28025,1,0,0,4,7,1920,350,47.4857,-122.318,1770,14833,30295,16603,2270,72,72
5,3,2230,8642,1,0,0,3,7,1330,900,47.487,-122.32,2100,11056,10872,13156,2230,5,5
3,1,2120,31564,1,0,0,3,7,1220,900,47.4938,-122.298,1790,11571,33684,13361,2120,77,77
2,1,710,14700,1,0,0,5,6,710,0,47.4939,-122.318,1320,14700,15410,16020,710,93,93
3,2.25,1470,16728,1,0,0,4,7,1350,120,47.4968,-122.302,1540,9000,18198,10540,1470,60,60
3,1.75,2270,7156,1,0,0,3,7,1370,900,47.4864,-122.316,1210,7156,9426,8366,2270,71,71
3,1,1490,8995,1,0,0,4,7,1490,0,47.4901,-122.303,1490,9000,10485,10490,1490,65,65
2,1,1200,9488,1,0,0,5,7,1200,0,47.4832,-122.299,1200,9488,10688,10688,1200,78,78
2,1,930,8665,1,0,0,4,6,930,0,47.4822,-122.318,1630,12375,9595,14005,930,81,81
4,1,2100,9200,1,0,0,3,7,1050,1050,47.476,-122.292,1540,10033,11300,11573,2100,60,60
5,1.5,1510,9078,1,0,0,4,7,1510,0,47.4852,-122.305,1480,9078,10588,10558,1510,60,60
3,1.75,1430,13399,1,0,0,4,7,900,530,47.4787,-122.275,1720,6415,14829,8135,1430,73,73
2,1,1610,19965,1,0,0,3,7,1610,0,47.5095,-122.313,2100,28400,21575,30500,1610,67,67
2,1,730,9975,1,0,0,1,5,730,0,47.4808,-122.315,860,9000,10705,9860,730,76,76
4,1,1130,13927,1,0,0,3,6,1130,0,47.4939,-122.3,1800,8274,15057,10074,1130,90,90
4,1.75,1400,6650,1,0,0,4,6,1400,0,47.4888,-122.332,1120,8645,8050,9765,1400,77,77
4,1,1340,22500,1,0,0,3,7,1340,0,47.489,-122.316,1620,10800,23840,12420,1340,93,93
3,1.75,1320,6600,1,0,0,3,7,1320,0,47.4838,-122.33,1070,6594,7920,7664,1320,31,31
2,1,1050,6250,1,0,0,4,6,840,210,47.5024,-122.333,1310,12500,7300,13810,1050,76,76
5,2.75,2770,6116,1,0,0,3,7,1490,1280,47.4847,-122.291,1920,6486,8886,8406,2770,40,40
3,1,1480,32700,1,0,0,4,6,1380,100,47.4949,-122.327,1500,22600,34180,24100,1480,77,77
4,1.75,1660,11664,1,0,0,3,6,1010,650,47.4943,-122.331,1670,9975,13324,11645,1660,67,67
3,1,1430,7599,1,0,0,4,6,1010,420,47.4783,-122.265,1290,10320,9029,11610,1430,89,89
3,1,1450,8820,1,0,0,3,6,1050,400,47.4698,-122.264,1510,8820,10270,10330,1450,61,61
4,2.5,2040,7800,2,0,0,3,7,2040,0,47.473,-122.293,1860,10954,9840,12814,2040,16,16
5,2.5,2130,8428,2,0,0,3,7,2130,0,47.4726,-122.282,1500,11810,10558,13310,2130,6,6
3,2,1290,9312,1,0,0,3,7,1290,0,47.4811,-122.325,1650,7300,10602,8950,1290,72,72
3,2.5,1890,4838,2,0,0,3,8,1730,160,47.4802,-122.279,1910,7409,6728,9319,1890,17,17
2,2.75,2820,11770,2,0,0,3,7,1630,1190,47.5102,-122.324,1690,12500,14590,14190,2820,72,72
3,1,1520,8600,1,0,0,3,6,1040,480,47.5134,-122.335,1320,8600,10120,9920,1520,68,68
2,1,900,8580,1,0,0,3,5,900,0,47.4727,-122.27,2060,6533,9480,8593,900,101,101
3,1.5,2210,11111,1,0,0,3,7,2210,0,47.492,-122.309,1250,8422,13321,9672,2210,85,85
3,1,1310,15022,1,0,0,3,7,1310,0,47.5008,-122.332,1530,13154,16332,14684,1310,85,31
3,1.5,1290,8366,1,0,0,3,7,1020,270,47.4853,-122.318,1770,8400,9656,10170,1290,62,62
2,1,920,7569,1,0,0,4,6,920,0,47.4951,-122.302,1280,7627,8489,8907,920,69,69
2,1,780,16344,1,0,0,1,5,780,0,47.4739,-122.28,1700,10387,17124,12087,780,77,77
2,1,780,9750,1,0,0,3,6,780,0,47.4816,-122.322,1670,9750,10530,11420,780,82,82
1,1,1120,11800,1,0,0,3,7,1120,0,47.5123,-122.331,2330,9290,12920,11620,1120,69,69
2,1,740,6550,1,0,0,4,5,740,0,47.4807,-122.332,1080,8515,7290,9595,740,73,73
2,1,1500,18540,1,0,0,3,8,1500,0,47.4727,-122.281,1700,9355,20040,11055,1500,69,69
3,2,1650,11256,1,0,0,4,7,1250,400,47.4707,-122.26,1860,11256,12906,13116,1650,62,62
2,1,1800,8900,1,0,0,3,6,900,900,47.51,-122.323,2040,10450,10700,12490,1800,74,74
2,1,780,6727,1,0,0,3,6,780,0,47.4733,-122.281,1860,10124,7507,11984,780,80,80
3,1.75,1330,12092,1,0,0,4,6,720,610,47.5102,-122.324,1770,11770,13422,13540,1330,38,38
3,1,1130,7014,1,0,0,3,7,1130,0,47.4743,-122.274,1440,9350,8144,10790,1130,65,65
3,1,1480,7469,1,0,0,3,6,1120,360,47.5048,-122.301,1460,7379,8949,8839,1480,79,79
2,1,1060,8000,1,0,0,3,6,1060,0,47.5088,-122.333,1390,8000,9060,9390,1060,78,78
3,2,1230,8235,1,0,0,3,6,1230,0,47.4853,-122.304,1080,10281,9465,11361,1230,60,60
2,1,1000,6227,1,0,0,3,6,1000,0,47.513,-122.333,1240,6250,7227,7490,1000,70,70
3,1,1440,11330,1,0,0,3,7,1440,0,47.4742,-122.265,1580,10100,12770,11680,1440,54,54
5,3,2230,6551,1,0,0,3,7,1330,900,47.487,-122.32,2230,9476,8781,11706,2230,5,5
4,2.5,2910,20067,2,0,0,3,9,2910,0,47.4714,-122.273,1730,21420,22977,23150,2910,18,18
2,1,1130,8160,1,0,0,4,6,1130,0,47.4997,-122.317,1060,6120,9290,7180,1130,67,67
4,1.5,1370,9750,1,0,0,3,7,1070,300,47.4718,-122.323,1540,9789,11120,11329,1370,66,66
3,1,1710,10190,1,0,0,3,6,1310,400,47.506,-122.331,1200,6251,11900,7451,1710,70,70
3,1,1020,6173,1,0,0,3,6,780,240,47.5042,-122.329,1330,5909,7193,7239,1020,71,71
5,1,1920,19040,1,0,0,3,7,1160,760,47.4756,-122.294,1920,11520,20960,13440,1920,58,58
3,1,1700,7700,1,0,0,3,7,1120,580,47.5114,-122.318,1700,8800,9400,10500,1700,59,59
2,1,1310,6600,1,0,0,3,6,1310,0,47.4834,-122.332,1240,6600,7910,7840,1310,77,77
2,1,790,7128,1,0,0,3,6,790,0,47.4873,-122.324,1110,7150,7918,8260,790,75,75
4,2,1700,8043,1,0,0,3,7,850,850,47.4758,-122.288,1540,13260,9743,14800,1700,65,65
3,1.5,1980,11214,1,0,0,3,7,1980,0,47.4696,-122.298,1510,9072,13194,10582,1980,60,60
4,2.5,2090,11645,1,0,0,3,7,1200,890,47.4759,-122.299,1450,9481,13735,10931,2090,57,57
3,1,1740,5247,1,0,0,3,7,1270,470,47.5049,-122.329,1070,5636,6987,6706,1740,72,72
3,1,990,12696,1,0,0,3,7,990,0,47.4776,-122.279,1260,8937,13686,10197,990,83,83
3,2.5,1700,2250,2,0,0,3,7,1700,0,47.4914,-122.334,1520,4500,3950,6020,1700,5,5
3,1.5,1140,8340,1,0,0,3,7,1140,0,47.4773,-122.28,1140,8340,9480,9480,1140,59,59
2,1,1090,9994,1,0,0,3,7,1090,0,47.4761,-122.287,1090,11700,11084,12790,1090,65,65
3,1.75,1440,12888,1,0,2,3,7,1090,350,47.471,-122.262,1710,12888,14328,14598,1440,61,61
1,0.75,840,7203,1,0,0,3,6,840,0,47.4756,-122.301,1560,8603,8043,10163,840,70,70
2,1,1020,8100,1,0,0,3,6,1020,0,47.4971,-122.334,1200,12500,9120,13700,1020,79,79
4,1.75,3080,32997,1,0,0,4,7,3080,0,47.498,-122.321,1980,5711,36077,7691,3080,69,33
4,1.75,1660,10725,1,0,0,3,7,960,700,47.5033,-122.3,1340,9023,12385,10363,1660,63,63
3,1,1620,9450,1,0,0,3,7,1620,0,47.5136,-122.313,2070,11970,11070,14040,1620,91,91
5,4.5,4440,9784,2,0,0,3,10,4440,0,47.4702,-122.275,2720,10080,14224,12800,4440,7,7
3,2.5,2740,7980,2,0,0,4,7,2740,0,47.473,-122.3,1470,8611,10720,10081,2740,55,55
3,1,900,6099,1,0,0,3,6,790,110,47.4807,-122.289,1240,6099,6999,7339,900,75,75
3,1,1080,6250,1,0,0,2,5,1080,0,47.5045,-122.33,1070,6250,7330,7320,1080,69,69
3,1.75,1970,8200,1,0,0,3,7,1270,700,47.4731,-122.327,1890,8348,10170,10238,1970,55,55
2,1,700,20130,1,0,0,3,6,700,0,47.4752,-122.271,1490,18630,20830,20120,700,70,70
2,1,1080,9067,1,0,0,3,6,1080,0,47.4815,-122.331,1080,6647,10147,7727,1080,68,68
3,1.75,2880,18296,1,0,0,3,8,1580,1300,47.4881,-122.281,1380,9592,21176,10972,2880,61,61
2,1,1070,6120,1,0,0,3,6,1070,0,47.4989,-122.317,1130,6120,7190,7250,1070,57,57
2,1,790,7153,1,0,0,4,6,790,0,47.4869,-122.324,810,7128,7943,7938,790,75,75
5,1,1460,6032,2,0,0,4,6,1460,0,47.487,-122.282,1060,10300,7492,11360,1460,78,78
2,1,1150,9186,1,0,0,3,7,1150,0,47.5081,-122.33,1390,10690,10336,12080,1150,73,73
3,1,1530,15975,1,0,0,3,7,970,560,47.4766,-122.326,1540,15975,17505,17515,1530,67,67
3,1.5,1940,8951,1,0,0,3,7,1300,640,47.473,-122.328,2000,8319,10891,10319,1940,61,61
4,1.75,2020,10332,1,0,0,3,7,1010,1010,47.5059,-122.303,2240,8379,12352,10619,2020,65,65
2,1,600,6120,1,0,0,3,5,600,0,47.4997,-122.317,1060,6120,6720,7180,600,76,76
5,1.5,2000,8100,1,0,0,3,6,2000,0,47.4945,-122.304,960,9239,10100,10199,2000,73,73
4,1,1590,24330,1,0,0,3,6,1140,450,47.4906,-122.309,1000,16228,25920,17228,1590,77,77
5,2.5,2900,6650,1,0,0,3,7,1450,1450,47.4935,-122.332,1600,8246,9550,9846,2900,55,55
4,3,1730,7264,2,0,0,3,6,1730,0,47.4738,-122.264,1500,12104,8994,13604,1730,99,99
3,2,1210,9097,1,0,0,4,7,1210,0,47.4849,-122.303,1360,10125,10307,11485,1210,65,65
2,1.5,1820,8867,2,0,0,3,7,1820,0,47.4764,-122.269,1430,9288,10687,10718,1820,98,98
3,1.5,2010,10100,1,0,0,4,7,1110,900,47.4738,-122.266,1900,10100,12110,12000,2010,55,55
4,2.5,2040,22653,2,0,0,3,7,2040,0,47.4991,-122.299,2020,20502,24693,22522,2040,8,8
3,1.5,1230,8056,1,0,0,4,6,1230,0,47.4878,-122.314,850,6714,9286,7564,1230,70,70
2,1,930,6600,1,0,0,3,6,930,0,47.4868,-122.33,1250,6600,7530,7850,930,62,62
4,2,1930,6600,1,0,0,4,7,1030,900,47.482,-122.332,1220,6600,8530,7820,1930,52,52
3,1,1030,7800,1,0,0,3,7,1030,0,47.473,-122.324,1630,12664,8830,14294,1030,65,65
4,2.5,1560,7800,2,0,0,3,7,1560,0,47.514,-122.316,1160,7800,9360,8960,1560,22,22
3,1,1170,6134,1,0,0,4,7,1170,0,47.4941,-122.312,1440,9823,7304,11263,1170,71,71
3,1.75,1580,6099,1,0,0,5,7,790,790,47.4807,-122.29,1330,6099,7679,7429,1580,75,75
3,2.5,2050,8172,2,0,0,3,8,2050,0,47.4808,-122.28,2140,5664,10222,7804,2050,17,17
3,1,1010,5490,1,0,0,3,6,1010,0,47.4762,-122.293,1740,10658,6500,12398,1010,65,65
2,1,960,13438,1,0,0,3,7,960,0,47.4745,-122.295,1630,11656,14398,13286,960,68,68
3,1,1140,10477,1,0,0,3,6,1140,0,47.4874,-122.306,1190,9750,11617,10940,1140,77,77
3,1.75,2390,30409,1,0,0,3,7,1560,830,47.4789,-122.296,1750,13500,32799,15250,2390,66,66
5,1,1870,7800,1,0,0,3,7,1580,290,47.5127,-122.321,1740,7808,9670,9548,1870,57,57
1,0.75,840,7203,1,0,0,3,6,840,0,47.4756,-122.301,1560,8603,8043,10163,840,70,70
3,1,1150,8100,1,0,0,3,6,1150,0,47.494,-122.307,1120,8100,9250,9220,1150,87,87
2,1,770,9715,1,0,0,4,6,770,0,47.4924,-122.312,1140,9715,10485,10855,770,77,77
4,1,1810,7500,1,0,0,2,7,1410,400,47.4935,-122.333,1250,6255,9310,7505,1810,60,60
2,2,1440,8425,1,0,0,4,6,1440,0,47.4831,-122.296,1430,12037,9865,13467,1440,77,31
3,1.5,1800,22000,2,0,0,3,8,1800,0,47.4889,-122.286,1440,16640,23800,18080,1800,88,88
2,1,1020,7742,1,0,0,4,6,1020,0,47.499,-122.301,1510,7742,8762,9252,1020,84,37
3,1,1640,18144,1,0,0,3,6,1640,0,47.5027,-122.33,1500,9065,19784,10565,1640,77,77
4,1.75,2120,9706,1,0,0,3,7,1370,750,47.4939,-122.297,1730,11337,11826,13067,2120,54,54
4,1,1220,8500,1,0,0,5,6,1220,0,47.4792,-122.277,1460,8500,9720,9960,1220,103,103
3,1.5,1370,9000,1,0,0,3,7,1370,0,47.4973,-122.328,1400,9075,10370,10475,1370,57,57
4,1.5,1810,9000,1,0,0,3,7,1810,0,47.4911,-122.322,1520,9780,10810,11300,1810,59,59
2,1,1330,28270,1,0,0,3,6,1330,0,47.4824,-122.274,1210,6926,29600,8136,1330,94,94
4,2.5,1670,8056,1,0,0,3,7,1170,500,47.4884,-122.319,1360,8056,9726,9416,1670,58,58
4,1,1490,6600,1,0,0,3,7,1490,0,47.4835,-122.332,1280,6600,8090,7880,1490,50,50
2,1,1390,11340,1,0,0,4,7,1390,0,47.4969,-122.3,1200,10224,12730,11424,1390,50,50
3,1.75,1370,10780,1,0,0,3,7,1370,0,47.4727,-122.298,1370,10317,12150,11687,1370,60,60
2,1,1050,6600,1,0,0,3,6,1050,0,47.4828,-122.324,1330,6600,7650,7930,1050,55,55
3,1.75,2300,41900,1,0,0,4,8,1310,990,47.477,-122.292,1160,8547,44200,9707,2300,80,80
3,1.75,1590,41550,1,0,0,3,6,1290,300,47.4817,-122.28,2990,6464,43140,9454,1590,86,25
2,1,2160,12960,1,0,0,3,7,1360,800,47.4702,-122.261,2070,12960,15120,15030,2160,51,51
4,1.5,1740,7292,1,0,0,3,7,1020,720,47.4787,-122.302,1740,7573,9032,9313,1740,57,57
2,1,760,5280,1,0,0,3,6,760,0,47.483,-122.33,1710,6594,6040,8304,760,73,73
4,1.5,1480,47045,1,0,0,5,6,1480,0,47.4809,-122.3,1530,11000,48525,12530,1480,77,77
2,1,1320,8865,1,0,0,4,6,1320,0,47.4949,-122.3,1190,6490,10185,7680,1320,76,76
4,1.75,1450,8891,1,0,0,3,7,1180,270,47.478,-122.278,1450,9013,10341,10463,1450,57,57
4,2.75,2230,10160,1,0,0,3,7,1400,830,47.5123,-122.32,1740,10080,12390,11820,2230,51,51
3,2,2320,7800,1,0,0,4,7,1160,1160,47.5141,-122.316,1380,7800,10120,9180,2320,59,59
3,1,1200,6250,1,0,0,3,6,920,280,47.5095,-122.331,1280,9375,7450,10655,1200,76,76
2,1,860,9000,1,0,0,4,6,860,0,47.4801,-122.315,990,9975,9860,10965,860,77,77
2,1,950,7692,1,0,0,3,6,950,0,47.4909,-122.298,1820,8221,8642,10041,950,93,93
4,1,1210,6250,1,0,0,3,7,1210,0,47.5008,-122.333,1210,8291,7460,9501,1210,57,57
3,1,1040,8910,1,0,0,3,6,1040,0,47.5024,-122.32,1330,9720,9950,11050,1040,76,76
3,1,1120,6625,1,0,0,3,6,1120,0,47.4879,-122.332,1120,6794,7745,7914,1120,77,77
4,2.75,2760,8160,1,0,2,4,8,1780,980,47.7248,-122.365,2720,8160,10920,10880,2760,79,79
4,3.5,3670,4960,2,0,0,3,9,2870,800,47.7022,-122.374,1520,6335,8630,7855,3670,14,14
4,1.75,2460,7560,2,0,0,4,8,2460,0,47.7256,-122.367,2760,8918,10020,11678,2460,67,67
3,2.5,3100,20553,1,0,0,3,10,3100,0,47.7635,-122.377,3000,22302,23653,25302,3100,65,65
2,1,880,7683,1,0,0,3,6,880,0,47.7145,-122.361,1370,7695,8563,9065,880,77,77
3,1.75,1730,8073,1,0,0,3,8,1350,380,47.7694,-122.367,2500,8073,9803,10573,1730,48,48
3,2.25,1530,1305,2,0,0,3,7,1116,414,47.7034,-122.357,1320,1427,2835,2747,1530,12,12
2,1,1320,8380,1,0,0,3,7,1320,0,47.705,-122.367,1290,8025,9700,9315,1320,66,66
3,1.75,1530,8028,1,0,0,3,7,1200,330,47.7768,-122.361,1530,8028,9558,9558,1530,52,52
4,3.5,3380,8330,2,0,0,3,8,3380,0,47.7741,-122.379,2220,8330,11710,10550,3380,19,19
3,2.25,2920,6300,1,0,0,3,8,1710,1210,47.7065,-122.37,1940,6300,9220,8240,2920,63,63
3,2.5,3670,18505,1,0,4,3,10,2530,1140,47.7588,-122.376,2920,20000,22175,22920,3670,36,36
4,1.75,2120,7680,1,0,0,4,7,1060,1060,47.7172,-122.361,1530,7680,9800,9210,2120,69,69
4,2.5,1960,8540,1,0,0,3,7,1220,740,47.7654,-122.359,1910,9120,10500,11030,1960,64,64
3,1.5,1320,8100,1,0,0,4,7,1320,0,47.7194,-122.371,1480,8100,9420,9580,1320,68,68
4,2,2260,7680,1,0,0,4,7,1130,1130,47.7193,-122.361,1800,7680,9940,9480,2260,72,72
3,4.25,5510,35000,2,0,4,3,13,4910,600,47.7296,-122.37,3430,45302,40510,48732,5510,22,22
3,1,1560,8100,1,0,0,4,8,1140,420,47.7261,-122.364,2130,8100,9660,10230,1560,67,67
3,1.75,1740,6220,1,0,0,4,6,1740,0,47.762,-122.362,1630,8418,7960,10048,1740,65,65
3,1.5,1840,9990,2,0,0,5,8,1840,0,47.7145,-122.369,2100,12474,11830,14574,1840,58,58
3,2.25,1770,7667,1,0,0,3,8,1270,500,47.7724,-122.362,2180,8103,9437,10283,1770,53,53
3,1,1470,7930,1,0,0,3,7,1070,400,47.7013,-122.368,1440,8100,9400,9540,1470,69,69
3,1.75,1570,5120,1,0,2,3,7,980,590,47.7166,-122.365,2420,7200,6690,9620,1570,72,72
3,1.75,1850,8160,1,0,0,3,8,1850,0,47.7241,-122.363,1600,8160,10010,9760,1850,67,67
3,1,1410,8250,1,0,0,3,7,1410,0,47.7621,-122.36,1580,8250,9660,9830,1410,65,65
2,1,1570,8210,1,0,0,4,8,1150,420,47.7221,-122.371,1680,8196,9780,9876,1570,67,67
4,2.5,5760,32033,2,0,4,4,12,4390,1370,47.7288,-122.37,3420,28475,37793,31895,5760,25,25
3,1.5,2200,7620,1,0,0,4,7,1130,1070,47.7263,-122.363,2170,7672,9820,9842,2200,77,77
3,1,1160,7491,1,0,0,4,6,1160,0,47.7024,-122.359,1800,2267,8651,4067,1160,102,102
4,2.25,2330,7220,2,0,1,3,8,1600,730,47.7764,-122.386,2220,9100,9550,11320,2330,31,31
4,2.5,1840,7800,1,0,2,3,8,1240,600,47.7762,-122.384,2010,9100,9640,11110,1840,47,47
3,2,1920,7598,1,0,0,4,8,1920,0,47.7735,-122.363,2220,7598,9518,9818,1920,47,47
4,1.75,2140,7102,1,0,0,4,7,1070,1070,47.7042,-122.37,1950,7102,9242,9052,2140,71,71
4,2.25,3740,18000,1,0,0,4,9,1870,1870,47.7027,-122.378,2610,10902,21740,13512,3740,68,68
3,1.75,2480,10804,1,0,0,3,8,1800,680,47.7721,-122.367,2480,10400,13284,12880,2480,43,43
5,2.5,2690,11745,1,0,0,3,8,1790,900,47.7708,-122.362,2670,7905,14435,10575,2690,59,59
3,2,2250,8000,1,0,2,4,9,2250,0,47.7077,-122.378,2880,10960,10250,13840,2250,64,64
3,1,1960,7955,1,0,0,4,7,1260,700,47.7641,-122.364,1850,8219,9915,10069,1960,56,56
3,1.75,1660,10819,1,0,0,4,7,1240,420,47.7045,-122.379,3110,11853,12479,14963,1660,77,77
3,1,1410,8053,1,0,0,4,7,1410,0,47.704,-122.367,1170,8042,9463,9212,1410,68,68
3,2.5,2400,6474,1,0,2,3,8,1560,840,47.7728,-122.386,2340,10856,8874,13196,2400,55,55
2,1.5,1320,10800,1,0,0,4,8,1320,0,47.7145,-122.367,2120,12040,12120,14160,1320,72,72
2,1,750,5534,1,0,0,3,7,750,0,47.7017,-122.36,1050,5534,6284,6584,750,72,72
3,2.5,1840,8250,1,0,1,3,8,1340,500,47.7767,-122.378,1970,7920,10090,9890,1840,61,61
3,1.75,1930,5400,2,0,2,3,9,1930,0,47.77,-122.391,2100,6840,7330,8940,1930,41,41
3,1,910,8000,1,0,0,4,6,740,170,47.7746,-122.378,2090,9007,8910,11097,910,69,69
3,2,1350,7216,1,0,0,3,7,1350,0,47.7616,-122.365,1920,7600,8566,9520,1350,55,55
2,1,680,5250,1,0,0,4,6,680,0,47.7013,-122.359,1620,5461,5930,7081,680,97,97
4,1.5,1700,8400,1,0,0,3,7,1700,0,47.7677,-122.359,1750,8475,10100,10225,1700,66,66
6,4.5,3810,28176,1,0,4,5,10,3810,0,47.7612,-122.381,3810,26400,31986,30210,3810,50,50
3,1.5,1860,7190,2,0,1,5,7,1860,0,47.7716,-122.392,1670,5525,9050,7195,1860,67,67
3,2,3000,22040,2,0,2,4,8,2470,530,47.7745,-122.368,2600,7947,25040,10547,3000,77,77
3,2.25,1770,7667,1,0,0,3,8,1270,500,47.7724,-122.362,2180,8103,9437,10283,1770,53,53
4,3.5,3620,6499,2,0,0,3,9,3620,0,47.7326,-122.36,2330,7200,10119,9530,3620,16,5
3,1.75,1970,8540,1,0,3,4,8,1130,840,47.7213,-122.365,2280,8540,10510,10820,1970,69,69
4,2.5,2290,26720,2,0,0,3,8,2290,0,47.7502,-122.374,2290,26720,29010,29010,2290,42,42
2,1,1340,8100,1,0,0,4,7,1340,0,47.7218,-122.37,1700,8100,9440,9800,1340,66,66
3,2.5,2050,15020,1,0,2,3,9,1600,450,47.759,-122.371,2930,15050,17070,17980,2050,59,59
3,2.25,1680,8450,1,0,0,3,8,1340,340,47.7575,-122.361,1850,8300,10130,10150,1680,59,59
3,1.75,2620,8280,1,0,0,4,7,1330,1290,47.7235,-122.359,1530,8160,10900,9690,2620,71,71
3,2.5,4090,16972,2,0,2,3,11,3590,500,47.7258,-122.37,3740,16972,21062,20712,4090,12,12
4,1.5,1840,11367,1,0,0,4,7,1840,0,47.7656,-122.358,1690,9800,13207,11490,1840,69,69
3,3.5,4310,10842,2,0,2,3,10,3140,1170,47.7735,-122.386,2280,11106,15152,13386,4310,31,31
4,2.5,2460,9973,1,0,0,4,8,1560,900,47.7133,-122.361,1830,7200,12433,9030,2460,54,54
3,2.25,2770,15886,2,0,0,3,10,2770,0,47.7464,-122.362,3290,15886,18656,19176,2770,37,37
3,2.25,2270,23900,1,0,0,3,9,1820,450,47.7506,-122.372,2520,28300,26170,30820,2270,44,44
4,2.75,4030,10240,2,0,2,3,8,3310,720,47.7168,-122.365,2490,7680,14270,10170,4030,76,20
3,1.75,2120,56192,1,0,1,3,9,1720,400,47.7665,-122.372,2240,20500,58312,22740,2120,60,60
3,2.25,1530,1279,2,0,0,3,7,1116,414,47.7035,-122.357,1320,1427,2809,2747,1530,12,12
3,2.75,1850,16960,1,0,2,4,8,1850,0,47.7128,-122.365,2470,13761,18810,16231,1850,66,66
6,2.5,2800,10490,1,0,0,3,7,1400,1400,47.7735,-122.378,2290,8716,13290,11006,2800,51,51
4,1.5,1880,11400,1,0,0,3,7,1280,600,47.7718,-122.381,1880,11400,13280,13280,1880,64,64
5,4.75,7880,24250,2,0,2,3,13,7880,0,47.7334,-122.362,2740,10761,32130,13501,7880,23,23
6,2.75,2980,20000,1,0,4,3,8,2130,850,47.7599,-122.375,2730,20000,22980,22730,2980,54,54
5,2.25,2650,9140,1,0,1,3,8,1350,1300,47.7772,-122.387,2700,7800,11790,10500,2650,54,54
4,2.25,1800,7200,1,0,0,3,7,1230,570,47.7717,-122.376,2260,7498,9000,9758,1800,40,40
3,2.5,2820,7200,1,0,3,3,9,1780,1040,47.7691,-122.388,2300,7200,10020,9500,2820,40,40
3,1.75,2570,13000,2,0,0,4,7,2570,0,47.7705,-122.371,2570,8521,15570,11091,2570,57,57
3,1,2150,7007,1,0,0,3,6,2150,0,47.7615,-122.362,1720,9000,9157,10720,2150,65,65
3,1.75,2310,7620,2,0,0,3,8,2310,0,47.7266,-122.363,2200,7672,9930,9872,2310,77,26
4,2.75,2330,6703,1,0,0,3,7,1710,620,47.7066,-122.359,2060,7500,9033,9560,2330,36,36
3,1.75,1870,9000,1,0,0,5,9,1870,0,47.7203,-122.361,2030,8160,10870,10190,1870,61,61
3,1.5,1770,30689,1,0,4,3,9,1770,0,47.7648,-122.37,2650,30280,32459,32930,1770,66,66
4,3,4590,9150,2,0,0,3,10,3490,1100,47.7234,-122.372,2910,12348,13740,15258,4590,38,38
4,1,1390,10800,1,0,0,4,7,1390,0,47.7248,-122.359,1390,9360,12190,10750,1390,78,78
2,1,1340,8100,1,0,2,3,8,1340,0,47.7212,-122.364,1680,7752,9440,9432,1340,69,69
3,1,1260,7980,1,0,0,3,7,1260,0,47.7013,-122.373,1760,7606,9240,9366,1260,68,68
4,2.25,2840,31720,1,0,0,3,8,1780,1060,47.7505,-122.375,2290,29577,34560,31867,2840,61,61
3,2,1520,3451,1,0,0,3,8,1520,0,47.7753,-122.375,1800,3451,4971,5251,1520,23,23
4,2.5,2600,11542,1,0,0,4,9,2200,400,47.7076,-122.377,2840,10960,14142,13800,2600,80,80
4,1.5,1680,11123,1,0,0,3,7,1130,550,47.7565,-122.361,1770,10103,12803,11873,1680,60,60
3,2.5,2320,2267,3,0,0,3,8,2320,0,47.7027,-122.359,1240,1883,4587,3123,2320,10,10
3,1.75,1680,28046,1,0,3,3,8,1180,500,47.7648,-122.37,2190,26308,29726,28498,1680,71,71
4,1.5,1740,8160,1,0,0,4,7,1400,340,47.7243,-122.363,1600,8160,9900,9760,1740,73,73
3,2.5,4310,32093,1,0,4,5,10,2510,1800,47.7624,-122.38,3810,26400,36403,30210,4310,37,37
5,2,1940,7642,1,0,0,3,7,1940,0,47.7751,-122.38,1940,8724,9582,10664,1940,62,62
3,2.25,1980,7200,1,0,0,3,8,1300,680,47.7625,-122.36,1820,8250,9180,10070,1980,55,55
3,2.5,2710,23292,1,0,4,3,9,2080,630,47.7608,-122.374,2430,20000,26002,22430,2710,63,63
4,2.5,2340,6420,1,0,2,3,8,1590,750,47.7728,-122.386,2110,10856,8760,12966,2340,55,55
3,1.75,1610,7900,1,0,0,4,8,1310,300,47.7588,-122.36,2210,7700,9510,9910,1610,59,59
3,1,1200,6561,1,0,0,3,6,1200,0,47.7763,-122.36,1340,9450,7761,10790,1200,69,47
3,1.5,1850,8124,1,0,0,4,7,1850,0,47.7275,-122.359,1530,8123,9974,9653,1850,71,71
5,2.5,2990,7500,1,0,2,3,9,1800,1190,47.7707,-122.369,2800,9860,10490,12660,2990,47,47
4,1.75,1790,10186,1,0,0,4,8,1790,0,47.7769,-122.376,1790,9142,11976,10932,1790,54,54
4,3.5,3180,12528,2,0,1,4,9,2060,1120,47.7058,-122.379,2850,11410,15708,14260,3180,40,40
4,3,2030,12675,2,0,0,3,7,2030,0,47.7689,-122.379,1990,7705,14705,9695,2030,37,37
2,1,940,6804,1,0,0,3,7,940,0,47.7047,-122.373,1150,6930,7744,8080,940,70,70
5,1.75,2840,10220,1,0,0,4,7,2210,630,47.764,-122.36,2000,9750,13060,11750,2840,65,65
5,6.25,8670,64033,2,0,4,3,13,6120,2550,47.7295,-122.372,4140,81021,72703,85161,8670,54,11
2,2,1540,9714,2,0,0,3,8,1540,0,47.7628,-122.359,1840,8179,11254,10019,1540,11,11
2,1.75,1930,11200,1,0,2,3,8,1430,500,47.7576,-122.37,2840,12408,13130,15248,1930,68,68
5,3,3850,9457,2,0,0,4,9,2910,940,47.727,-122.362,2830,9608,13307,12438,3850,56,56
5,2.5,2240,7543,1,0,0,3,7,1140,1100,47.7756,-122.372,2110,7408,9783,9518,2240,53,53
4,3.25,3090,6744,2,0,4,3,9,3090,0,47.768,-122.388,2020,6656,9834,8676,3090,96,0
2,2,1540,6804,1,0,0,5,7,1020,520,47.7044,-122.372,1380,6930,8344,8310,1540,77,77
3,1,2040,7936,1,0,3,5,8,1680,360,47.7028,-122.385,2300,10080,9976,12380,2040,79,79
2,1,1120,7560,1,0,1,3,6,1120,0,47.77,-122.39,1120,7200,8680,8320,1120,72,72
2,1,1020,8155,1,0,0,4,7,1020,0,47.7257,-122.361,1430,8157,9175,9587,1020,71,71
3,1.75,2940,6000,1,0,2,4,8,1590,1350,47.7235,-122.369,2880,8100,8940,10980,2940,62,62
3,2.25,2960,8330,1,0,3,4,10,2260,700,47.7035,-122.385,2960,8840,11290,11800,2960,66,66
5,2.75,2960,28300,1,0,3,4,9,2160,800,47.7606,-122.37,2940,23250,31260,26190,2960,60,60
4,2.75,2910,18700,1,0,0,3,9,2210,700,47.7557,-122.368,2420,26140,21610,28560,2910,62,19
4,1.75,3220,7392,1,0,0,4,8,2010,1210,47.7719,-122.361,1660,8363,10612,10023,3220,60,60
3,2.25,2210,7680,1,0,2,3,8,1730,480,47.7729,-122.389,2390,7680,9890,10070,2210,47,47
4,2.5,2430,6766,2,0,0,3,8,2430,0,47.7294,-122.358,1820,6772,9196,8592,2430,20,20
3,1.75,1970,8200,1,0,0,5,8,1420,550,47.7602,-122.363,2140,8000,10170,10140,1970,56,56
3,1,1440,27505,1,0,0,3,8,1440,0,47.7553,-122.37,2430,16400,28945,18830,1440,68,68
4,2.5,2650,25248,1,0,2,3,9,2330,320,47.7537,-122.373,3020,23135,27898,26155,2650,65,65
3,1.75,1800,7620,1,0,0,3,8,1350,450,47.7165,-122.361,1770,7620,9420,9390,1800,68,68
2,1,1430,8157,1,0,0,3,7,1150,280,47.7256,-122.361,1820,8157,9587,9977,1430,75,75
4,4,3860,67953,2,0,2,4,12,3860,0,47.7469,-122.378,4410,128066,71813,132476,3860,92,92
2,2.5,2910,19449,2,1,4,5,9,1940,970,47.7729,-122.393,2540,23598,22359,26138,2910,34,34
2,1.75,2170,25732,1,0,2,4,8,2170,0,47.7542,-122.372,3020,23135,27902,26155,2170,67,67
3,2.75,2710,9204,1,0,4,3,9,1480,1230,47.7039,-122.385,2960,10080,11914,13040,2710,44,44
4,1,1940,5753,1,0,0,3,7,1940,0,47.7188,-122.358,2170,6075,7693,8245,1940,72,72
4,2.25,2040,8315,1,0,0,4,8,1480,560,47.7077,-122.371,2330,8940,10355,11270,2040,61,61
4,4,3770,9750,1,0,0,4,9,1940,1830,47.7159,-122.367,2260,9878,13520,12138,3770,52,52
4,2.75,2420,7102,1,0,0,5,7,1670,750,47.7042,-122.371,1620,7102,9522,8722,2420,73,73
3,1.75,2220,7224,1,0,2,3,8,2040,180,47.774,-122.384,2540,9990,9444,12530,2220,44,44
4,1.75,2120,9786,1,0,0,3,8,1640,480,47.7753,-122.365,2310,8787,11906,11097,2120,52,52
3,1.5,2480,9900,2,0,3,3,10,2130,350,47.7018,-122.381,2860,9288,12380,12148,2480,79,79
3,2.5,3570,15151,1,0,0,4,8,2400,1170,47.7475,-122.364,3140,14375,18721,17515,3570,38,38
3,1.5,1410,9647,1,0,0,3,8,1410,0,47.7608,-122.361,2090,9272,11057,11362,1410,58,58
6,2.5,3010,17864,2,0,0,3,8,3010,0,47.7209,-122.372,2560,11532,20874,14092,3010,50,50
4,2.75,1800,7750,1,0,0,4,8,1400,400,47.7776,-122.384,1800,8275,9550,10075,1800,54,54
4,2.5,2080,8100,1,0,2,5,8,1220,860,47.7228,-122.369,2090,8100,10180,10190,2080,67,67
3,1.5,2000,7350,1,0,0,3,8,2000,0,47.7061,-122.368,1890,6960,9350,8850,2000,66,66
4,2.75,2300,26650,1,0,0,4,8,2300,0,47.7771,-122.362,2000,9879,28950,11879,2300,69,69
2,1,790,5985,1,0,0,3,6,790,0,47.4941,-122.24,1030,5985,6775,7015,790,75,75
2,1,850,6000,1,0,0,3,6,850,0,47.4972,-122.224,1100,6000,6850,7100,850,95,95
3,1.5,1320,7980,1,0,0,3,7,1320,0,47.5068,-122.259,2000,7700,9300,9700,1320,63,63
2,1,1070,6000,1,0,0,4,5,1070,0,47.495,-122.227,1910,6000,7070,7910,1070,97,97
3,1.75,2110,15400,1,0,0,3,7,1380,730,47.4861,-122.226,2110,9800,17510,11910,2110,56,56
4,2.5,1950,3000,2,0,0,3,7,1950,0,47.4977,-122.226,1170,6000,4950,7170,1950,17,17
2,1,1180,9350,1,0,0,3,6,1180,0,47.4889,-122.259,1780,9306,10530,11086,1180,101,101
3,2,1580,6655,1,0,0,3,6,790,790,47.4927,-122.248,1090,6655,8235,7745,1580,75,75
2,1,1260,7810,2,0,0,3,6,1260,0,47.5003,-122.248,1260,7755,9070,9015,1260,74,74
2,2,750,6553,1,0,2,3,7,750,0,47.4982,-122.221,1140,7500,7303,8640,750,74,74
5,3,2840,7199,1,0,0,3,7,1710,1130,47.5065,-122.275,2210,10800,10039,13010,2840,16,16
5,2,1890,6050,2,0,0,4,7,1890,0,47.5018,-122.242,1170,6050,7940,7220,1890,75,75
3,1,1040,6800,1,0,0,5,6,1040,0,47.492,-122.224,1430,6080,7840,7510,1040,68,68
4,1.75,2090,6485,1,0,0,3,7,1280,810,47.4958,-122.265,2190,9600,8575,11790,2090,63,63
3,1,1300,5898,1,0,0,3,7,1300,0,47.5053,-122.255,1320,7619,7198,8939,1300,58,58
4,1.5,2020,6000,1,0,0,4,7,1010,1010,47.5019,-122.235,1710,6000,8020,7710,2020,66,66
4,2.5,1900,3301,2,0,0,3,7,1900,0,47.489,-122.249,1960,3379,5201,5339,1900,12,12
1,0.75,930,29258,1,0,0,3,6,930,0,47.4837,-122.236,2000,18321,30188,20321,930,78,78
3,1.75,1560,9788,1,0,0,3,7,1560,0,47.4876,-122.226,1840,11180,11348,13020,1560,55,55
3,2,1410,7998,1,0,0,4,7,1410,0,47.4968,-122.277,1780,8278,9408,10058,1410,79,79
2,1,880,5600,1,0,0,5,7,880,0,47.5071,-122.265,1240,7015,6480,8255,880,64,64
3,3,2240,11536,2,0,0,3,7,2240,0,47.4886,-122.245,1650,8760,13776,10410,2240,76,9
3,1,860,7467,1,0,0,3,6,860,0,47.4947,-122.237,1280,7467,8327,8747,860,75,75
3,1.5,1010,5000,1,0,0,3,6,1010,0,47.4925,-122.278,980,5000,6010,5980,1010,76,76
3,3,1860,7440,1,0,0,5,7,1040,820,47.5035,-122.255,1490,8160,9300,9650,1860,65,65
4,2.25,2060,8400,1,0,0,3,7,1300,760,47.4984,-122.23,1990,7383,10460,9373,2060,59,59
3,1,1250,10200,1,0,0,3,6,1250,0,47.4902,-122.256,1800,8283,11450,10083,1250,54,54
4,2,1650,5974,1,0,0,5,7,860,790,47.5008,-122.257,1940,6001,7624,7941,1650,47,47
4,3.25,3450,5000,2,0,0,3,8,3450,0,47.4925,-122.273,1420,5000,8450,6420,3450,11,11
3,1,1420,7420,1,0,0,3,6,1420,0,47.4949,-122.239,1290,6600,8840,7890,1420,75,75
2,2.75,2810,11205,1,0,0,3,7,1510,1300,47.4869,-122.243,2520,13000,14015,15520,2810,51,51
5,1.5,1990,18200,1,0,0,3,7,1990,0,47.4938,-122.262,1860,8658,20190,10518,1990,59,59
3,1,1200,7500,1,0,0,3,6,1200,0,47.4921,-122.275,1010,7000,8700,8010,1200,114,25
5,3.5,2100,5107,2,0,0,3,7,1410,690,47.5108,-122.257,1410,5650,7207,7060,2100,20,20
2,1,1120,5650,1,0,0,3,6,1120,0,47.4979,-122.241,1270,6875,6770,8145,1120,75,75
3,1,1180,5350,1,0,0,4,6,1180,0,47.505,-122.259,1490,5350,6530,6840,1180,60,60
4,2.5,2070,8658,2,0,0,3,8,2070,0,47.5072,-122.257,2010,7215,10728,9225,2070,20,20
4,2.25,3060,7920,1,0,0,3,7,1530,1530,47.4879,-122.245,1850,7800,10980,9650,3060,54,54
4,1.75,1270,6825,1,0,2,3,7,1270,0,47.5051,-122.242,1800,6930,8095,8730,1270,69,69
4,1.5,1280,8000,1,0,0,3,6,1280,0,47.4949,-122.255,1420,8211,9280,9631,1280,59,59
3,1.75,1400,7300,2,0,0,3,6,1400,0,47.4999,-122.268,1440,10825,8700,12265,1400,71,71
3,1,860,6664,1,0,0,3,6,860,0,47.4931,-122.247,1150,6857,7524,8007,860,75,75
4,2.25,2290,12174,1,1,4,3,7,1490,800,47.5114,-122.245,2290,9379,14464,11669,2290,71,71
2,1,2080,14659,1,0,0,3,7,1040,1040,47.4858,-122.231,1920,15208,16739,17128,2080,59,59
6,3,3840,14040,1,0,3,3,8,2460,1380,47.506,-122.241,2170,6765,17880,8935,3840,70,70
4,1,1530,7200,1,0,0,3,7,1400,130,47.5015,-122.262,1530,7200,8730,8730,1530,71,71
4,1,1220,7980,1,0,0,3,6,1220,0,47.4924,-122.237,1210,7920,9200,9130,1220,75,75
3,2.75,2240,3360,2,0,0,3,8,2100,140,47.4999,-122.232,1790,5873,5600,7663,2240,5,5
5,2.75,2380,7500,1,0,0,3,7,1300,1080,47.5009,-122.235,2400,6000,9880,8400,2380,35,35
5,1.75,2230,7560,1,0,0,3,7,1230,1000,47.5055,-122.26,1380,6570,9790,7950,2230,60,60
4,1.75,2080,13629,1,0,0,4,7,1040,1040,47.4866,-122.232,1780,14659,15709,16439,2080,64,64
3,1,1070,14000,1,0,0,3,7,1070,0,47.4971,-122.279,920,12500,15070,13420,1070,59,59
3,2,1200,5700,1,0,0,5,7,1200,0,47.5031,-122.242,1190,6384,6900,7574,1200,77,77
2,1,800,6050,1,0,0,4,6,800,0,47.5001,-122.242,880,6050,6850,6930,800,75,75
4,2.5,4940,10037,1,0,4,3,9,3450,1490,47.5095,-122.247,2430,9272,14977,11702,4940,66,66
2,1.5,2010,7755,2,0,0,3,7,2010,0,47.4947,-122.233,1360,8037,9765,9397,2010,67,67
5,1.75,2640,13290,1,1,4,4,8,1400,1240,47.5022,-122.223,2400,11942,15930,14342,2640,65,65
3,1.5,1640,5650,1,0,0,3,8,1640,0,47.509,-122.251,1640,5650,7290,7290,1640,67,67
5,1.75,3700,9140,1,0,0,3,8,1850,1850,47.5086,-122.258,2190,6720,12840,8910,3700,62,62
3,1.75,2210,7920,1,0,0,3,7,1400,810,47.4968,-122.237,2220,7920,10130,10140,2210,53,53
3,2.25,2230,4551,1,0,2,5,8,1450,780,47.5078,-122.236,2060,7200,6781,9260,2230,91,91
3,1,1340,7260,1,0,0,3,6,1340,0,47.4934,-122.237,1210,7260,8600,8470,1340,75,75
3,2.5,1190,3000,2,0,0,3,7,1190,0,47.4933,-122.275,1190,3000,4190,4190,1190,17,17
3,1,1180,5650,1,0,0,3,7,1180,0,47.5112,-122.257,1340,5650,6830,6990,1180,64,64
2,1,1150,12775,1,1,4,4,6,1150,0,47.502,-122.222,2440,11852,13925,14292,1150,111,111
3,1.75,1080,9262,1,0,0,3,7,1080,0,47.4883,-122.248,1090,9262,10342,10352,1080,51,51
3,2.25,2470,5650,1,0,2,3,7,1550,920,47.5072,-122.252,1660,5650,8120,7310,2470,46,46
4,2.5,3160,6540,1,0,3,3,8,1580,1580,47.5037,-122.24,1990,7090,9700,9080,3160,60,60
2,1,710,7200,1,0,0,3,6,710,0,47.4903,-122.245,960,7200,7910,8160,710,76,76
4,1.5,1440,8680,1,0,0,3,7,1440,0,47.502,-122.228,1440,9000,10120,10440,1440,97,97
4,3.5,3040,7125,2,0,1,3,8,2240,800,47.492,-122.225,2220,7800,10165,10020,3040,17,17
4,1.75,2010,10816,1,0,0,3,7,1410,600,47.5048,-122.251,1610,9360,12826,10970,2010,64,64
4,1.75,2000,6120,1,0,0,3,7,1100,900,47.5035,-122.258,1880,6120,8120,8000,2000,54,54
3,2,2110,6900,1,0,0,5,6,1220,890,47.504,-122.26,1350,7683,9010,9033,2110,64,64
4,1.75,1950,7139,1,1,4,3,7,1150,800,47.5121,-122.248,1600,13122,9089,14722,1950,62,62
3,1.75,1740,11547,1,0,0,3,7,1740,0,47.4945,-122.22,880,78408,13287,79288,1740,65,65
3,1.5,1220,8345,1,0,0,3,7,1220,0,47.5038,-122.266,1880,10169,9565,12049,1220,88,88
2,1,760,3800,1,0,0,3,6,760,0,47.5019,-122.269,1220,7410,4560,8630,760,69,69
4,1.5,1580,6200,1,0,0,3,6,790,790,47.4971,-122.24,1320,6499,7780,7819,1580,75,75
4,2.5,1740,6000,1,0,0,4,7,1740,0,47.5026,-122.236,1190,6000,7740,7190,1740,67,67
3,1,840,3000,1,0,0,3,5,840,0,47.494,-122.275,1010,6000,3840,7010,840,76,76
3,1,790,6750,1,0,0,2,6,790,0,47.4984,-122.24,960,6298,7540,7258,790,75,75
3,1,1450,6776,1,0,0,3,7,1450,0,47.5056,-122.244,1680,7200,8226,8880,1450,67,67
4,2,2240,4508,1,0,2,4,8,1340,900,47.5096,-122.25,1930,5250,6748,7180,2240,93,93
4,2,2430,8960,1,0,0,3,7,1430,1000,47.4979,-122.232,2430,8960,11390,11390,2430,59,59
3,1.75,1550,7410,1,0,0,5,7,1550,0,47.4951,-122.237,1250,7467,8960,8717,1550,75,75
2,1.5,1010,6000,1,0,0,4,7,1010,0,47.498,-122.222,1290,6000,7010,7290,1010,96,96
3,1,1100,27008,1,0,0,3,6,960,140,47.4963,-122.249,1280,8890,28108,10170,1100,84,84
3,3,1790,13350,1,0,0,3,7,1190,600,47.4958,-122.262,1740,10624,15140,12364,1790,31,31
3,3.75,3890,7140,1,0,2,3,8,2390,1500,47.5073,-122.239,1820,7320,11030,9140,3890,76,7
3,3,2400,7260,1,0,0,3,7,1440,960,47.5045,-122.251,1060,7200,9660,8260,2400,64,64
3,1,1180,6050,1,0,0,3,6,820,360,47.4945,-122.249,1070,6050,7230,7120,1180,75,75
3,1.75,1720,6000,1,0,2,3,7,1000,720,47.4999,-122.223,1690,6000,7720,7690,1720,65,65
4,1.75,1850,8580,1,0,0,3,7,1140,710,47.4877,-122.24,2210,9240,10430,11450,1850,59,59
3,1,890,7110,1,0,0,3,6,890,0,47.4971,-122.261,1100,8375,8000,9475,890,62,62
4,2,2030,8120,2,0,0,3,7,2030,0,47.4994,-122.261,1520,9440,10150,10960,2030,69,69
4,1.75,2320,5490,1,0,3,3,8,1160,1160,47.5091,-122.241,2240,7200,7810,9440,2320,63,63
4,2,2090,6630,1,0,0,3,7,1070,1020,47.5077,-122.268,1550,7980,8720,9530,2090,45,45
2,1.75,1670,10725,1,0,0,3,7,1670,0,47.4893,-122.229,1600,10725,12395,12325,1670,54,54
5,2.5,2690,5557,2,0,0,3,7,2690,0,47.4914,-122.253,2090,10500,8247,12590,2690,7,7
3,1.5,880,6600,1,0,0,5,6,880,0,47.5002,-122.247,1020,6600,7480,7620,880,74,74
4,1,2050,7590,1,0,0,3,7,1280,770,47.4916,-122.224,2050,7800,9640,9850,2050,62,62
3,1,1200,5650,1,0,0,3,7,1200,0,47.5065,-122.249,1610,5650,6850,7260,1200,91,91
3,1,1210,6000,1,0,0,3,7,1210,0,47.4984,-122.224,1210,6000,7210,7210,1210,89,89
2,2,1860,10856,1,0,0,3,8,1260,600,47.4989,-122.265,1250,10008,12716,11258,1860,67,67
2,1,860,5000,1,0,0,3,7,860,0,47.5005,-122.267,1130,6000,5860,7130,860,70,70
3,2.25,1810,11800,1,0,0,3,7,1240,570,47.4997,-122.231,1810,5641,13610,7451,1810,42,42
4,2.25,2600,9900,1,0,0,3,7,1600,1000,47.4881,-122.237,1770,11250,12500,13020,2600,54,54
4,3,2400,5400,2,0,2,4,7,1600,800,47.5099,-122.26,2400,5400,7800,7800,2400,54,54
3,1.75,1190,6000,1,0,0,3,7,1190,0,47.5026,-122.236,1200,6000,7190,7200,1190,67,0
4,2,1460,7254,1,0,0,3,6,1460,0,47.5056,-122.254,1460,7236,8714,8696,1460,60,60
4,2.5,2330,7050,2,0,0,3,8,2330,0,47.5001,-122.231,1810,5424,9380,7234,2330,21,21
4,1.5,2390,7480,1,0,2,3,7,2390,0,47.504,-122.227,2850,6867,9870,9717,2390,99,99
2,1,880,6780,1,0,0,4,6,880,0,47.5009,-122.248,1190,6780,7660,7970,880,74,74
4,2.5,2080,5650,1,0,0,3,7,1680,400,47.5107,-122.257,1270,5650,7730,6920,2080,69,69
2,1,860,5265,1,0,0,3,6,860,0,47.5048,-122.272,1650,8775,6125,10425,860,88,88
3,2,1300,9334,1,0,0,5,7,1300,0,47.4865,-122.238,2210,9636,10634,11846,1300,38,38
5,3,3190,7081,1,0,2,3,9,1890,1300,47.509,-122.24,2270,7623,10271,9893,3190,6,6
5,1.75,2840,12870,2,0,2,4,7,2840,0,47.4961,-122.235,2170,9612,15710,11782,2840,94,94
4,2.5,1840,9611,2,0,0,3,7,1840,0,47.4964,-122.251,1830,8505,11451,10335,1840,23,23
4,1.75,2230,9625,1,0,4,3,8,1180,1050,47.508,-122.244,2300,8211,11855,10511,2230,64,64
3,1.75,1900,7680,1,0,0,3,7,1260,640,47.5081,-122.266,2000,7740,9580,9740,1900,60,60
3,2.25,2100,8201,1,0,2,3,8,1620,480,47.5091,-122.244,2660,8712,10301,11372,2100,52,52
4,2.75,3160,8429,1,0,3,4,7,1620,1540,47.511,-122.251,1760,6780,11589,8540,3160,37,37
2,1,920,7716,1,0,0,3,6,920,0,47.5028,-122.243,1410,7128,8636,8538,920,75,75
3,1.75,1420,3000,1,0,0,3,5,710,710,47.4928,-122.274,1960,5000,4420,6960,1420,88,0
3,2.75,2000,6405,1,0,0,3,8,1260,740,47.5066,-122.259,2130,6510,8405,8640,2000,55,55
4,3.25,3190,11774,2,1,4,3,8,2610,580,47.5033,-122.225,2240,8725,14964,10965,3190,63,23
2,1.5,1120,17487,1,0,0,3,6,1120,0,47.5024,-122.271,1690,8056,18607,9746,1120,95,95
2,1,580,7500,1,0,0,3,5,580,0,47.4852,-122.251,1700,11250,8080,12950,580,76,76
3,1.5,1130,7200,1,0,0,3,7,1130,0,47.5041,-122.253,1130,7200,8330,8330,1130,65,65
5,3,2480,10090,1,0,0,3,7,1300,1180,47.4964,-122.263,2290,9900,12570,12190,2480,15,15
3,2,1150,6000,1,0,0,5,7,1150,0,47.498,-122.263,1980,6360,7150,8340,1150,63,63
3,2.5,3070,5871,3,0,0,4,8,2510,560,47.5007,-122.223,2220,4000,8941,6220,3070,91,91
2,1,930,11450,1,0,0,3,6,930,0,47.4862,-122.264,1150,11450,12380,12600,930,73,73
3,1,960,6400,1,0,0,4,6,820,140,47.496,-122.239,1200,6600,7360,7800,960,75,75
4,2.75,1920,4627,1,0,0,3,8,1010,910,47.5003,-122.23,1910,7210,6547,9120,1920,21,21
2,1,760,6407,1,0,0,3,6,760,0,47.4977,-122.259,1050,8580,7167,9630,760,76,76
2,1,1160,17635,1,1,4,3,6,1160,0,47.5117,-122.248,1510,13122,18795,14632,1160,74,74
3,1,1270,6405,1,0,0,3,6,1270,0,47.4959,-122.241,1110,6405,7675,7515,1270,75,75
2,1,720,18000,1,0,0,3,6,720,0,47.5054,-122.261,1250,7925,18720,9175,720,69,69
3,2,1830,17321,1,0,0,4,7,1100,730,47.5072,-122.272,1450,10706,19151,12156,1830,71,71
3,1.75,1160,5082,1,0,0,3,6,580,580,47.503,-122.262,1730,6000,6242,7730,1160,77,77
3,1,2000,15900,1,0,0,3,6,1000,1000,47.4816,-122.233,1760,10500,17900,12260,2000,71,71
3,1.75,1830,12500,1,0,1,3,7,1200,630,47.5087,-122.25,1830,7300,14330,9130,1830,72,72
4,1.75,1850,6000,1,0,0,4,6,1270,580,47.4923,-122.247,1270,6600,7850,7870,1850,75,75
4,1.75,1760,6204,1,0,2,4,7,1180,580,47.5045,-122.24,1990,6240,7964,8230,1760,69,69
6,2,2350,6554,2,0,1,3,8,2000,350,47.5115,-122.256,1560,6554,8904,8114,2350,114,114
4,1,1500,6360,1,0,0,3,6,1500,0,47.4979,-122.24,1190,6360,7860,7550,1500,75,75
3,1.75,2190,7021,1,0,2,4,7,1390,800,47.5033,-122.232,2180,7155,9211,9335,2190,66,66
4,1.75,1670,8856,1,0,2,3,7,1070,600,47.5056,-122.251,1660,8088,10526,9748,1670,64,64
3,1.75,2180,7200,1,0,3,4,8,1090,1090,47.5044,-122.235,2180,7140,9380,9320,2180,65,65
5,2,2020,67953,1,0,0,4,7,1620,400,47.4891,-122.263,1270,13198,69973,14468,2020,83,83
3,2.25,2210,10794,1,0,0,3,7,1540,670,47.4911,-122.224,2230,10753,13004,12983,2210,52,52
4,2.75,1900,6000,1,0,2,3,7,1300,600,47.495,-122.229,2230,6000,7900,8230,1900,58,58
4,2,1880,7500,1,0,0,5,6,980,900,47.495,-122.266,1670,14350,9380,16020,1880,73,73
5,2,1730,7375,1,0,0,4,6,1730,0,47.4953,-122.238,1550,7125,9105,8675,1730,75,75
4,2.75,2770,3852,2,0,0,3,8,2770,0,47.5001,-122.232,1810,5641,6622,7451,2770,5,5
3,1,1120,8576,1,0,0,3,6,1120,0,47.4896,-122.248,1050,8812,9696,9862,1120,76,76
2,1,1770,5522,1,0,0,4,7,960,810,47.4974,-122.231,1830,7378,7292,9208,1770,76,76
3,1,1340,10035,1,0,0,3,7,1340,0,47.4916,-122.254,2090,10035,11375,12125,1340,60,60
4,1.75,2180,9702,1,0,0,5,7,1090,1090,47.4973,-122.268,2020,9792,11882,11812,2180,57,57
6,3.5,3020,4500,2,0,0,3,7,3020,0,47.498,-122.225,900,6000,7520,6900,3020,78,22
3,1,1320,9520,1,0,0,3,7,990,330,47.4857,-122.253,1460,10610,10840,12070,1320,66,66
3,1,1070,5750,1,0,0,3,7,1070,0,47.5071,-122.255,1420,6500,6820,7920,1070,67,67
4,1.75,1970,8390,1,0,0,3,7,1140,830,47.4861,-122.251,1710,10890,10360,12600,1970,64,64
2,1,1280,12500,1,0,0,3,7,1060,220,47.4833,-122.237,1460,17771,13780,19231,1280,68,68
2,1.75,1900,13122,1,1,4,3,7,1100,800,47.5121,-122.248,1650,13160,15022,14810,1900,65,65
3,1,1360,5967,1,0,0,3,6,1360,0,47.4973,-122.256,1360,6052,7327,7412,1360,65,65
3,2.25,1950,7221,1,0,0,4,8,1950,0,47.431,-122.285,2310,8125,9171,10435,1950,13,13
3,1.75,2040,7281,1,0,0,3,7,1020,1020,47.4681,-122.282,1740,7527,9321,9267,2040,57,57
2,1.75,1330,7200,1,0,0,3,7,1330,0,47.4467,-122.281,1450,11682,8530,13132,1330,26,26
4,2.5,3280,16575,1,0,0,3,9,2190,1090,47.426,-122.285,1570,13209,19855,14779,3280,47,47
5,3,2480,7200,1,0,0,3,7,1560,920,47.4586,-122.283,1910,9432,9680,11342,2480,20,20
3,1,1130,10650,1,0,0,3,7,1130,0,47.4363,-122.286,1320,10650,11780,11970,1130,65,65
3,1,970,9130,1,0,0,3,6,970,0,47.4369,-122.272,1000,8886,10100,9886,970,62,62
2,1,740,7380,1,0,0,4,6,740,0,47.4481,-122.278,1500,10075,8120,11575,740,68,68
4,2.5,2560,7492,2,0,0,3,8,2560,0,47.4467,-122.287,1260,11541,10052,12801,2560,5,5
3,1,1060,10042,1,0,0,4,7,1060,0,47.4434,-122.283,1130,10925,11102,12055,1060,62,62
4,1,1400,7242,1,0,0,3,7,1400,0,47.4339,-122.291,1310,7314,8642,8624,1400,60,60
3,1,1010,15701,1,0,0,4,7,1010,0,47.4518,-122.292,1260,9800,16711,11060,1010,70,70
2,1,880,9000,1,0,0,3,5,880,0,47.4672,-122.291,1410,10000,9880,11410,880,91,91
3,1.75,1870,8250,2,0,0,3,7,1870,0,47.445,-122.285,1350,8714,10120,10064,1870,63,36
4,1,1360,11175,1,0,0,3,7,1360,0,47.4551,-122.272,1340,9702,12535,11042,1360,58,58
4,1,1920,13787,1,0,0,4,7,1220,700,47.4502,-122.277,1490,11200,15707,12690,1920,53,53
2,1.5,1430,9782,1,0,0,3,7,1430,0,47.441,-122.282,1430,9828,11212,11258,1430,64,64
3,1.5,1860,7963,1,0,0,3,7,1200,660,47.4513,-122.268,1800,10400,9823,12200,1860,56,56
4,1.5,2040,10488,1,0,0,3,7,1190,850,47.4557,-122.269,1960,10488,12528,12448,2040,58,58
3,1,1060,9946,1,0,0,4,7,1060,0,47.4432,-122.282,1310,10619,11006,11929,1060,63,63
4,3.5,2630,3435,1,0,3,3,7,1640,990,47.4355,-122.272,1920,2435,6065,4355,2630,35,35
3,1.5,910,25500,1,0,0,3,5,910,0,47.4565,-122.276,1580,10019,26410,11599,910,76,76
3,2,2420,8800,1,0,0,4,7,1420,1000,47.4322,-122.291,1546,8666,11220,10212,2420,60,60
4,1.75,1340,8700,1,0,0,3,6,1340,0,47.4514,-122.287,1240,8700,10040,9940,1340,61,61
3,1,980,7606,1,0,0,3,7,980,0,47.4356,-122.29,980,8125,8586,9105,980,65,65
4,3,2420,9566,2,0,0,3,7,2420,0,47.4693,-122.266,2420,9135,11986,11555,2420,16,16
3,1.75,1350,8737,1,0,0,3,7,1350,0,47.4378,-122.279,1600,8928,10087,10528,1350,53,53
3,2.5,1560,9600,1,0,0,3,7,1210,350,47.457,-122.27,2070,9600,11160,11670,1560,55,55
3,2.25,2150,30476,2,0,0,3,7,2150,0,47.4605,-122.277,2010,10800,32626,12810,2150,28,28
2,1,680,8064,1,0,0,3,6,680,0,47.469,-122.298,1340,10800,8744,12140,680,78,78
2,1.75,2330,7280,1,0,0,3,7,1450,880,47.4282,-122.28,1830,12178,9610,14008,2330,37,37
4,2.5,3390,7870,2,0,0,3,8,3390,0,47.4536,-122.274,1960,10069,11260,12029,3390,5,5
3,2.5,2340,8414,1,0,0,3,7,1280,1060,47.4685,-122.265,2340,7268,10754,9608,2340,26,26
3,1,1170,7320,1,0,0,3,7,1170,0,47.4685,-122.282,2040,7320,8490,9360,1170,57,57
5,1.75,2180,9178,1,0,0,3,7,1140,1040,47.4364,-122.28,2140,9261,11358,11401,2180,56,56
4,2.25,2100,7305,1,0,0,4,7,1050,1050,47.4676,-122.296,1760,7308,9405,9068,2100,56,56
4,2,2030,9600,1,0,0,3,6,1430,600,47.4459,-122.272,1820,14600,11630,16420,2030,72,72
5,4.5,3540,21217,2,0,0,4,8,2940,600,47.4274,-122.28,1290,12040,24757,13330,3540,93,93
6,2.5,2420,11662,1,0,2,4,7,1420,1000,47.4459,-122.278,1630,11662,14082,13292,2420,54,54
4,2.5,3020,8750,1,0,0,3,8,1710,1310,47.4298,-122.29,1900,8750,11770,10650,3020,59,59
3,1,1270,12733,1,0,0,3,7,1270,0,47.445,-122.276,1660,11536,14003,13196,1270,64,64
4,2.75,3550,13938,1,0,0,5,8,2100,1450,47.425,-122.283,2050,9000,17488,11050,3550,53,53
3,1,1740,10875,1,0,0,4,7,1020,720,47.4682,-122.283,1470,8532,12615,10002,1740,57,57
3,1,1100,7657,1,0,0,3,7,1100,0,47.4374,-122.285,1300,8000,8757,9300,1100,64,64
6,1.75,2210,8594,1,0,0,3,7,1310,900,47.4594,-122.273,1850,8594,10804,10444,2210,60,60
3,3.5,2100,12384,2,0,0,3,9,2100,0,47.4687,-122.263,2400,7776,14484,10176,2100,39,39
4,1.75,1630,8410,1,0,0,5,7,1630,0,47.4538,-122.288,1390,8410,10040,9800,1630,76,76
2,1.5,1480,9660,1,0,0,3,7,1480,0,47.4577,-122.289,1990,9660,11140,11650,1480,70,70
3,1,1040,9750,1,0,0,3,7,1040,0,47.4553,-122.274,1510,11100,10790,12610,1040,60,60
3,2,1260,4125,1,0,0,3,6,1260,0,47.4401,-122.279,1300,9091,5385,10391,1260,21,21
3,1.75,1590,11914,1,0,2,3,7,1090,500,47.4427,-122.274,1630,9052,13504,10682,1590,62,62
6,4,4470,17877,3,0,3,3,9,3230,1240,47.4514,-122.273,1790,18260,22347,20050,4470,6,6
6,2.75,2410,10763,1,0,0,5,7,1310,1100,47.4429,-122.282,1310,10746,13173,12056,2410,62,62
4,3.5,2260,30250,2,0,0,3,7,2260,0,47.4493,-122.281,1270,16350,32510,17620,2260,6,6
3,1,1560,7800,1,0,0,3,7,1560,0,47.4549,-122.287,1468,9375,9360,10843,1560,64,64
4,1.75,1720,10137,2,0,0,3,7,1720,0,47.4424,-122.276,1350,10205,11857,11555,1720,63,63
2,1,790,14200,1,0,0,3,7,790,0,47.459,-122.285,1430,10000,14990,11430,790,68,68
4,2.5,2380,13550,2,0,0,3,7,2380,0,47.4486,-122.288,1230,9450,15930,10680,2380,20,20
3,1,1270,16800,1,0,0,4,7,1270,0,47.4599,-122.276,1700,10200,18070,11900,1270,62,62
3,2.25,1800,9597,1,0,2,3,7,1200,600,47.4516,-122.267,1700,13502,11397,15202,1800,56,56
3,1,1350,7973,1,0,0,3,7,1350,0,47.4323,-122.292,1310,7491,9323,8801,1350,65,65
3,1.75,1650,12349,1,0,0,3,7,1650,0,47.442,-122.282,1470,10763,13999,12233,1650,62,62
3,1.75,1650,8850,1,0,0,3,7,1650,0,47.4331,-122.291,1400,8800,10500,10200,1650,60,60
4,2,1890,8362,1,0,0,3,7,1890,0,47.4377,-122.279,1600,9257,10252,10857,1890,53,53
5,2.25,2340,7494,1,0,0,3,7,1170,1170,47.448,-122.28,1650,10125,9834,11775,2340,68,68
2,1,670,6750,1,0,0,4,5,670,0,47.4521,-122.283,1700,11520,7420,13220,670,72,72
3,1.5,1430,8861,1,0,0,3,7,1430,0,47.4454,-122.289,1080,9425,10291,10505,1430,63,63
2,2.5,1370,3438,2,0,0,3,7,1370,0,47.4606,-122.283,1370,2308,4808,3678,1370,32,32
4,2,1370,8837,1,0,0,3,7,1370,0,47.4386,-122.285,1360,9000,10207,10360,1370,64,64
4,2.5,2700,6998,2,0,0,3,8,2700,0,47.4694,-122.263,2350,10550,9698,12900,2700,18,18
3,1,910,8700,1,0,0,4,6,910,0,47.449,-122.29,1090,8700,9610,9790,910,76,76
4,1.5,1950,12559,1,0,0,3,6,1950,0,47.4364,-122.282,1950,9178,14509,11128,1950,80,80
3,1.5,1340,8450,1,0,0,4,7,1340,0,47.4405,-122.28,1340,8920,9790,10260,1340,61,61
5,3,2257,10117,1,0,0,3,8,1363,894,47.4524,-122.284,1540,10700,12374,12240,2257,14,14
3,1.5,1170,11530,1,0,0,3,7,1170,0,47.4211,-122.29,1550,8605,12700,10155,1170,59,59
2,1,850,5000,1,0,0,3,6,850,0,47.3817,-122.314,1160,5000,5850,6160,850,43,43
2,1,940,5375,1,0,0,4,5,940,0,47.4206,-122.324,1200,7500,6315,8700,940,67,67
2,2.5,1090,13444,2,0,0,3,7,1090,0,47.4166,-122.319,1380,6000,14534,7380,1090,12,12
4,2.75,1810,8677,1,0,0,3,7,1810,0,47.3668,-122.31,1740,8677,10487,10417,1810,57,57
3,2.25,1990,6350,2,0,0,3,7,1990,0,47.3822,-122.316,1220,6250,8340,7470,1990,52,52
3,1.75,1580,8151,1,0,1,4,7,1100,480,47.3672,-122.312,1650,8151,9731,9801,1580,57,57
4,2,1580,9600,1,0,0,5,7,1050,530,47.4091,-122.313,1710,9600,11180,11310,1580,54,54
4,2,1757,19370,1,0,2,5,7,1757,0,47.3974,-122.312,1850,11125,21127,12975,1757,64,64
2,2,1360,5433,1,0,0,3,8,1360,0,47.3804,-122.32,1160,5264,6793,6424,1360,45,11
3,1.5,1230,10125,1,0,0,3,7,1230,0,47.397,-122.299,1970,10125,11355,12095,1230,59,59
3,2.75,3176,13391,2,0,3,4,9,2726,450,47.3429,-122.33,3470,12779,16567,16249,3176,34,34
3,1.75,1200,8631,1,0,0,3,7,1200,0,47.3864,-122.308,1564,8115,9831,9679,1200,60,60
4,2.75,2750,14982,1,0,3,3,9,1720,1030,47.3566,-122.32,2860,16344,17732,19204,2750,38,38
3,2,1300,5000,1,0,0,4,7,1300,0,47.3837,-122.304,1630,7500,6300,9130,1300,36,36
4,2.25,2280,7500,1,0,0,4,7,1140,1140,47.4182,-122.332,1660,8000,9780,9660,2280,56,56
3,1,1320,8220,1,0,0,3,7,1320,0,47.3697,-122.309,1320,7920,9540,9240,1320,60,60
4,2.5,2060,3608,2,0,0,3,7,2060,0,47.362,-122.309,2060,3608,5668,5668,2060,15,15
3,3,2110,7794,1,0,0,3,6,2110,0,47.4005,-122.293,1330,10044,9904,11374,2110,38,38
3,1.75,1995,18360,2,0,0,3,7,1995,0,47.4129,-122.322,1980,13640,20355,15620,1995,62,62
3,1.75,1370,5858,1,0,0,3,7,1370,0,47.3815,-122.313,1400,7500,7228,8900,1370,32,32
4,1,1520,7298,1,0,0,3,7,1520,0,47.3706,-122.31,1520,7298,8818,8818,1520,59,59
3,1,1070,9000,1,0,0,4,7,1070,0,47.4061,-122.33,1840,12000,10070,13840,1070,69,69
3,2.25,1770,10000,1,0,0,3,7,1340,430,47.3814,-122.322,1270,5055,11770,6325,1770,41,41
3,1.5,1010,9600,1,0,0,4,7,1010,0,47.4097,-122.316,1400,9660,10610,11060,1010,57,57
2,1.75,1370,4495,1,0,0,4,8,1370,0,47.3794,-122.317,1370,4686,5865,6056,1370,44,44
1,1,620,8685,1,0,0,4,5,620,0,47.4095,-122.29,1300,12150,9305,13450,620,43,43
3,1.75,1750,9623,1,0,0,3,7,1150,600,47.3997,-122.313,1820,9623,11373,11443,1750,57,57
4,2.5,2201,9542,2,0,0,3,8,2201,0,47.4002,-122.317,1990,9542,11743,11532,2201,13,13
2,1,1390,19988,1,0,2,4,7,1390,0,47.3985,-122.321,2580,10490,21378,13070,1390,70,70
3,1.5,1360,13496,1,0,0,4,8,1360,0,47.4032,-122.314,1900,10538,14856,12438,1360,59,59
3,2.5,3300,11525,1,0,0,5,8,1650,1650,47.4113,-122.315,1950,9680,14825,11630,3300,58,58
3,1.5,1340,7391,1,0,0,4,7,1340,0,47.3837,-122.317,1300,7391,8731,8691,1340,53,53
4,1.5,1850,7547,1,0,0,4,7,1850,0,47.3714,-122.309,1730,7577,9397,9307,1850,59,59
4,2.5,1780,6000,2,0,0,3,7,1780,0,47.3828,-122.302,1630,6000,7780,7630,1780,28,28
4,3.5,3440,6000,2,0,0,4,8,3440,0,47.4077,-122.331,1660,7800,9440,9460,3440,17,17
5,2,2050,10200,1,0,0,3,6,1430,620,47.4136,-122.333,1940,8625,12250,10565,2050,63,63
3,1,1250,10744,1,0,0,3,6,1250,0,47.4226,-122.327,1500,10710,11994,12210,1250,77,77
3,2.25,2590,15229,2,0,3,3,8,2590,0,47.3948,-122.325,2590,15229,17819,17819,2590,35,35
4,3.5,3290,20107,2,0,4,3,10,2220,1070,47.355,-122.319,2990,16988,23397,19978,3290,29,29
3,2.25,1410,8909,2,0,2,3,7,1410,0,47.3983,-122.31,2050,8909,10319,10959,1410,31,31
4,2.5,3238,9112,1,0,2,4,8,1678,1560,47.4005,-122.311,3056,9668,12350,12724,3238,40,40
3,1.75,2200,7706,2,0,2,3,7,2200,0,47.3878,-122.326,1170,70973,9906,72143,2200,111,26
2,1.75,1000,3554,1,0,0,4,8,1000,0,47.3811,-122.32,1150,4000,4554,5150,1000,44,44
3,1,1200,12500,1,0,0,3,6,1200,0,47.4162,-122.329,1200,7500,13700,8700,1200,83,83
3,2.5,2370,7500,1,0,3,3,8,1620,750,47.4091,-122.331,1960,8062,9870,10022,2370,40,40
4,2.25,2270,11997,1,0,2,4,7,1540,730,47.4095,-122.296,1920,9634,14267,11554,2270,60,60
3,2,1750,9750,1,0,0,3,7,1350,400,47.398,-122.299,1900,10125,11500,12025,1750,58,58
5,2,2050,10200,1,0,0,3,6,1430,620,47.4136,-122.333,1940,8625,12250,10565,2050,63,63
3,1,1300,14000,1,0,0,4,7,1300,0,47.4213,-122.322,1390,8750,15300,10140,1300,61,61
3,1,1540,9450,1,0,0,4,7,1540,0,47.3612,-122.315,1210,9450,10990,10660,1540,59,59
3,1,980,9115,1,0,0,3,7,980,0,47.3737,-122.312,1470,8716,10095,10186,980,51,51
4,2.75,2730,9112,1,0,2,3,9,1740,990,47.4005,-122.312,3050,10454,11842,13504,2730,23,23
2,1,800,8550,1,0,0,3,7,800,0,47.4075,-122.294,1490,8550,9350,10040,800,72,72
2,1,930,3447,1,0,0,4,8,930,0,47.3822,-122.318,1160,3447,4377,4607,930,41,41
3,1,1060,7473,1,0,0,3,7,1060,0,47.3699,-122.309,1320,7912,8533,9232,1060,60,60
4,1.75,2180,28710,1,0,0,3,8,1180,1000,47.405,-122.288,2180,28710,30890,30890,2180,69,69
4,1.5,1370,7944,1,0,0,3,7,1370,0,47.4224,-122.289,1370,9181,9314,10551,1370,58,58
2,1,730,6000,1,0,0,3,6,730,0,47.3832,-122.3,1750,7200,6730,8950,730,69,29
3,1,1260,7500,1,0,0,3,6,1260,0,47.4191,-122.33,1260,7500,8760,8760,1260,65,65
3,1.5,1060,9711,1,0,0,3,7,1060,0,47.4095,-122.315,1650,9711,10771,11361,1060,56,56
2,1,1200,9000,1,0,2,5,6,1200,0,47.4039,-122.323,1660,9000,10200,10660,1200,102,102
4,2.5,1910,7201,1,0,0,3,7,1210,700,47.3908,-122.316,1690,7554,9111,9244,1910,32,32
4,1.5,1930,15000,1,0,0,5,7,1930,0,47.3864,-122.312,1620,7500,16930,9120,1930,73,73
3,2.5,3070,14400,1,0,3,5,9,1720,1350,47.3716,-122.321,2020,18211,17470,20231,3070,34,34
3,2.5,1930,4505,1,0,3,4,7,1440,490,47.3459,-122.326,1550,4505,6435,6055,1930,46,46
3,2.75,2330,4780,2,0,3,3,8,1730,600,47.3459,-122.326,1100,5336,7110,6436,2330,89,26
3,2.25,1650,10000,2,0,0,3,7,1650,0,47.3862,-122.315,1420,10000,11650,11420,1650,31,31
3,2.25,1690,7320,2,0,0,3,7,1690,0,47.3889,-122.316,1520,7450,9010,8970,1690,32,32
3,1,1240,8000,1,0,0,4,6,1040,200,47.4204,-122.316,1240,8000,9240,9240,1240,65,65
2,1,730,2400,1,0,1,3,4,730,0,47.35,-122.322,1220,4382,3130,5602,730,85,85
4,1.75,1390,10660,1,0,0,4,7,1030,360,47.4128,-122.323,1800,11960,12050,13760,1390,59,59
3,1.5,1420,5000,1,0,0,3,7,920,500,47.4192,-122.33,1400,7500,6420,8900,1420,32,32
3,1.75,1790,12000,1,0,0,3,7,1040,750,47.3945,-122.313,1840,12000,13790,13840,1790,59,59
2,1,1010,5200,1,0,0,3,7,1010,0,47.4166,-122.323,1580,7500,6210,9080,1010,64,64
3,1.5,2100,10000,1,0,0,4,7,2100,0,47.4222,-122.331,1300,7500,12100,8800,2100,65,65
3,1.5,1520,7200,1,0,0,4,7,1160,360,47.3855,-122.302,1460,7200,8720,8660,1520,29,29
3,2.25,1990,6350,2,0,0,3,7,1990,0,47.3822,-122.316,1220,6250,8340,7470,1990,52,52
2,1.75,1330,2159,1,0,0,4,8,1330,0,47.3822,-122.32,1220,3679,3489,4899,1330,40,40
4,2,2120,8701,1,0,0,4,7,2120,0,47.3722,-122.308,1720,8527,10821,10247,2120,59,59
1,1,870,26326,1,0,0,3,6,870,0,47.4152,-122.3,1250,10608,27196,11858,870,80,80
3,2.25,1980,8755,1,0,0,4,7,1300,680,47.3922,-122.321,2030,8671,10735,10701,1980,56,56
4,2.5,3120,49456,2,1,4,4,9,2590,530,47.3535,-122.323,2030,32181,52576,34211,3120,45,25
3,1,1100,4046,1,0,4,4,6,1100,0,47.344,-122.331,2550,7847,5146,10397,1100,97,97
4,2.5,2050,5787,2,0,0,3,7,2050,0,47.3527,-122.315,2030,6615,7837,8645,2050,17,17
3,1,990,8062,1,0,0,4,7,990,0,47.4151,-122.334,1420,8790,9052,10210,990,59,59
3,2.5,1730,7202,1,0,0,3,7,1330,400,47.4099,-122.329,2100,8125,8932,10225,1730,28,28
4,1.5,1310,137214,1,0,0,4,7,1310,0,47.362,-122.316,1310,9450,138524,10760,1310,93,93
4,2.5,2290,3777,2,0,0,3,7,2290,0,47.3617,-122.308,1480,3608,6067,5088,2290,15,15
4,1.75,1570,18730,1,0,0,3,7,1200,370,47.3999,-122.301,1920,18295,20300,20215,1570,59,59
3,1.75,1860,7881,1,0,0,3,7,1160,700,47.3855,-122.322,1490,7527,9741,9017,1860,33,33
4,2,2280,10319,1,0,3,4,8,1270,1010,47.3594,-122.322,2280,9767,12599,12047,2280,30,30
3,2,1170,10051,1,0,0,4,7,1170,0,47.4229,-122.324,1440,9800,11221,11240,1170,62,62
2,1,1200,8063,1,0,0,4,6,1200,0,47.4204,-122.324,1200,7500,9263,8700,1200,61,61
3,1,970,11963,1,0,0,4,6,970,0,47.3776,-122.315,1210,11963,12933,13173,970,49,49
3,1,1060,7473,1,0,0,3,7,1060,0,47.3699,-122.309,1320,7912,8533,9232,1060,60,60
3,1,1040,8122,1,0,0,5,7,1040,0,47.3731,-122.312,1470,8676,9162,10146,1040,48,48
3,1,1010,9450,1,0,0,4,7,1010,0,47.3592,-122.315,1240,9450,10460,10690,1010,60,60
3,2,2620,10107,1,0,3,3,7,2620,0,47.4096,-122.329,1730,7812,12727,9542,2620,37,37
1,1,1220,12426,1,0,4,4,6,1220,0,47.4047,-122.331,2770,22270,13646,25040,1220,73,73
2,1.75,1240,2493,1,0,0,4,8,1240,0,47.3813,-122.322,1270,4966,3733,6236,1240,34,34
3,1,1860,9225,1,0,0,3,7,1860,0,47.3904,-122.3,1740,12204,11085,13944,1860,62,62
4,1.5,1610,6923,1,0,0,3,6,1010,600,47.3747,-122.306,1320,7684,8533,9004,1610,50,50
4,2.5,2290,8796,2,0,0,3,8,2290,0,47.3762,-122.318,2130,8796,11086,10926,2290,25,25
3,1.75,1590,7617,2,0,0,3,7,1590,0,47.3819,-122.312,1490,7450,9207,8940,1590,33,33
3,1.5,1820,8750,1,0,0,4,7,1200,620,47.4213,-122.322,1500,8000,10570,9500,1820,61,61
3,1,1210,8000,1,0,0,3,6,1210,0,47.4211,-122.314,1430,8000,9210,9430,1210,65,65
3,1,880,7500,1,0,0,3,7,880,0,47.3837,-122.307,880,7500,8380,8380,880,41,41
4,3,2320,13068,2,0,2,3,8,2320,0,47.3497,-122.317,2220,25265,15388,27485,2320,21,21
3,2,1470,8089,1,0,0,3,7,1470,0,47.3878,-122.316,1530,7721,9559,9251,1470,32,32
4,1.5,1840,9009,2,0,0,3,7,1840,0,47.406,-122.318,1390,8025,10849,9415,1840,54,54
5,1.5,1790,11656,2,0,0,3,7,1790,0,47.3961,-122.308,2040,9790,13446,11830,1790,56,56
2,1,2180,12875,1,0,0,3,7,1480,700,47.3757,-122.303,1800,7447,15055,9247,2180,60,60
3,1,1190,9083,1,0,0,3,7,1190,0,47.4116,-122.293,1190,9450,10273,10640,1190,64,64
4,2.75,3527,7200,2,0,0,3,7,3527,0,47.3823,-122.3,2490,7200,10727,9690,3527,14,14
3,2.5,2780,8225,2,0,1,3,9,2780,0,47.3509,-122.323,720,9736,11005,10456,2780,29,29
3,2,1680,19978,1,0,0,3,6,880,800,47.3924,-122.308,2150,11588,21658,13738,1680,71,71
4,2.5,1660,8063,1,0,0,4,7,1660,0,47.3761,-122.32,1060,8437,9723,9497,1660,41,41
3,2.5,2990,10711,1,1,4,3,9,1560,1430,47.3573,-122.324,2870,11476,13701,14346,2990,43,23
3,1.5,1230,7500,1,0,0,3,7,1230,0,47.4202,-122.331,1260,7800,8730,9060,1230,57,57
4,0.75,1960,8277,1,1,4,4,7,1320,640,47.3648,-122.325,1940,8402,10237,10342,1960,96,28
3,1,1520,6500,1,0,0,3,7,990,530,47.4164,-122.332,1500,7500,8020,9000,1520,61,61
3,1.75,1270,8470,1,0,0,4,7,1270,0,47.4207,-122.29,1600,8470,9740,10070,1270,59,59
2,1,880,7575,1,0,0,4,7,880,0,47.3757,-122.304,1800,7575,8455,9375,880,77,77
4,2.75,1830,3420,2,0,0,3,8,1830,0,47.366,-122.308,1813,3420,5250,5233,1830,7,7
3,1.75,1120,10187,1,0,0,3,7,1120,0,47.3694,-122.311,1900,8736,11307,10636,1120,51,51
3,1,1580,8206,1,0,0,3,7,1100,480,47.3676,-122.312,1600,8196,9786,9796,1580,57,57
4,2.75,2060,8100,1,0,0,4,7,1310,750,47.3581,-122.317,1540,8100,10160,9640,2060,31,31
4,1.75,1920,7500,1,0,0,4,7,1920,0,47.4222,-122.318,1490,8000,9420,9490,1920,57,57
3,1.75,2800,19386,1,1,4,3,8,1400,1400,47.3554,-122.324,3270,31450,22186,34720,2800,54,54
4,1.5,1420,8063,1,0,0,3,7,940,480,47.4174,-122.316,1330,7515,9483,8845,1420,57,57
3,1.75,1680,8629,1,0,0,3,8,1200,480,47.3662,-122.319,1990,8400,10309,10390,1680,42,42
3,2.75,2080,16740,1,0,3,3,8,1580,500,47.3632,-122.324,2175,7568,18820,9743,2080,53,53
2,1,950,2784,1,0,0,4,8,950,0,47.3793,-122.321,1080,3899,3734,4979,950,47,47
2,1.75,1050,2926,1,0,0,4,8,1050,0,47.3811,-122.317,1150,3802,3976,4952,1050,45,45
3,1.5,1780,16000,1,0,0,2,7,1240,540,47.419,-122.322,1860,9775,17780,11635,1780,59,59
3,2.5,2198,6222,2,0,2,3,8,2198,0,47.3906,-122.304,2198,7621,8420,9819,2198,9,9
3,2,1300,8400,1,0,0,4,7,1300,0,47.368,-122.315,1300,7500,9700,8800,1300,52,52
3,2.5,1990,9995,2,0,0,3,7,1990,0,47.383,-122.305,1680,7511,11985,9191,1990,23,23
6,1.75,2240,11180,2,0,0,4,7,2240,0,47.42,-122.323,1590,7955,13420,9545,2240,64,64
4,3.25,3380,7500,2,0,3,3,7,2420,960,47.4092,-122.33,1920,7500,10880,9420,3380,29,29
3,1.5,1450,6875,1,0,0,4,7,1450,0,47.4205,-122.316,1270,8000,8325,9270,1450,58,58
3,1,1730,7950,1,0,0,4,7,1180,550,47.3644,-122.312,1830,8890,9680,10720,1730,58,58
2,1,960,7000,1,0,0,3,4,960,0,47.3864,-122.307,1850,8120,7960,9970,960,101,101
3,1,1040,7500,1,0,0,4,6,1040,0,47.4206,-122.316,1270,8000,8540,9270,1040,65,65
4,1.5,2000,6778,1,0,0,4,7,1170,830,47.3708,-122.311,1940,7531,8778,9471,2000,57,57
5,2.5,1740,8750,1,0,0,4,7,1740,0,47.3904,-122.299,1740,8750,10490,10490,1740,60,60
3,2,1540,10410,1,0,0,4,7,1540,0,47.3662,-122.315,1590,7725,11950,9315,1540,52,52
3,3,2790,12523,2,1,4,4,8,1600,1190,47.3571,-122.324,2990,11476,15313,14466,2790,42,42
4,3,2253,7700,2,0,0,3,7,2253,0,47.3935,-122.3,1786,9052,9953,10838,2253,62,1
3,2.5,1660,5550,2,0,0,3,7,1660,0,47.375,-122.304,1810,5550,7210,7360,1660,17,17
3,2,1550,18958,1,0,0,3,7,1550,0,47.3699,-122.319,1840,12826,20508,14666,1550,36,36
4,2,1330,9188,1,0,0,3,7,1330,0,47.401,-122.319,1770,10419,10518,12189,1330,91,10
5,1,1410,6400,1,0,0,5,7,960,450,47.4207,-122.334,1400,6500,7810,7900,1410,64,64
5,1.5,1840,8050,1,0,0,4,7,1840,0,47.3668,-122.312,1690,8151,9890,9841,1840,57,57
3,1,1110,9827,1,0,0,3,7,1110,0,47.369,-122.311,1540,10187,10937,11727,1110,53,53
2,1.75,1340,7250,1,0,0,5,5,700,640,47.408,-122.327,1830,9750,8590,11580,1340,70,70
5,1.75,1320,38125,1,0,0,4,7,1120,200,47.3937,-122.323,2360,15070,39445,17430,1320,72,72
3,1.5,1370,7500,1,0,0,3,7,1080,290,47.4167,-122.322,1400,7500,8870,8900,1370,61,61
5,1.75,2590,9394,1,0,0,4,7,1390,1200,47.3941,-122.307,2580,9049,11984,11629,2590,56,56
3,2,2460,53882,1,1,4,3,7,2460,0,47.3811,-122.325,2660,32625,56342,35285,2460,64,64
4,2,1610,6200,1,0,0,4,7,1610,0,47.3833,-122.306,1610,7500,7810,9110,1610,40,40
3,1,1220,6719,1,0,0,3,6,1220,0,47.4187,-122.329,1580,7200,7939,8780,1220,66,66
3,1.75,1310,9645,1,0,0,3,7,1310,0,47.4051,-122.29,1440,9893,10955,11333,1310,40,40
2,1.5,1643,14616,1,0,1,4,7,1643,0,47.3973,-122.312,2270,9940,16259,12210,1643,65,65
3,2.5,2700,9994,1,0,3,4,7,1350,1350,47.397,-122.321,2470,10664,12694,13134,2700,60,60
4,2.5,2790,7956,2,0,0,3,9,2790,0,47.3681,-122.31,1660,8192,10746,9852,2790,14,14
4,1.75,1680,9966,1,0,0,3,7,1100,580,47.3923,-122.311,2400,10369,11646,12769,1680,42,42
4,2.75,2960,10454,1,0,1,3,8,2360,600,47.4006,-122.322,1870,10500,13414,12370,2960,40,40
3,1,1240,18000,1,0,0,2,7,1240,0,47.3514,-122.315,1240,18000,19240,19240,1240,76,76
3,2,2220,6641,1,0,2,4,7,1220,1000,47.6426,-122.388,1800,5900,8861,7700,2220,72,72
4,1.75,1870,6000,1,0,0,5,8,1670,200,47.6435,-122.399,1710,6000,7870,7710,1870,70,70
1,1,1080,5000,1,0,0,3,7,1080,0,47.6603,-122.394,1620,4000,6080,5620,1080,71,71
2,2.25,2470,7658,1,0,0,4,8,1480,990,47.653,-122.416,2070,7270,10128,9340,2470,65,65
4,4,3530,8400,2,0,0,5,8,2630,900,47.6402,-122.395,2340,8216,11930,10556,3530,61,61
2,1.75,2320,6755,1,0,0,5,8,1380,940,47.6398,-122.403,1990,5000,9075,6990,2320,73,73
5,1.75,2220,6000,1,0,0,3,7,1420,800,47.648,-122.384,1550,1715,8220,3265,2220,96,96
5,3,2710,8227,1,0,2,3,8,1910,800,47.6505,-122.39,2060,5400,10937,7460,2710,66,66
2,1.75,2130,6574,1,0,0,3,8,1500,630,47.6529,-122.411,2130,6275,8704,8405,2130,73,73
3,3.5,1450,1263,2,0,0,3,8,1160,290,47.6508,-122.383,1390,1282,2713,2672,1450,12,12
2,2,1340,5350,1,0,0,3,8,1340,0,47.6384,-122.403,2210,5350,6690,7560,1340,78,78
5,3.75,4450,7680,2,0,0,3,9,3460,990,47.6418,-122.392,2550,6400,12130,8950,4450,9,9
3,1.75,1800,5816,1,0,0,5,7,900,900,47.6529,-122.407,1650,5816,7616,7466,1800,72,72
3,1.75,1560,6000,1,0,0,3,6,780,780,47.6501,-122.384,1560,1734,7560,3294,1560,75,75
3,1.75,1670,5375,1,0,0,3,7,1270,400,47.6416,-122.397,1460,6125,7045,7585,1670,67,67
4,3,2020,6000,1,0,0,3,8,1220,800,47.6563,-122.401,1400,6000,8020,7400,2020,51,0
3,2.25,1230,1238,2,0,0,3,8,1080,150,47.6519,-122.384,1230,953,2468,2183,1230,10,10
2,2,1350,1209,3,0,0,3,8,1350,0,47.649,-122.383,1310,982,2559,2292,1350,6,6
4,2.75,1890,1475,2,0,0,3,9,1200,690,47.6472,-122.383,1650,1682,3365,3332,1890,4,4
3,2.5,1300,877,2,0,0,3,7,1060,240,47.6591,-122.392,1320,1414,2177,2734,1300,11,11
4,2.75,3600,5040,2,0,0,3,9,2610,990,47.6487,-122.388,1590,5040,8640,6630,3600,15,15
3,1.75,1580,5750,1,0,2,4,8,1330,250,47.6339,-122.392,2480,5750,7330,8230,1580,72,72
4,2.25,3490,6906,2,0,0,4,10,2280,1210,47.6424,-122.407,2540,6223,10396,8763,3490,91,91
3,1,1450,5378,1,0,0,3,7,1190,260,47.6436,-122.405,1810,5559,6828,7369,1450,80,80
3,1.5,1270,1318,2,0,0,3,7,1080,190,47.6526,-122.384,1360,1488,2588,2848,1270,15,15
3,3,2960,5500,2,0,2,3,10,2440,520,47.6356,-122.402,2960,5876,8460,8836,2960,82,24
3,2.5,1710,1664,2,0,0,5,8,1300,410,47.6456,-122.383,1470,5400,3374,6870,1710,16,16
4,1.75,3720,8448,1,0,3,4,9,1960,1760,47.6425,-122.406,2540,7064,12168,9604,3720,72,72
3,2.75,3450,5350,1,0,3,4,9,2590,860,47.6389,-122.407,2910,5350,8800,8260,3450,94,94
4,2,2210,8556,1,0,1,4,8,1210,1000,47.6498,-122.396,2190,7975,10766,10165,2210,65,65
4,1.75,1490,4485,1,0,0,3,8,1350,140,47.6388,-122.399,1380,4846,5975,6226,1490,59,59
4,1.5,2740,4912,1,0,0,4,8,1370,1370,47.6523,-122.412,2160,5006,7652,7166,2740,82,82
3,2.5,2920,5629,1,0,2,5,8,1460,1460,47.642,-122.405,2380,5000,8549,7380,2920,64,64
4,1,1690,3417,1,0,0,3,7,1690,0,47.663,-122.402,1970,4800,5107,6770,1690,112,112
4,3,2400,7680,1,0,0,3,7,1200,1200,47.6466,-122.389,2670,6342,10080,9012,2400,63,63
3,3.5,2130,6150,2,0,2,5,8,1530,600,47.6491,-122.405,2040,5381,8280,7421,2130,111,111
3,2.5,1510,1618,2,0,0,3,8,1330,180,47.6515,-122.384,1350,1397,3128,2747,1510,8,8
3,2.5,2860,4442,2,0,0,3,8,2860,0,47.661,-122.396,1440,4400,7302,5840,2860,19,19
3,2,1380,4800,1,0,0,3,7,1380,0,47.651,-122.369,1740,5640,6180,7380,1380,71,71
4,1.5,3120,7680,1,0,3,3,8,1660,1460,47.646,-122.39,2900,7680,10800,10580,3120,63,63
4,1.75,3080,6500,1,0,0,4,9,1700,1380,47.6353,-122.402,2960,5711,9580,8671,3080,78,78
3,2.25,1970,4564,1,0,0,3,8,1470,500,47.6703,-122.41,1980,5000,6534,6980,1970,60,60
3,2.75,2310,5200,1,0,0,4,7,1520,790,47.6357,-122.397,2310,5200,7510,7510,2310,79,79
4,2.5,3220,4400,2,0,2,3,9,2180,1040,47.6325,-122.394,3000,5000,7620,8000,3220,82,82
5,4.5,5620,5800,3,0,3,3,11,4700,920,47.6482,-122.412,2360,5800,11420,8160,5620,20,20
3,2.5,1230,922,2,0,0,3,8,1080,150,47.6518,-122.384,1230,1237,2152,2467,1230,10,10
4,2.5,3690,11191,1,0,3,4,10,2190,1500,47.6434,-122.412,3460,8160,14881,11620,3690,68,68
4,2,3140,10875,1,0,1,3,7,1940,1200,47.6656,-122.406,3300,10080,14015,13380,3140,80,45
3,1.75,1500,6000,1,0,0,5,7,850,650,47.6474,-122.402,1700,6000,7500,7700,1500,79,79
3,1.75,2180,6120,1,0,2,3,8,1380,800,47.6501,-122.405,2020,6122,8300,8142,2180,70,70
4,1.75,1780,2788,1,0,0,4,6,890,890,47.6511,-122.4,1760,5664,4568,7424,1780,76,76
4,2.5,2900,21074,2,0,0,3,11,2900,0,47.6696,-122.416,3390,20000,23974,23390,2900,33,33
3,2,2300,5000,1,0,0,4,8,1150,1150,47.6521,-122.413,2300,5000,7300,7300,2300,81,81
3,3.25,1320,1327,2,0,0,3,8,1040,280,47.6506,-122.383,1440,1263,2647,2703,1320,11,11
4,2.5,2830,5932,2,0,0,3,9,2830,0,47.6479,-122.408,2840,5593,8762,8433,2830,5,5
3,2,1550,4000,1,0,0,3,7,940,610,47.6379,-122.387,1880,4000,5550,5880,1550,64,64
4,2.5,4040,9630,1,0,3,4,9,2020,2020,47.6408,-122.41,3160,8025,13670,11185,4040,68,68
3,1.75,2440,5800,1,0,3,4,8,1320,1120,47.6474,-122.412,2530,5800,8240,8330,2440,74,74
4,1.75,2320,5595,1,0,0,3,7,1510,810,47.6397,-122.388,1840,5596,7915,7436,2320,63,63
3,1,1470,6122,1,0,0,3,8,1200,270,47.6517,-122.406,2200,6122,7592,8322,1470,71,71
4,2.75,2010,7000,2,0,0,5,8,2010,0,47.6607,-122.396,1420,4400,9010,5820,2010,118,118
3,2.5,2390,5500,1,0,3,3,9,1700,690,47.6389,-122.409,2700,5500,7890,8200,2390,67,67
3,3,1490,2944,2,0,0,3,7,960,530,47.6506,-122.384,1590,1600,4434,3190,1490,26,26
3,1,1170,4400,1,0,0,3,7,870,300,47.6584,-122.391,1240,4400,5570,5640,1170,68,68
3,1.75,1990,5600,1,0,1,3,8,1330,660,47.65,-122.415,2630,6780,7590,9410,1990,78,78
4,1.75,2700,6000,1,0,0,4,8,1450,1250,47.6539,-122.395,2080,6000,8700,8080,2700,66,66
4,2,1840,5419,1,0,0,4,7,920,920,47.6483,-122.404,1800,5419,7259,7219,1840,77,77
6,3.25,2900,6400,2,0,0,4,8,2300,600,47.6464,-122.401,2480,6400,9300,8880,2900,42,42
5,4,3366,7800,2,0,2,3,8,2966,400,47.6466,-122.391,2340,6000,11166,8340,3366,82,82
4,1.5,1430,4163,1,0,0,3,7,1430,0,47.6606,-122.397,1500,4000,5593,5500,1430,109,109
3,1,1100,5400,1,0,0,3,7,1100,0,47.6604,-122.396,1770,4400,6500,6170,1100,111,111
2,1.75,1370,3125,1,0,0,3,7,1090,280,47.6492,-122.391,1730,5966,4495,7696,1370,69,69
4,2.75,3090,6600,1,0,2,3,9,1800,1290,47.6339,-122.396,2380,5000,9690,7380,3090,63,63
3,3.25,3960,6132,2,0,3,3,10,2600,1360,47.6396,-122.409,2730,5221,10092,7951,3960,86,86
3,2.5,3560,8297,1,0,2,4,8,1650,1910,47.6473,-122.407,2760,8297,11857,11057,3560,71,71
4,2.5,2210,5002,1,0,0,3,7,1370,840,47.6637,-122.401,1970,4920,7212,6890,2210,42,42
3,2.25,2910,15626,1,0,0,4,9,2510,400,47.6534,-122.412,2370,6519,18536,8889,2910,96,96
1,1,680,6600,1,0,0,3,5,480,200,47.6567,-122.392,1170,5500,7280,6670,680,103,103
2,1,1150,4000,1,0,0,3,7,1150,0,47.6575,-122.394,1150,4288,5150,5438,1150,72,72
2,1,1210,8400,1,0,0,3,8,780,430,47.6503,-122.393,1860,6000,9610,7860,1210,19,19
2,1.75,1550,6000,1,0,1,3,7,1550,0,47.6712,-122.409,2360,6000,7550,8360,1550,99,99
2,1.75,1560,3200,1,0,0,5,7,880,680,47.6419,-122.394,2060,4940,4760,7000,1560,73,73
2,2.25,1570,1269,2,0,0,3,9,1280,290,47.6514,-122.385,1570,6000,2839,7570,1570,4,4
2,1,880,1753,2,0,0,4,7,880,0,47.6475,-122.397,1010,1748,2633,2758,880,74,74
4,2.25,2290,5350,2,0,0,4,9,2120,170,47.6428,-122.411,2910,5350,7640,8260,2290,61,61
3,2.25,1230,1380,3,0,0,3,8,1230,0,47.6521,-122.4,1760,5664,2610,7424,1230,6,6
2,1.5,1990,6000,1,0,0,3,6,1430,560,47.6521,-122.398,1350,6000,7990,7350,1990,75,75
4,2.25,2060,5649,1,0,0,5,8,1360,700,47.6496,-122.407,2060,5626,7709,7686,2060,78,78
2,1.5,1220,1120,2,0,0,3,8,1110,110,47.6374,-122.388,2010,3175,2340,5185,1220,11,11
2,1,1650,9780,1,0,0,3,7,950,700,47.6549,-122.394,1650,5458,11430,7108,1650,76,76
4,3.5,4285,9567,2,0,1,5,10,3485,800,47.6434,-122.409,2960,6902,13852,9862,4285,73,73
4,3.5,3440,5000,2,0,0,3,11,2560,880,47.6672,-122.409,3090,10241,8440,13331,3440,13,13
4,3.5,4270,5800,2,0,3,5,10,3170,1100,47.6474,-122.411,3100,5800,10070,8900,4270,82,82
3,3.5,1570,1486,2,0,0,3,8,1330,240,47.652,-122.384,1610,1486,3056,3096,1570,19,19
2,1.5,1350,4592,1,0,0,3,7,1070,280,47.6511,-122.405,1610,5102,5942,6712,1350,80,80
1,1,790,3000,1,0,0,3,6,790,0,47.6544,-122.386,1110,4100,3790,5210,790,66,66
2,1.75,1960,6000,1,0,0,4,7,980,980,47.6531,-122.401,1650,6000,7960,7650,1960,115,115
4,3.5,3080,4815,2,0,3,3,10,2300,780,47.6417,-122.411,2910,5350,7895,8260,3080,82,5
4,1.75,1480,7875,1,0,0,3,7,740,740,47.643,-122.397,1680,5851,9355,7531,1480,92,92
3,1,1650,5102,1,0,0,4,8,1300,350,47.6524,-122.404,1440,5102,6752,6542,1650,66,66
3,2,1760,6428,1,0,0,4,7,980,780,47.6388,-122.397,1760,6004,8188,7764,1760,77,77
3,1.75,1560,5520,1,0,0,4,6,780,780,47.6515,-122.399,1470,6000,7080,7470,1560,75,75
6,5,7100,18200,2,0,0,3,13,5240,1860,47.6427,-122.408,3130,6477,25300,9607,7100,86,12
2,1,1120,5250,1,0,0,3,7,950,170,47.6496,-122.392,1510,5250,6370,6760,1120,81,81
3,1.75,1490,1036,2,0,0,3,10,1090,400,47.6588,-122.403,1460,1206,2526,2666,1490,11,11
3,3,4380,6320,2,0,3,5,10,3580,800,47.6452,-122.411,3080,7680,10700,10760,4380,67,67
2,1,1370,5922,1,0,2,3,8,1130,240,47.6473,-122.406,2460,6759,7292,9219,1370,78,78
3,2.5,1880,5500,2,0,0,4,7,1880,0,47.657,-122.393,1230,5500,7380,6730,1880,72,7
3,2.5,1910,1501,2,0,0,3,8,1530,380,47.6441,-122.385,1760,1750,3411,3510,1910,12,12
3,2,2310,6000,2,0,1,4,9,1560,750,47.648,-122.395,2000,6000,8310,8000,2310,93,93
3,2.5,1800,4400,1,0,0,5,7,1350,450,47.6599,-122.396,1920,4400,6200,6320,1800,49,49
2,2.25,1060,925,2,0,0,3,8,980,80,47.6386,-122.388,1020,4000,1985,5020,1060,13,13
4,2.5,2920,5500,1,0,3,3,10,2030,890,47.6406,-122.412,3790,5500,8420,9290,2920,62,62
2,1,1100,6240,1,0,0,4,7,1100,0,47.6446,-122.403,1250,6240,7340,7490,1100,78,78
4,3.5,3660,4760,2,0,0,3,9,2840,820,47.6482,-122.409,3210,4640,8420,7850,3660,5,5
3,1.75,2040,5775,1,0,0,3,7,1410,630,47.6592,-122.393,1360,4400,7815,5760,2040,61,61
5,2.5,3200,7863,1,0,3,5,8,1600,1600,47.6398,-122.39,2640,7680,11063,10320,3200,60,60
3,1.5,1360,1488,2,0,0,3,7,1120,240,47.6526,-122.384,1360,1573,2848,2933,1360,16,16
4,1,1870,4992,1,0,0,4,7,1670,200,47.6437,-122.396,2160,5239,6862,7399,1870,79,79
4,1.75,2010,6300,1,0,2,5,8,1610,400,47.6457,-122.412,3290,6300,8310,9590,2010,82,82
3,2.5,1990,3478,2,0,0,3,10,1520,470,47.6361,-122.399,1710,6157,5468,7867,1990,29,29
3,1,2090,4000,1,0,2,3,8,1890,200,47.6393,-122.392,2090,4000,6090,6090,2090,88,88
6,4,3600,6224,2,0,0,3,9,2610,990,47.6531,-122.405,1430,6224,9824,7654,3600,74,8
4,2.25,1900,5000,1,0,0,3,7,1400,500,47.6456,-122.387,1710,4994,6900,6704,1900,56,56
4,3.5,4030,4200,3,0,0,3,9,4030,0,47.6416,-122.386,2130,5000,8230,7130,4030,27,27
3,1.75,1860,5584,1,0,0,3,8,1310,550,47.637,-122.4,1630,6022,7444,7652,1860,68,68
3,2.5,1570,1452,2,0,0,3,9,1240,330,47.648,-122.396,1670,1596,3022,3266,1570,12,12
5,3.75,3290,6480,2,0,0,5,10,2190,1100,47.653,-122.415,2010,7639,9770,9649,3290,81,81
3,3.5,3080,6495,2,0,3,3,11,2530,550,47.6321,-122.393,4120,8620,9575,12740,3080,23,8
5,2.75,3520,6353,2,0,0,4,10,3520,0,47.6506,-122.391,2520,6250,9873,8770,3520,18,18
4,2.5,3520,7815,2,0,3,3,10,3140,380,47.6429,-122.412,2790,6644,11335,9434,3520,90,90
2,1,1270,6000,1,0,0,3,7,1270,0,47.6482,-122.393,1770,6000,7270,7770,1270,80,80
4,2.5,2020,4350,2,0,0,5,9,1730,290,47.6503,-122.41,1620,5800,6370,7420,2020,76,76
2,1.5,1159,4800,1,0,0,3,7,1159,0,47.6592,-122.399,1640,4800,5959,6440,1159,71,71
3,1.75,2090,4725,2,0,0,3,7,1610,480,47.657,-122.394,1280,4725,6815,6005,2090,72,1
4,2.25,2220,4200,1,0,0,5,8,1310,910,47.6418,-122.394,2020,4940,6420,6960,2220,87,87
3,2,1880,4000,1,0,2,3,8,1280,600,47.6375,-122.391,1920,4000,5880,5920,1880,69,69
3,3.25,1550,1280,2,0,0,3,9,1220,330,47.6493,-122.384,1550,1579,2830,3129,1550,6,6
4,1.75,2500,7000,1,0,0,3,7,1250,1250,47.648,-122.386,1680,7000,9500,8680,2500,72,72
3,3,2800,5800,1,0,0,3,9,1580,1220,47.6493,-122.413,2580,5800,8600,8380,2800,66,5
2,1,810,6480,1,0,0,5,6,810,0,47.6493,-122.398,1920,6000,7290,7920,810,77,77
4,2.75,2080,5000,1,0,0,5,8,1470,610,47.6422,-122.403,1970,5000,7080,6970,2080,79,79
3,2,2230,4800,1,0,0,4,7,1290,940,47.645,-122.386,1650,5040,7030,6690,2230,104,104
4,2,2590,7220,2,0,2,4,10,2590,0,47.647,-122.41,2530,6380,9810,8910,2590,89,89
2,1,820,5040,1,0,0,3,7,820,0,47.6498,-122.388,1730,5760,5860,7490,820,66,66
5,2.25,2130,4360,1,0,2,3,8,1240,890,47.6586,-122.395,1830,5000,6490,6830,2130,60,60
3,2.25,2380,6000,2,0,0,5,9,1650,730,47.6472,-122.393,2000,6000,8380,8000,2380,88,88
3,1.75,1850,6000,1,0,0,3,8,1650,200,47.6528,-122.401,1540,6000,7850,7540,1850,106,15
3,2.5,3080,8448,2,0,2,3,9,3080,0,47.6469,-122.389,2500,6400,11528,8900,3080,19,19
3,2,1470,4640,1,0,0,4,7,1470,0,47.6398,-122.393,1700,5000,6110,6700,1470,93,93
3,1.75,1720,5280,1,0,0,4,8,900,820,47.6493,-122.401,1600,6000,7000,7600,1720,76,76
3,3.25,3620,4000,2,0,0,3,10,2730,890,47.6393,-122.403,1910,5000,7620,6910,3620,14,14
2,1,1510,4032,1,0,0,3,8,1310,200,47.6371,-122.393,1700,4042,5542,5742,1510,84,84
4,3.5,2730,5607,1,0,0,5,9,1660,1070,47.6387,-122.396,1720,5400,8337,7120,2730,71,71
2,2,1510,5133,1,0,0,3,7,1510,0,47.6415,-122.401,1470,6000,6643,7470,1510,80,80
3,2.5,2680,4990,1,0,0,5,8,1440,1240,47.6538,-122.393,2320,6000,7670,8320,2680,68,68
4,2.25,2980,8051,1,0,2,4,10,2020,960,47.6426,-122.409,2760,5499,11031,8259,2980,84,84
3,2.25,1760,1800,2,0,0,3,7,1330,430,47.6579,-122.394,1150,4575,3560,5725,1760,36,36
4,2.25,2480,6000,2,0,2,3,10,2380,100,47.6392,-122.406,3030,5600,8480,8630,2480,90,90
2,1.75,1740,7290,1,0,0,3,8,1280,460,47.6461,-122.397,1820,6174,9030,7994,1740,69,69
3,2.5,2570,5500,1,0,0,4,7,1320,1250,47.6417,-122.397,1460,6250,8070,7710,2570,58,58
2,1.75,2070,23160,1,0,0,3,7,1260,810,47.6551,-122.394,1690,5458,25230,7148,2070,73,73
2,1,1380,5484,1,0,0,3,8,1030,350,47.6382,-122.399,1380,5347,6864,6727,1380,72,72
4,3.25,3610,4000,2,0,0,3,9,2640,970,47.658,-122.396,1980,4000,7610,5980,3610,12,12
2,1,820,6000,1,0,0,3,7,820,0,47.6494,-122.395,1630,6000,6820,7630,820,80,80
3,2.5,1940,4000,2,0,0,4,9,1940,0,47.659,-122.398,1410,4000,5940,5410,1940,19,19
3,1.5,1360,1795,2,0,0,3,7,1360,0,47.6471,-122.397,1580,1795,3155,3375,1360,74,74
3,2.25,2060,7080,2,0,0,3,9,1800,260,47.6455,-122.409,3070,7500,9140,10570,2060,79,79
5,3.25,4590,12793,2,0,2,5,11,3590,1000,47.6453,-122.41,2920,8609,17383,11529,4590,91,91
3,2,1430,4200,1,0,0,4,7,830,600,47.6462,-122.384,1540,5000,5630,6540,1430,111,111
2,1.75,1320,3420,1,0,1,3,7,1080,240,47.6639,-122.399,2070,6000,4740,8070,1320,64,64
2,1,720,4323,1,0,0,3,6,720,0,47.6604,-122.401,1460,3300,5043,4760,720,77,77
2,1,1260,5800,1,0,0,4,7,1260,0,47.6501,-122.409,1830,5800,7060,7630,1260,80,80
4,2.75,2820,5000,1,0,0,3,8,2170,650,47.6376,-122.394,1740,5000,7820,6740,2820,92,92
4,2.75,3160,7143,1,0,0,3,8,2100,1060,47.6513,-122.406,2200,6122,10303,8322,3160,86,86
2,1.75,1010,1461,1,0,0,3,7,670,340,47.6515,-122.4,1500,2499,2471,3999,1010,16,16
3,3,2480,5500,2,0,3,3,10,1730,750,47.6466,-122.404,2950,5670,7980,8620,2480,69,9
3,1.75,1710,5913,1,0,0,4,8,1120,590,47.6481,-122.406,2920,5922,7623,8842,1710,78,78
3,1,1190,7000,1,0,0,3,7,1190,0,47.6453,-122.403,1350,7000,8190,8350,1190,76,76
3,2.25,1460,968,2,0,0,3,7,1140,320,47.6601,-122.4,1460,1531,2428,2991,1460,16,16
5,3.25,3160,5000,2,0,2,3,10,2180,980,47.6464,-122.405,3160,5746,8160,8906,3160,14,14
3,2.5,1740,1251,2,0,0,3,9,1180,560,47.644,-122.385,1740,1625,2991,3365,1740,7,7
4,2.5,2950,7024,2,0,0,3,10,2950,0,47.6651,-122.403,2950,6339,9974,9289,2950,7,7
4,3.5,3960,6654,2,0,0,3,10,2850,1110,47.6461,-122.389,2840,6400,10614,9240,3960,13,13
3,4,3910,5350,2,0,2,5,10,2610,1300,47.6393,-122.408,2890,5350,9260,8240,3910,86,86
2,1,880,3200,1,0,0,3,7,880,0,47.6575,-122.402,1880,6000,4080,7880,880,109,44
4,4.25,4470,5884,2,0,1,3,11,3230,1240,47.6387,-122.405,2570,6000,10354,8570,4470,9,9
3,1.75,1790,6117,1,0,2,3,8,1350,440,47.6366,-122.401,1960,5554,7907,7514,1790,79,79
3,2.25,1860,15559,2,0,0,4,7,1860,0,47.1559,-121.646,1110,11586,17419,12696,1860,56,56
5,2.75,2060,329903,1,0,3,5,7,2060,0,47.1776,-121.944,2240,220232,331963,222472,2060,30,30
3,1.75,1820,32666,1,0,0,4,7,1820,0,47.1803,-121.974,2050,43560,34486,45610,1820,53,53
3,1.75,1670,11452,1,0,2,3,8,1670,0,47.1913,-122.015,1820,11152,13122,12972,1670,27,27
3,2,1760,9732,1,0,0,3,7,1760,0,47.1923,-122.014,1910,9231,11492,11141,1760,23,23
4,2.5,1800,9229,2,0,0,3,7,1800,0,47.1927,-122.015,1970,9231,11029,11201,1800,25,25
4,2.25,1600,7916,2,0,0,3,7,1600,0,47.194,-121.981,1540,7242,9516,8782,1600,28,28
3,2.75,1740,5757,1,0,0,3,7,1740,0,47.1941,-121.979,2380,5647,7497,8027,1740,9,9
5,2.5,1970,8605,2,0,0,4,7,1970,0,47.1944,-122.013,1970,8460,10575,10430,1970,25,25
3,3,1670,4440,1,0,0,3,7,1670,0,47.1948,-121.975,1670,4622,6110,6292,1670,5,5
4,2.75,2130,8560,1,0,0,3,7,1560,570,47.1949,-122.01,2130,8560,10690,10690,2130,27,27
3,2,1920,5688,1,0,3,3,9,1920,0,47.1952,-121.976,2384,4802,7608,7186,1920,12,12
3,1,1010,8863,1,0,0,4,6,1010,0,47.1955,-121.999,1090,8410,9873,9500,1010,29,29
3,2.5,2010,11618,2,0,0,3,7,2010,0,47.1956,-121.985,1550,9354,13628,10904,2010,29,29
3,2,1610,8400,1,0,0,3,8,1610,0,47.1958,-122.009,1930,8459,10010,10389,1610,29,29
3,1.75,1480,7830,1,0,0,3,7,1480,0,47.1967,-121.998,1130,7553,9310,8683,1480,39,39
4,2,1870,8750,1,0,2,3,7,1870,0,47.1985,-122.001,1770,8207,10620,9977,1870,42,42
3,1,3180,27586,1,0,0,3,8,1400,1780,47.1986,-121.967,2180,27586,30766,29766,3180,50,50
3,2.25,1600,39848,1,0,3,4,8,1600,0,47.1991,-122.013,1600,39848,41448,41448,1600,61,61
2,1,940,8997,1,0,0,5,7,940,0,47.2005,-121.999,1110,9126,9937,10236,940,64,64
3,1,1060,9126,1,0,2,5,7,1060,0,47.201,-121.999,1300,9126,10186,10426,1060,63,63
3,1,1200,7727,1,0,0,4,7,1200,0,47.2021,-121.999,1300,7718,8927,9018,1200,60,60
3,1.75,1470,8925,1,0,0,4,7,1470,0,47.2026,-122,1430,9282,10395,10712,1470,62,62
3,1.5,1370,10115,1,0,0,4,7,1370,0,47.2027,-122,1450,9282,11485,10732,1370,62,62
3,2.5,2070,25710,1,0,0,5,6,2070,0,47.2032,-121.964,1350,17998,27780,19348,2070,102,102
4,1.75,2290,36900,1,0,2,5,7,1690,600,47.2034,-122.003,2170,12434,39190,14604,2290,81,81
4,2.25,2120,53578,2,0,2,4,7,2120,0,47.2041,-122.021,2120,53578,55698,55698,2120,34,34
3,1.5,1500,10227,1,0,0,4,7,1000,500,47.2043,-121.996,1490,7670,11727,9160,1500,74,74
3,1,1050,7670,1,0,0,5,7,1050,0,47.2046,-121.996,1220,7670,8720,8890,1050,64,64
3,1.5,1560,10489,1,0,0,5,7,1560,0,47.2048,-121.999,1400,10489,12049,11889,1560,58,58
3,1.75,1940,7500,1,0,0,4,8,1940,0,47.2062,-121.993,1650,7500,9440,9150,1940,101,29
3,1.75,1400,6300,1,0,0,3,7,1400,0,47.2074,-122.001,1400,8490,7700,9890,1400,21,21
3,2,1700,8448,1,0,0,3,7,1700,0,47.2077,-122.011,1350,8587,10148,9937,1700,23,23
4,2.5,1900,8282,1,0,0,3,7,1900,0,47.2089,-122.003,1420,8350,10182,9770,1900,51,17
3,2.5,1850,8770,2,0,0,3,8,1850,0,47.2091,-122.009,2350,8606,10620,10956,1850,23,23
3,1.5,1140,8500,1,0,0,4,7,1140,0,47.2093,-122.005,1600,8500,9640,10100,1140,55,55
3,1,1020,8437,1,0,0,5,6,1020,0,47.2093,-122,1420,8500,9457,9920,1020,32,32
2,1,900,6400,1,0,0,5,6,900,0,47.2113,-121.992,1320,6400,7300,7720,900,81,81
3,2.5,1620,79993,1,0,2,4,6,1620,0,47.2138,-121.982,1620,15680,81613,17300,1620,59,59
3,1.5,1510,344124,1,0,2,4,7,1510,0,47.2156,-122.029,1750,169884,345634,171634,1510,55,55
3,2,1710,134489,1,0,2,5,7,1710,0,47.2207,-121.984,1700,63823,136199,65523,1710,67,67
4,1,1300,1651359,1,0,3,4,6,1300,0,47.2313,-122.023,2560,425581,1652659,428141,1300,99,99
3,2.25,2040,435600,2,0,2,4,7,2040,0,47.2328,-121.945,2020,223027,437640,225047,2040,36,36
3,1,960,15273,1,0,0,4,7,960,0,47.238,-122.039,1930,51400,16233,53330,960,56,56
2,1,1120,35500,1,0,0,5,6,1120,0,47.2411,-122.043,1680,66022,36620,67702,1120,58,58
3,2.5,3660,39478,2,0,2,4,9,3260,400,47.2413,-121.972,2700,38312,43138,41012,3660,30,30
3,3.5,3520,35512,2,0,2,3,8,2760,760,47.2416,-121.979,2860,39614,39032,42474,3520,14,14
3,2.25,2300,35287,2,0,0,3,8,2300,0,47.2477,-121.937,1760,47916,37587,49676,2300,42,42
4,2.75,2470,50123,1,0,0,3,8,1280,1190,47.2504,-122,2200,54520,52593,56720,2470,41,41
4,3,3620,403693,2,0,2,3,9,3620,0,47.2527,-121.98,2230,148811,407313,151041,3620,39,39
4,1.5,1590,131551,1,0,3,4,7,1590,0,47.2558,-122.024,2280,108028,133141,110308,1590,53,53
3,2.5,2260,93218,1,0,2,4,6,2260,0,47.2582,-121.935,2180,111078,95478,113258,2260,21,21
3,1.75,2610,117176,1,0,0,3,7,1390,1220,47.2585,-121.925,2140,142005,119786,144145,2610,38,38
3,2.5,1920,144619,1,0,0,3,8,1920,0,47.2683,-121.946,2010,48787,146539,50797,1920,5,5
3,2,2540,237402,1,0,0,3,9,2540,0,47.2688,-122.024,2200,229125,239942,231325,2540,12,12
2,1,1020,13647,1,0,0,5,6,1020,0,47.2848,-121.927,980,8250,14667,9230,1020,104,41
4,2.25,3180,9600,2,0,0,3,10,3180,0,47.6313,-122.045,2840,10739,12780,13579,3180,35,35
4,4.5,3780,6000,2,0,4,4,11,2770,1010,47.5922,-122.388,2660,6000,9780,8660,3780,109,38
3,2.5,2330,9160,2,0,0,3,9,2330,0,47.5467,-122.181,2460,9160,11490,11620,2330,22,22
2,2.25,1190,1499,2,0,0,3,9,1100,90,47.6666,-122.285,1430,1332,2689,2762,1190,15,15
4,1.75,2530,5000,1,0,2,5,8,2070,460,47.6624,-122.348,1950,3600,7530,5550,2530,102,102
3,2,1900,9513,1,0,0,3,8,1900,0,47.2843,-122.357,1790,8028,11413,9818,1900,24,24
4,1.75,1400,7920,1,0,0,3,7,1400,0,47.4658,-122.184,1910,7700,9320,9610,1400,56,56
3,2.5,1690,4500,1,0,1,4,8,1690,0,47.5841,-122.383,2140,7200,6190,9340,1690,91,91
7,3.5,3890,8342,2,0,4,3,9,2840,1050,47.7011,-122.392,2870,8342,12232,11212,3890,51,51
3,3.5,4660,5500,2,0,4,5,10,3040,1620,47.6465,-122.319,2980,5500,10160,8480,4660,110,110
6,2.5,4410,14034,1,0,2,4,9,2350,2060,47.3376,-122.324,2600,13988,18444,16588,4410,54,54
3,2.5,1910,5125,2,0,0,3,9,1910,0,47.5481,-121.995,1910,3215,7035,5125,1910,13,13
4,2.25,2620,8100,1,0,0,4,7,1550,1070,47.4564,-122.351,1650,8100,10720,9750,2620,55,55
6,1.5,1680,5202,1,0,0,2,7,1680,0,47.6798,-122.206,1890,5500,6882,7390,1680,108,108
3,1,980,5600,1,0,0,2,6,980,0,47.5308,-122.361,1840,5302,6580,7142,980,70,70
6,4.5,5740,10312,2,0,2,3,11,3610,2130,47.5533,-122.11,4350,11917,16052,16267,5740,19,19
3,1.75,1620,5500,1,0,0,3,7,1110,510,47.6393,-122.308,2100,6500,7120,8600,1620,69,69
4,2.5,1740,7895,2,0,0,3,7,1740,0,47.3401,-122.282,1720,6813,9635,8533,1740,20,20
5,3,2870,4369,2,0,0,3,8,2090,780,47.7449,-122.192,2640,4610,7239,7250,2870,12,12
3,1,1060,20040,1,0,0,3,6,1060,0,47.7281,-122.235,1768,10800,21100,12568,1060,76,76
4,2.25,2940,20384,2,0,0,4,9,2940,0,47.6214,-122.227,3410,19910,23324,23320,2940,49,49
3,2.25,1520,1221,3,0,0,3,8,1520,0,47.674,-122.377,1550,4750,2741,6300,1520,6,6
3,2.5,2060,5750,1,0,0,3,7,1330,730,47.5671,-122.391,1920,5750,7810,7670,2060,43,43
4,1.75,1630,3000,1,0,0,3,7,930,700,47.5961,-122.305,1630,3000,4630,4630,1630,41,41
4,2.5,3270,24750,1,0,0,4,8,1690,1580,47.5221,-122.178,1520,13480,28020,15000,3270,40,40
4,2.25,2720,18295,1,0,0,4,8,2000,720,47.5851,-122.073,2720,18295,21015,21015,2720,40,40
3,1.75,2300,12000,1,0,0,3,8,1770,530,47.7599,-122.343,2030,6000,14300,8030,2300,77,77
3,1,1640,7187,1,0,0,3,7,1640,0,47.455,-122.182,1340,8346,8827,9686,1640,53,53
3,2.5,2360,11254,1,0,2,3,9,2360,0,47.3356,-122.333,2390,11254,13614,13644,2360,29,29
4,2,2360,6000,1,0,0,5,7,1260,1100,47.6534,-122.41,1720,6000,8360,7720,2360,80,80
2,2.75,2090,23962,2,0,3,4,8,2090,0,47.4145,-122.44,1820,32340,26052,34160,2090,31,31
5,1.75,1920,6500,1,0,0,3,7,1260,660,47.6394,-122.308,1970,5500,8420,7470,1920,68,68
3,2.25,1190,1200,3,0,0,3,8,1190,0,47.6542,-122.346,1180,1224,2390,2404,1190,11,11
3,2.5,1380,1389,3,0,0,3,8,1380,0,47.6427,-122.327,1380,1249,2769,2629,1380,11,11
4,2.25,1950,6000,1,0,0,3,7,1350,600,47.6909,-122.301,1980,6000,7950,7980,1950,58,58
5,2,1700,7314,1,0,0,3,7,1000,700,47.549,-122.305,2000,7176,9014,9176,1700,63,63
4,1.75,1900,10454,1,0,0,4,7,1180,720,47.5933,-122.195,2060,11325,12354,13385,1900,65,65
3,2.25,1750,8400,1,0,0,3,7,1350,400,47.4571,-122.272,2020,9110,10150,11130,1750,54,54
3,2.5,2260,3640,2,0,0,3,8,2260,0,47.7356,-122.157,2350,3710,5900,6060,2260,25,25
4,1,1460,16638,1,0,0,4,6,1460,0,47.3431,-122.048,1460,16638,18098,18098,1460,44,44
4,2.5,2320,11259,2,0,0,3,9,2320,0,47.6443,-122.194,2820,11770,13579,14590,2320,37,37
3,1.75,2110,56192,1,0,0,3,7,1480,630,47.7701,-122.138,2570,46609,58302,49179,2110,41,41
3,3.25,1480,983,2,0,0,3,8,1180,300,47.5555,-122.363,1330,1062,2463,2392,1480,6,6
2,2.25,1330,10838,2,0,0,3,8,1330,0,47.7689,-122.241,1390,10310,12168,11700,1330,34,34
4,1.75,1440,13296,1,0,0,4,8,1440,0,47.634,-122.204,3520,10802,14736,14322,1440,52,52
4,4.5,4240,13162,2,0,0,3,10,4240,0,47.6193,-122.229,3010,12163,17402,15173,4240,15,15
4,2.25,2040,7600,1,0,0,4,8,1580,460,47.3169,-122.365,2130,7200,9640,9330,2040,41,41
3,2.5,1670,3980,2,0,0,3,8,1670,0,47.5317,-122.047,1670,2897,5650,4567,1670,19,19
3,1.75,1410,45302,1,0,0,3,7,1410,0,47.7077,-121.914,2240,49222,46712,51462,1410,39,39
2,1,700,4700,1,0,0,5,5,700,0,47.4953,-122.169,960,5200,5400,6160,700,66,66
4,2.5,3310,5404,2,0,0,3,9,3310,0,47.6635,-122.083,2600,4730,8714,7330,3310,15,15
4,2.25,1990,21312,1,0,0,4,8,1990,0,47.439,-122.144,2400,19210,23302,21610,1990,51,51
4,2.5,2410,6440,1,0,0,3,8,1550,860,47.7153,-122.191,2330,6938,8850,9268,2410,45,45
2,1.5,1380,209959,1,0,0,1,6,1380,0,47.7461,-122.195,3130,19868,211339,22998,1380,65,65
3,2.25,2330,3600,1,0,0,3,8,2330,0,47.631,-122.061,2050,4275,5930,6325,2330,48,48
3,1.5,1190,9135,1,0,0,4,7,1190,0,47.5164,-122.189,1520,9146,10325,10666,1190,60,60
2,1,790,4000,1,0,0,3,6,790,0,47.6844,-122.289,990,5000,4790,5990,790,71,71
4,2.5,2360,43088,2,0,0,3,8,2360,0,47.7661,-122.071,2850,39216,45448,42066,2360,42,42
4,2.5,1980,4745,2,0,0,3,7,1980,0,47.3495,-122.04,1980,4878,6725,6858,1980,15,15
2,1,820,6400,1,0,0,4,7,820,0,47.55,-122.379,1490,6400,7220,7890,820,75,75
4,2.75,1810,7350,1,0,0,4,7,1200,610,47.3703,-122.171,1750,7350,9160,9100,1810,39,39
3,1.5,1320,7560,1,0,0,3,6,840,480,47.7451,-121.98,1210,7560,8880,8770,1320,36,36
1,1,740,5000,1,0,0,3,7,740,0,47.5519,-122.292,1400,4400,5740,5800,740,96,96
4,2,2090,40419,1,0,0,4,7,2090,0,47.4691,-121.993,2380,63162,42509,65542,2090,35,35
3,2.5,2320,5760,1,0,0,3,7,1480,840,47.504,-122.248,1660,5762,8080,7422,2320,32,32
4,1,1530,3900,1,0,0,4,7,1530,0,47.6748,-122.379,1300,3900,5430,5200,1530,111,111
3,2.5,1360,7293,2,0,0,3,8,1360,0,47.3304,-122.302,1540,7353,8653,8893,1360,31,31
6,3,2620,4350,1,0,0,3,7,1760,860,47.678,-122.373,1760,4300,6970,6060,2620,62,62
4,2.5,2181,5521,2,0,0,3,8,2181,0,47.3503,-122.291,2333,5143,7702,7476,2181,13,13
3,2.5,2430,15264,2,0,0,3,8,2430,0,47.3805,-122.208,2260,10416,17694,12676,2430,22,22
2,1,894,1552,2,0,0,3,7,894,0,47.6911,-122.313,1131,1992,2446,3123,894,8,8
4,2.5,2860,3638,1,0,2,5,7,1720,1140,47.6631,-122.361,1760,3880,6498,5640,2860,95,95
4,2.5,2090,6926,2,0,0,3,8,2090,0,47.6339,-122.022,2000,7151,9016,9151,2090,29,29
4,2.75,3410,35040,2,0,0,3,9,3410,0,47.4054,-122.03,2580,37263,38450,39843,3410,35,35
4,2.5,2090,10306,2,0,0,3,10,2090,0,47.6304,-122.051,2660,11481,12396,14141,2090,33,33
5,3.5,5470,35071,2,0,0,3,11,4590,880,47.6368,-122.159,3600,35074,40541,38674,5470,43,43
4,3,3290,10783,2,0,0,3,9,3290,0,47.3904,-122.178,2810,10783,14073,13593,3290,29,29
4,2.5,2340,5600,2,0,0,3,7,2340,0,47.5117,-122.379,1310,5600,7940,6910,2340,98,1
3,3.5,1280,1257,2,0,0,3,8,1040,240,47.6721,-122.374,1280,1249,2537,2529,1280,19,19
4,2,2760,27631,2,0,0,4,8,1800,960,47.7484,-122.291,2490,13158,30391,15648,2760,41,41
3,2.25,2230,11835,1,0,0,5,8,1630,600,47.563,-122.178,2190,10384,14065,12574,2230,45,45
3,2.75,2720,31314,3,0,2,3,8,2720,0,47.3689,-122.163,2290,15188,34034,17478,2720,33,33
2,3.25,1840,1500,3,0,0,3,8,1840,0,47.6595,-122.354,1910,2500,3340,4410,1840,18,18
4,3,3350,23781,1,0,0,4,9,2020,1330,47.56,-122.132,2870,12036,27131,14906,3350,40,40
4,2.5,1750,9000,1,0,0,3,8,1410,340,47.6403,-122.105,2120,9600,10750,11720,1750,42,11
3,1.75,1460,6360,1,0,2,3,7,1010,450,47.5311,-122.353,1400,4240,7820,5640,1460,40,40
3,3,1560,2250,2,0,0,3,9,1560,0,47.6929,-122.333,1610,4500,3810,6110,1560,10,10
3,2.5,1700,6200,2,0,0,3,8,1700,0,47.2621,-122.221,1720,6205,7900,7925,1700,22,22
2,1.5,950,865,3,0,0,3,8,950,0,47.6714,-122.382,1290,1189,1815,2479,950,13,13
4,2.5,2740,12899,2,0,0,4,10,2740,0,47.5811,-122.028,2830,9453,15639,12283,2740,29,29
4,2.5,1840,4593,2,0,0,3,7,1840,0,47.6866,-122.013,1740,3600,6433,5340,1840,9,9
3,2,2140,7200,1,0,0,4,8,1480,660,47.5084,-122.185,2070,7220,9340,9290,2140,53,53
3,2.25,1320,963,2,0,0,3,7,1040,280,47.5199,-122.357,1300,1285,2283,2585,1320,12,12
3,2.25,2390,7000,1,0,0,4,7,1990,400,47.4568,-122.169,1610,7000,9390,8610,2390,49,49
2,1,820,5700,1,0,0,5,5,820,0,47.4915,-122.184,1000,5700,6520,6700,820,77,77
3,1.75,2290,8234,1,0,0,4,7,1250,1040,47.7611,-122.351,1660,7200,10524,8860,2290,69,69
3,1.75,1260,8487,1,0,0,3,7,1260,0,47.7664,-122.201,1890,13051,9747,14941,1260,49,49
3,2.5,1340,8867,2,0,0,3,8,1340,0,47.724,-122.327,1630,7287,10207,8917,1340,35,35
4,5.5,5060,10320,2,0,0,3,11,5060,0,47.6245,-122.21,3010,10080,15380,13090,5060,11,11
3,1.75,1660,4800,2,0,0,3,7,1660,0,47.6296,-122.308,1660,4800,6460,6460,1660,113,0
5,2.5,2900,8711,1,0,0,3,8,1650,1250,47.7752,-122.197,2340,8869,11611,11209,2900,42,42
3,1.75,1770,2800,1,0,0,3,7,1770,0,47.6631,-122.357,1630,3254,4570,4884,1770,105,105
3,2,1200,10212,1,0,0,5,6,1200,0,47.206,-121.998,1280,10212,11412,11492,1200,70,70
3,1,990,4250,1,0,0,4,7,840,150,47.5392,-122.39,990,4500,5240,5490,990,95,95
4,2.5,2070,7476,2,0,0,3,8,2070,0,47.3352,-122.189,2430,5500,9546,7930,2070,16,16
5,2.75,2000,5885,1,0,0,3,7,1260,740,47.3155,-122.347,1960,6514,7885,8474,2000,25,25
3,1.75,1300,7770,1,0,0,3,7,1300,0,47.7347,-122.192,1520,7600,9070,9120,1300,52,52
3,2.5,2320,4721,2,0,0,3,8,2320,0,47.591,-122.017,2250,4356,7041,6606,2320,15,15
4,2.5,2230,5500,2,0,0,3,7,2230,0,47.3533,-122.023,1910,5500,7730,7410,2230,20,20
3,1.75,1330,12618,1,0,3,3,7,1330,0,47.4403,-122.271,1870,8429,13948,10299,1330,36,36
3,2.25,1340,873,3,0,0,3,8,1340,0,47.7325,-122.343,1340,1186,2213,2526,1340,10,10
5,1.75,1380,7620,1,0,0,3,7,1180,200,47.5279,-122.345,1990,7620,9000,9610,1380,64,64
3,1.5,1890,9000,1,0,0,3,7,1190,700,47.4425,-122.272,2060,9000,10890,11060,1890,60,60
3,2,1850,9550,1,0,0,3,8,1850,0,47.3225,-122.273,2250,9550,11400,11800,1850,31,31
3,1.75,1780,5850,1,0,0,5,7,980,800,47.5589,-122.392,1550,5850,7630,7400,1780,75,75
1,1,530,6350,1,0,0,5,5,530,0,47.6946,-122.357,1200,6350,6880,7550,530,78,78
2,1,910,7617,1,0,0,3,6,910,0,47.7332,-122.305,1310,6624,8527,7934,910,83,83
3,1.75,1460,9261,1,0,0,3,7,1460,0,47.5155,-122.189,1550,8800,10721,10350,1460,34,34
3,2.5,2120,7401,2,0,0,3,8,2120,0,47.5781,-122.018,2010,7972,9521,9982,2120,30,30
3,1.5,1780,5000,1,0,4,4,7,1030,750,47.5168,-122.256,1780,7500,6780,9280,1780,61,61
3,2.5,1510,10384,1,0,0,2,7,1030,480,47.758,-122.071,1490,10000,11894,11490,1510,43,43
3,1.75,1950,10633,1,0,0,3,7,1250,700,47.7019,-122.313,1290,6380,12583,7670,1950,41,41
1,1,710,6000,1,0,0,3,6,710,0,47.5756,-122.316,1440,4800,6710,6240,710,4,4
3,1,1310,7125,1,0,0,4,7,1310,0,47.3739,-122.148,1650,7290,8435,8940,1310,41,41
3,1.75,2320,6400,1,0,2,4,8,1420,900,47.6449,-122.389,2540,7680,8720,10220,2320,62,62
3,3.25,3240,8338,2,0,0,3,9,3240,0,47.6321,-122.064,3420,8405,11578,11825,3240,18,18
4,1.75,3130,18253,2,0,0,3,7,3130,0,47.7402,-122.348,1850,12220,21383,14070,3130,41,41
3,2.5,1590,3121,2,0,0,3,7,1590,0,47.5515,-122.284,1090,4900,4711,5990,1590,25,25
3,1.75,1870,9897,1,0,0,4,8,1870,0,47.5505,-122.221,1900,10005,11767,11905,1870,59,59
4,4.5,2690,7350,1,0,0,5,7,2690,0,47.7062,-122.311,1660,9000,10040,10660,2690,70,70
2,1,850,6174,1,0,0,4,7,850,0,47.7352,-122.328,1100,6174,7024,7274,850,69,69
3,2.5,1740,4948,2,0,0,3,7,1740,0,47.6966,-122.025,1290,3383,6688,4673,1740,11,11
2,1.75,1530,3503,1,0,1,4,7,830,700,47.6368,-122.371,1280,1531,5033,2811,1530,103,103
2,1,960,5508,1,0,0,3,6,770,190,47.5307,-122.277,1280,5304,6468,6584,960,68,68
4,3,2150,64694,1,0,0,3,8,1450,700,47.3268,-122.388,2430,59612,66844,62042,2150,50,50
4,2.25,2420,15482,2,0,0,4,8,2420,0,47.5907,-122.196,2870,13905,17902,16775,2420,94,17
3,1.75,1840,19501,1,0,0,4,8,1270,570,47.3364,-122.318,1910,12000,21341,13910,1840,47,47
4,4.25,5584,68257,2,0,0,3,11,5584,0,47.6113,-121.952,5030,101901,73841,106931,5584,21,21
3,1.75,1899,11325,2,0,0,3,7,1899,0,47.3987,-122.3,2000,10454,13224,12454,1899,76,9
3,1.75,2110,11250,1,0,0,4,8,2110,0,47.5402,-122.216,2560,10992,13360,13552,2110,58,58
5,2.25,3550,7992,2,0,0,3,8,3550,0,47.7285,-122.179,2110,7992,11542,10102,3550,51,51
4,3,2120,5520,1,0,0,3,8,1420,700,47.7085,-122.286,2020,8700,7640,10720,2120,34,34
4,1.75,1880,9880,1,0,0,4,8,1880,0,47.4551,-122.151,1880,9600,11760,11480,1880,52,52
4,1.75,1970,9389,1,0,0,5,7,1140,830,47.7771,-122.339,1820,8135,11359,9955,1970,59,59
6,2.5,1880,14350,1,0,0,5,7,1640,240,47.7556,-122.352,1510,9840,16230,11350,1880,64,64
4,2,2240,11040,1,0,0,5,8,1120,1120,47.693,-122.168,1790,11040,13280,12830,2240,58,58
4,1,1750,68841,1,0,0,3,7,1750,0,47.4442,-122.081,1550,32799,70591,34349,1750,77,77
3,1.5,1140,4800,1,0,0,3,7,1140,0,47.6368,-122.354,1260,4800,5940,6060,1140,104,104
4,2.5,1920,8562,2,0,2,4,7,1920,0,47.1932,-122.008,1820,8628,10482,10448,1920,25,25
4,2.5,3470,6651,2,0,0,3,9,3470,0,47.5426,-121.879,2730,6179,10121,8909,3470,14,14
3,1,1540,7740,1,0,0,4,7,1540,0,47.522,-122.375,1220,7740,9280,8960,1540,110,110
3,2.5,3520,237402,2,0,0,3,9,3520,0,47.2687,-122.056,2310,165963,240922,168273,3520,15,15
5,2.75,2040,7488,1,0,0,4,7,1200,840,47.7289,-122.172,1530,7488,9528,9018,2040,50,50
2,1,780,6380,1,0,0,3,6,780,0,47.5423,-122.351,1270,6960,7160,8230,780,72,72
3,2.5,1830,65340,1,0,0,3,8,1520,310,47.4553,-121.75,2100,84942,67170,87042,1830,28,28
3,1,1020,5500,1,0,0,3,7,1020,0,47.5502,-122.286,1160,5500,6520,6660,1020,58,58
4,2,2240,9240,1,0,0,3,7,1120,1120,47.3666,-122.288,2040,8250,11480,10290,2240,51,51
3,1.75,1600,7500,1,0,0,3,7,1600,0,47.2831,-122.199,1620,7461,9100,9081,1600,21,21
3,2.5,1760,1755,3,0,0,3,8,1760,0,47.6688,-122.279,1700,1721,3515,3421,1760,21,21
4,2.5,2490,40608,2,0,0,3,9,2490,0,47.6507,-122.004,3170,45441,43098,48611,2490,22,22
3,1.5,1770,17208,1,0,0,3,8,1160,610,47.5659,-122.117,2450,17118,18978,19568,1770,60,60
3,2.5,2200,9696,2,0,0,3,8,2200,0,47.4197,-122.205,2200,9915,11896,12115,2200,32,32
4,2.5,2770,10051,2,0,0,3,10,2770,0,47.6288,-122.043,2730,10675,12821,13405,2770,32,32
5,3,2400,10126,2,0,3,3,8,2400,0,47.5726,-122.373,2250,3946,12526,6196,2400,38,38
2,2,1180,2521,2,0,0,3,6,1180,0,47.3487,-122.021,1310,3003,3701,4313,1180,14,14
4,2.5,3160,8530,2,0,0,3,9,3160,0,47.5075,-122.148,3160,6460,11690,9620,3160,13,13
3,1,970,12300,1,0,0,3,7,970,0,47.7335,-122.227,2040,9994,13270,12034,970,37,37
3,3.5,3310,5558,2,0,0,3,9,3310,0,47.5553,-122.003,3310,5270,8868,8580,3310,14,14
4,2,2350,9329,2,0,0,3,8,2350,0,47.583,-122.17,1640,9403,11679,11043,2350,42,42
5,4,3460,5400,2,0,0,3,10,2830,630,47.5201,-122.204,1890,5400,8860,7290,3460,7,7
4,3.5,3100,5600,2,0,0,3,9,3100,0,47.5968,-121.978,3080,5600,8700,8680,3100,14,14
3,1,1030,6600,1,0,0,3,7,1030,0,47.4941,-122.34,1220,9040,7630,10260,1030,65,65
4,2.25,2130,8734,2,0,2,4,8,2130,0,47.5672,-122.161,2550,8800,10864,11350,2130,58,58
3,2,1550,34175,1,0,0,3,7,1550,0,47.4855,-121.698,2300,35174,35725,37474,1550,20,20
2,1.75,1310,3816,1,0,0,2,7,1110,200,47.679,-122.368,1510,3816,5126,5326,1310,90,90
4,2.25,2280,8550,1,0,0,3,8,1660,620,47.701,-122.231,2590,9500,10830,12090,2280,42,42
4,2.5,2740,9599,1,0,2,3,8,1820,920,47.7728,-122.385,2660,8280,12339,10940,2740,58,58
4,2.5,2320,3974,2,0,0,3,7,2320,0,47.532,-121.88,2620,4539,6294,7159,2320,20,20
5,2.5,3050,13212,1,0,0,4,8,1590,1460,47.5596,-122.142,2550,10826,16262,13376,3050,44,44
4,1.75,1830,6000,1,0,0,4,7,930,900,47.6536,-122.41,1540,6000,7830,7540,1830,80,80
2,1,1270,43560,1,0,0,4,5,1270,0,47.3651,-122.165,1870,6960,44830,8830,1270,111,111
5,3.5,3250,4800,2,0,0,3,9,2410,840,47.5618,-122.362,1330,4920,8050,6250,3250,9,9
4,1.75,1550,6000,1,0,0,5,7,1550,0,47.6567,-122.399,1550,6000,7550,7550,1550,75,75
4,1.75,2140,49658,1,0,0,5,7,2140,0,47.3583,-121.922,1720,99316,51798,101036,2140,60,60
3,1.75,1340,9975,1,0,0,4,7,1340,0,47.7012,-122.169,1340,10050,11315,11390,1340,58,58
3,1.75,1360,16000,1,0,0,3,7,1360,0,47.7583,-122.306,1360,12939,17360,14299,1360,41,41
4,2.75,3010,7427,2,0,0,3,8,3010,0,47.7068,-122.112,3000,4929,10437,7929,3010,9,9
3,1.5,1400,9750,1,0,0,4,6,1400,0,47.3768,-122.17,1160,9750,11150,10910,1400,55,55
3,2,1870,8442,1,0,0,5,7,1060,810,47.6964,-122.365,1640,6174,10312,7814,1870,92,92
4,3,3110,4408,2,0,3,4,10,2510,600,47.6583,-122.27,3250,5669,7518,8919,3110,88,88
4,2.25,2720,8712,2,0,0,4,9,2720,0,47.5616,-122.153,2470,8714,11432,11184,2720,43,43
4,2.5,3120,7448,2,0,0,3,9,3120,0,47.3645,-122.126,2980,8102,10568,11082,3120,21,21
4,2.5,3310,4839,2,0,0,3,9,3310,0,47.773,-122.161,3240,5280,8149,8520,3310,12,12
4,3,2430,7242,2,0,0,3,8,2430,0,47.3533,-122.015,2430,7242,9672,9672,2430,16,16
5,1.75,2330,3800,1,0,0,3,7,1360,970,47.6835,-122.308,2100,3800,6130,5900,2330,92,92
4,1.75,1860,9112,1,0,0,4,7,1110,750,47.3792,-122.282,1570,9112,10972,10682,1860,56,56
3,2.25,1430,2343,2,0,0,3,8,1430,0,47.5648,-122.294,1270,1916,3773,3186,1430,7,7
4,1.75,1980,10800,1,0,0,4,8,1320,660,47.5899,-122.173,2310,10800,12780,13110,1980,66,66
4,2.75,2710,45963,2,0,0,3,9,2710,0,47.4745,-121.724,2710,33955,48673,36665,2710,24,24
5,2.75,2670,4000,2,0,0,4,7,1800,870,47.6711,-122.315,2460,4000,6670,6460,2670,105,105
3,2.5,1930,1348,2,0,0,3,8,1300,630,47.6513,-122.384,1630,6000,3278,7630,1930,14,14
4,2.25,2360,7490,2,0,0,3,8,2360,0,47.6988,-122.169,2360,7490,9850,9850,2360,40,40
3,2.5,1580,12250,2,0,0,3,8,1580,0,47.3771,-122.315,1560,9900,13830,11460,1580,26,26
3,2.25,1620,6000,1,0,0,3,7,1280,340,47.2835,-122.2,1710,6318,7620,8028,1620,21,21
4,2.25,2390,12292,1,0,0,5,9,2390,0,47.5528,-122.221,2870,12337,14682,15207,2390,57,57
3,3.25,1710,1960,2,0,0,3,8,1360,350,47.5479,-122.003,1420,955,3670,2375,1710,15,15
3,1,1320,9239,1,0,0,4,7,1320,0,47.312,-122.183,1320,8415,10559,9735,1320,51,51
3,1.5,1480,2700,1,0,0,3,7,1480,0,47.623,-122.304,1970,4200,4180,6170,1480,91,91
2,1,700,4000,1,0,0,3,6,700,0,47.5487,-122.391,1060,6000,4700,7060,700,76,76
2,1.5,1480,7276,1,0,0,4,6,940,540,47.4942,-122.166,1090,6710,8756,7800,1480,41,41
2,1,720,4920,1,0,0,3,6,720,0,47.5352,-122.371,670,4920,5640,5590,720,78,78
3,2.5,2670,12806,2,0,0,3,9,2670,0,47.3686,-122.059,3010,7231,15476,10241,2670,9,9
2,1.5,1008,26487,1,1,4,4,6,1008,0,47.3853,-122.479,1132,24079,27495,25211,1008,76,13
3,2.5,2030,5100,2,0,0,3,7,2030,0,47.6594,-122.397,1790,4380,7130,6170,2030,11,11
4,2.5,1890,7200,1,0,0,4,7,1500,390,47.7278,-122.218,2070,7200,9090,9270,1890,41,41
2,2.5,1770,4950,1,0,0,3,7,1770,0,47.3497,-122.025,1770,4500,6720,6270,1770,16,16
3,2,2660,16677,1,0,0,3,9,2210,450,47.3689,-122.055,2660,11355,19337,14015,2660,29,29
3,1.5,2200,5000,1,0,0,3,9,2200,0,47.6404,-122.408,2860,5000,7200,7860,2200,87,87
4,1.75,1540,7200,1,0,0,3,7,1260,280,47.3424,-122.308,1540,8416,8740,9956,1540,53,53
4,2.5,2070,6175,2,0,0,3,8,2070,0,47.3262,-122.174,1940,6175,8245,8115,2070,26,26
4,1.75,1880,4080,1,0,0,3,7,940,940,47.6754,-122.327,1410,4080,5960,5490,1880,95,95
4,2.5,2240,7245,1,0,0,4,7,1140,1100,47.7161,-122.17,1740,7350,9485,9090,2240,47,47
4,3.25,4270,6384,2,0,0,3,9,3060,1210,47.5362,-121.874,2850,6285,10654,9135,4270,18,18
3,2.25,2900,35273,2,0,0,3,9,2900,0,47.4013,-122.03,2510,38487,38173,40997,2900,33,33
3,2,2010,12950,1,0,0,3,8,2010,0,47.7222,-122.229,1490,10181,14960,11671,2010,66,66
4,5,4550,18641,1,1,4,3,10,2600,1950,47.6053,-122.077,4550,19508,23191,24058,4550,17,17
5,4.5,6070,14731,2,0,0,3,11,6070,0,47.5306,-122.134,4750,13404,20801,18154,6070,15,15
2,1,910,9000,1,0,0,3,5,910,0,47.526,-121.81,1290,9000,9910,10290,910,96,96
2,1,840,6654,1,0,0,3,7,840,0,47.7319,-122.335,1350,5831,7494,7181,840,68,68
5,2.5,2130,7111,1,0,0,3,7,1330,800,47.5071,-122.16,1840,7592,9241,9432,2130,51,51
5,3.25,3420,5669,2,0,0,3,9,2620,800,47.5366,-122.067,3310,6006,9089,9316,3420,16,16
4,2,2050,4400,1,0,0,4,9,2050,0,47.644,-122.319,2320,5500,6450,7820,2050,97,97
6,3,2630,8800,1,0,0,3,7,1610,1020,47.7166,-122.293,1220,1173,11430,2393,2630,60,60
3,1,1430,10005,1,0,0,4,7,1430,0,47.7181,-122.338,1720,8822,11435,10542,1430,69,69
4,1,1720,4410,1,0,2,3,7,1720,0,47.6791,-122.402,2140,4500,6130,6640,1720,91,91
3,1,1040,8075,1,0,0,4,7,1040,0,47.6701,-122.176,1450,8075,9115,9525,1040,58,58
4,2.5,3340,10422,2,0,0,3,10,3340,0,47.6515,-122.197,1770,9490,13762,11260,3340,23,23
3,2.25,1410,1287,2,0,0,3,7,1290,120,47.5344,-122.068,1490,1435,2697,2925,1410,14,14
2,2,1110,1095,3,0,0,3,7,980,130,47.5494,-122.388,1110,1083,2205,2193,1110,11,11
3,1,1260,6000,1,0,3,3,7,1260,0,47.5058,-122.384,2020,6600,7260,8620,1260,68,68
4,2.75,2050,3960,1,0,0,4,7,1180,870,47.5808,-122.394,1440,5040,6010,6480,2050,33,33
5,2.75,2730,6401,2,0,0,3,8,2730,0,47.7685,-122.16,2520,6126,9131,8646,2730,4,4
3,1.75,1290,7205,1,0,0,3,7,1290,0,47.7329,-122.237,1340,7214,8495,8554,1290,48,48
3,1.5,1490,10132,1,0,0,4,6,1490,0,47.4779,-122.145,1720,9915,11622,11635,1490,50,50
3,1,1180,11862,1,0,0,4,7,1180,0,47.7153,-122.363,1540,8100,13042,9640,1180,71,71
4,2.5,1910,5000,2,0,0,3,7,1910,0,47.3608,-122.036,2020,5000,6910,7020,1910,14,14
3,1.5,1330,7125,2,0,0,3,7,1330,0,47.7308,-122.194,1570,7350,8455,8920,1330,51,51
4,3.75,4150,17424,1,0,0,3,9,3130,1020,47.639,-122.236,3930,21420,21574,25350,4150,56,15
3,1,1220,7695,1,0,0,3,7,1220,0,47.5191,-122.339,1210,7412,8915,8622,1220,65,65
3,1.5,2440,5750,1,0,0,3,8,1320,1120,47.6991,-122.296,2160,6820,8190,8980,2440,80,80
4,3,2940,7108,2,0,1,3,9,2220,720,47.5437,-122.395,2240,7950,10048,10190,2940,8,8
5,3.25,3690,12353,2,0,0,5,9,3690,0,47.7672,-122.292,2290,9082,16043,11372,3690,42,42
3,2,1630,7599,1,0,0,3,10,1630,0,47.6981,-122.376,2030,7599,9229,9629,1630,13,13
5,2.5,2400,4496,2,0,0,3,7,2400,0,47.3692,-122.126,1880,4319,6896,6199,2400,15,15
4,2.5,1930,6957,2,0,0,3,8,1930,0,47.4309,-122.191,2090,6996,8887,9086,1930,24,24
3,2.5,1720,6200,2,0,0,3,7,1720,0,47.2137,-121.989,1710,9520,7920,11230,1720,5,5
4,2.5,2720,8000,1,0,0,4,7,1360,1360,47.5237,-122.391,1790,8000,10720,9790,2720,64,64
4,2,3510,12905,1,0,2,3,8,2210,1300,47.4466,-122.36,2530,16143,16415,18673,3510,54,32
3,1.75,1490,11360,1,0,0,3,8,1490,0,47.5896,-122.12,2350,10320,12850,12670,1490,44,44
5,3.25,2610,3642,2,0,0,3,8,2080,530,47.535,-122.284,1750,3118,6252,4868,2610,14,14
2,1,1150,6835,1,0,1,3,7,1010,140,47.5567,-122.273,1150,6561,7985,7711,1150,97,97
3,1.75,2270,11472,1,0,0,4,7,1370,900,47.7057,-122.374,2270,8340,13742,10610,2270,63,63
3,1,1060,8040,1,0,0,4,6,1060,0,47.7121,-122.287,1300,7620,9100,8920,1060,70,70
3,1.75,2570,14033,1,0,2,4,8,2570,0,47.4335,-122.338,2550,16100,16603,18650,2570,66,66
3,2.5,3400,16603,2,0,0,3,10,3400,0,47.6012,-122.023,3400,12601,20003,16001,3400,19,19
4,3.25,3940,27591,2,0,3,3,9,3440,500,47.5157,-122.116,3420,29170,31531,32590,3940,19,19
5,2.25,2200,9600,1,0,0,4,7,1100,1100,47.3263,-122.364,1780,9680,11800,11460,2200,56,56
4,2,2410,4680,2,0,0,3,9,2410,0,47.6234,-122.113,1910,4611,7090,6521,2410,45,45
2,1,1320,8830,1,0,0,3,7,1020,300,47.6433,-122.404,1620,8531,10150,10151,1320,80,80
3,2,1210,9926,1,0,0,4,7,1210,0,47.5731,-122.135,1690,9737,11136,11427,1210,65,0
3,2.25,1320,1800,2,0,0,3,7,1320,0,47.6081,-122.289,2010,4500,3120,6510,1320,25,25
4,3.5,3820,13224,2,0,0,3,10,3280,540,47.6005,-122.199,3340,9700,17044,13040,3820,29,29
3,2,1330,8100,1,0,0,4,7,1330,0,47.7251,-122.175,1590,8100,9430,9690,1330,50,50
3,1.75,1720,7200,1,0,0,3,7,1140,580,47.6977,-122.132,1700,8400,8920,10100,1720,42,42
4,1.75,2030,7350,1,0,0,3,8,2030,0,47.6274,-122.094,2000,7998,9380,9998,2030,53,53
2,1,850,5225,1,0,0,3,7,850,0,47.5311,-122.38,1230,5225,6075,6455,850,70,70
4,2.5,3130,13202,2,0,0,3,10,3130,0,47.5878,-121.976,2840,10470,16332,13310,3130,23,23
3,2.25,2400,16301,1,0,0,3,8,1400,1000,47.6901,-122.282,1720,9828,18701,11548,2400,57,57
3,2.25,1570,3109,2,0,0,3,8,1570,0,47.3258,-122.186,1680,3590,4679,5270,1570,17,17
3,1.75,1620,10000,1,0,0,5,6,1620,0,47.5091,-122.262,1880,10000,11620,11880,1620,101,101
5,2.5,2820,67518,2,0,0,3,8,2820,0,47.5794,-122.025,2820,48351,70338,51171,2820,40,40
3,1.75,1530,5000,1,0,2,3,7,1020,510,47.6806,-122.36,1530,5000,6530,6530,1530,71,71
4,2.5,2400,4596,2,0,0,3,8,2400,0,47.3358,-122.265,2230,4763,6996,6993,2400,15,15
2,1.75,1220,5000,1,0,0,5,7,860,360,47.4906,-122.204,1120,5000,6220,6120,1220,98,98
4,2.5,3240,13978,1,0,0,3,9,1860,1380,47.6298,-122.057,3150,12767,17218,15917,3240,42,42
3,1,1230,4800,1,0,0,1,6,1230,0,47.6941,-122.365,1230,4800,6030,6030,1230,103,103
4,1.75,2180,10200,1,0,2,3,8,2000,180,47.7638,-122.27,2590,10445,12380,13035,2180,53,53
3,1.75,2080,12522,1,0,0,5,6,2080,0,47.267,-122.25,1690,11200,14602,12890,2080,69,69
2,1,1070,4500,1,0,0,3,7,1070,0,47.6802,-122.29,1320,4465,5570,5785,1070,82,82
4,2.5,2425,9017,2,0,0,3,9,2425,0,47.3003,-122.263,2725,7019,11442,9744,2425,6,6
4,2.5,2060,5742,2,0,0,3,7,2060,0,47.3612,-122.185,1610,7298,7802,8908,2060,20,20
4,3,3520,4895,1,0,0,3,8,1980,1540,47.6678,-122.361,1570,2153,8415,3723,3520,65,65
2,1,1070,5280,1,0,0,3,6,1070,0,47.6168,-122.303,1380,2370,6350,3750,1070,119,119
3,2,2350,8459,1,0,0,3,9,2350,0,47.3043,-122.349,2430,8459,10809,10889,2350,30,30
4,2.25,2510,4090,2,0,0,3,8,1840,670,47.7345,-121.967,2070,4090,6600,6160,2510,7,7
4,2.75,2780,6978,2,0,0,3,8,2780,0,47.6881,-122.04,2760,5460,9758,8220,2780,18,18
4,1.75,1920,9380,1,0,0,3,7,1920,0,47.6344,-122.118,1580,8580,11300,10160,1920,55,55
3,2,1450,7300,1,0,0,5,7,1450,0,47.7517,-122.342,1660,9069,8750,10729,1450,64,64
2,1,980,3400,1,0,0,3,7,980,0,47.6688,-122.323,1200,3420,4380,4620,980,96,96
3,2.25,1430,1448,3,0,0,3,8,1430,0,47.6916,-122.341,1430,1383,2878,2813,1430,14,14
2,1,700,5200,1,0,0,5,6,700,0,47.4924,-122.175,1030,5200,5900,6230,700,67,67
4,3.5,2440,3012,3,0,1,3,8,2440,0,47.6923,-122.392,1860,4650,5452,6510,2440,14,14
5,2,2500,7860,1,0,0,3,7,1040,1460,47.7212,-122.226,2060,9684,10360,11744,2500,56,56
3,2,1470,16500,1,0,0,3,7,1470,0,47.3617,-122.061,1720,14406,17970,16126,1470,58,58
4,2.5,2660,5500,2,0,2,3,9,2660,0,47.5439,-121.996,3620,5500,8160,9120,2660,16,16
3,1,1430,19901,1,0,0,4,7,1430,0,47.7558,-122.229,1780,12697,21331,14477,1430,92,92
4,2.5,3140,22100,1,0,0,4,8,1820,1320,47.319,-122.362,2700,25500,25240,28200,3140,59,59
5,4,5840,11652,2,0,1,3,11,4410,1430,47.5835,-122.202,3120,13639,17492,16759,5840,31,31
2,1.75,1480,4000,1,0,0,4,6,740,740,47.6916,-122.38,1060,4000,5480,5060,1480,94,94
3,2.5,1600,2788,2,0,0,4,7,1600,0,47.4034,-122.187,1720,3605,4388,5325,1600,27,27
3,1,1100,5100,2,0,0,4,7,1100,0,47.679,-122.386,1540,5100,6200,6640,1100,119,119
3,2.5,1640,6991,1,0,0,3,7,1110,530,47.7255,-122.327,1860,7342,8631,9202,1640,52,52
2,1,1400,19570,1,0,0,3,6,1100,300,47.4724,-122.271,2250,6500,20970,8750,1400,90,90
3,1,1060,8625,2,0,0,4,7,1060,0,47.6615,-122.179,2010,8901,9685,10911,1060,57,17
3,4,2550,3900,2,0,2,3,8,2050,500,47.6415,-122.392,2340,6400,6450,8740,2550,79,11
2,1,850,8400,1,0,0,4,6,850,0,47.4696,-122.359,1280,8400,9250,9680,850,78,78
5,1.75,3690,36036,1,0,0,3,9,1890,1800,47.3473,-122.085,2680,44131,39726,46811,3690,34,34
4,2.5,3010,6100,2,0,0,3,9,3010,0,47.6647,-122.08,2890,5176,9110,8066,3010,14,14
2,1,1220,10170,1,0,0,3,7,980,240,47.7297,-122.327,1990,9064,11390,11054,1220,71,71
3,1.75,1370,10866,1,0,0,4,6,1370,0,47.6774,-122.164,1580,14250,12236,15830,1370,74,74
3,1.75,1410,7215,1,0,0,3,7,1410,0,47.7343,-122.193,1550,7600,8625,9150,1410,52,52
2,1.5,1110,1189,3,0,0,3,8,1110,0,47.6711,-122.377,1420,1311,2299,2731,1110,19,19
4,2.5,2050,3784,2,0,0,3,8,2050,0,47.7189,-122.181,2050,3366,5834,5416,2050,18,18
3,2.75,2500,5568,2,0,0,5,9,2500,0,47.6258,-122.312,2810,5568,8068,8378,2500,114,114
3,1.5,1750,7000,2,0,0,3,8,1750,0,47.3108,-122.346,1840,9305,8750,11145,1750,36,36
3,2,1940,3800,1,0,0,4,7,1050,890,47.6842,-122.309,1700,3800,5740,5500,1940,92,92
3,2.25,1670,4800,1,0,3,3,8,1670,0,47.6356,-122.367,2300,4800,6470,7100,1670,116,116
4,1.75,3990,13470,2,0,0,3,11,3990,0,47.5305,-122.131,5790,13709,17460,19499,3990,13,13
3,3,2470,11900,2,0,0,3,9,2290,180,47.641,-122.057,2590,11900,14370,14490,2470,43,43
3,2.25,1760,10350,1,0,0,4,7,1330,430,47.6605,-122.188,2210,11337,12110,13547,1760,40,40
3,1.75,1270,4800,1,0,0,3,7,1270,0,47.693,-122.361,1490,4800,6070,6290,1270,66,66
2,1,740,11250,1,0,0,2,6,740,0,47.5036,-122.362,1390,11250,11990,12640,740,81,81
4,2.5,2665,5868,2,0,0,3,9,2665,0,47.3831,-122.185,2665,6092,8533,8757,2665,13,13
4,2.75,3010,15750,1,0,0,4,8,1560,1450,47.7336,-122.183,2110,9450,18760,11560,3010,46,46
4,2.25,2520,8000,1,0,2,3,8,1680,840,47.3202,-122.383,2300,8000,10520,10300,2520,49,49
3,2.5,2300,18540,1,0,0,3,8,1800,500,47.7767,-122.369,2460,18540,20840,21000,2300,58,58
4,3,3150,6175,2,0,0,3,9,3150,0,47.5968,-122.017,3150,6986,9325,10136,3150,18,18
4,2.5,1620,219542,2,0,0,3,7,1620,0,47.4014,-122.069,2240,217800,221162,220040,1620,39,39
4,2,2170,5404,1,0,0,5,6,1470,700,47.3046,-122.22,1030,5477,7574,6507,2170,99,99
4,2.5,3370,7200,2,0,0,3,8,3370,0,47.7698,-122.384,1880,7200,10570,9080,3370,5,5
4,2.75,2340,6350,1,0,0,4,7,1310,1030,47.5559,-122.379,2020,6350,8690,8370,2340,45,45
2,1,810,7980,1,0,0,1,6,810,0,47.489,-122.337,1440,7980,8790,9420,810,91,91
3,1.75,1880,8706,1,0,0,3,7,940,940,47.7362,-122.292,1880,7200,10586,9080,1880,92,92
4,2,1640,6000,1,0,0,4,9,1640,0,47.6505,-122.375,1900,6000,7640,7900,1640,108,108
3,1,1090,4000,1,0,0,4,7,1090,0,47.6846,-122.386,1520,4000,5090,5520,1090,74,74
4,2,3210,8400,1,0,0,5,7,2040,1170,47.5322,-122.391,2540,6458,11610,8998,3210,105,105
4,1.75,2440,7350,1,0,0,3,8,1610,830,47.3743,-122.285,2180,7680,9790,9860,2440,41,41
3,2.25,2070,15002,1,0,0,3,8,2070,0,47.7635,-122.274,2070,15002,17072,17072,2070,64,1
5,2.75,2440,8000,1,0,0,4,7,1240,1200,47.7283,-122.17,1780,8391,10440,10171,2440,47,47
4,1.5,1880,3500,1,0,0,4,7,1080,800,47.6835,-122.347,1690,3500,5380,5190,1880,93,93
2,1,1110,26051,1,0,0,3,6,1110,0,47.4711,-122.291,2240,12255,27161,14495,1110,68,68
3,2.5,1830,4997,2,0,0,3,7,1830,0,47.3035,-122.283,2488,4998,6827,7486,1830,15,15
4,2.5,2390,7115,2,0,0,3,9,2390,0,47.2593,-122.222,2600,7916,9505,10516,2390,20,20
3,1,1690,6658,1,0,0,3,7,1690,0,47.7099,-122.35,1080,5925,8348,7005,1690,77,32
3,1,1220,8573,1,0,0,4,7,1220,0,47.6088,-122.193,1390,8573,9793,9963,1220,65,65
3,1.75,1210,8864,1,0,0,3,7,1210,0,47.3639,-122.08,1510,8062,10074,9572,1210,34,34
4,2.5,1940,4517,1,0,0,3,8,1190,750,47.776,-122.26,1910,10410,6457,12320,1940,9,9
5,3,3670,9600,1,0,1,3,8,1980,1690,47.5648,-122.316,1730,4933,13270,6663,3670,64,64
4,2.75,2500,5995,2,0,0,3,8,2500,0,47.3749,-122.107,2530,5988,8495,8518,2500,11,11
3,1,1520,213444,1,0,3,5,8,1520,0,47.5081,-122.093,2640,213444,214964,216084,1520,31,31
3,2.5,2980,7338,2,0,0,3,8,2980,0,47.437,-122.207,3010,5267,10318,8277,2980,13,13
5,2.5,2820,9956,1,0,0,4,7,1410,1410,47.4715,-122.33,2700,9956,12776,12656,2820,52,52
4,3.75,3070,5850,2,0,0,5,9,2400,670,47.633,-122.283,2940,5573,8920,8513,3070,92,92
10,2,3610,11914,2,0,0,4,7,3010,600,47.5705,-122.175,2040,11914,15524,13954,3610,61,61
3,1.75,1580,6127,1,0,0,5,7,1580,0,47.7192,-122.32,1500,6128,7707,7628,1580,72,72
3,1,940,5904,1,0,0,3,6,940,0,47.699,-122.35,870,5728,6844,6598,940,72,72
4,2.5,2620,9873,2,0,0,3,8,2620,0,47.5822,-122.051,2520,9935,12493,12455,2620,32,32
3,2.75,1830,208216,2,0,0,3,8,1830,0,47.4377,-122.464,1530,16988,210046,18518,1830,22,22
3,1,1480,6550,1,0,0,4,6,1480,0,47.5498,-122.381,1200,6550,8030,7750,1480,94,94
3,2.5,1220,1330,2,0,0,3,8,1010,210,47.6904,-122.37,1360,3750,2550,5110,1220,11,11
3,1,1110,8423,1,0,0,3,7,1110,0,47.4718,-122.342,1140,9083,9533,10223,1110,67,67
4,3.5,3065,5440,3,0,0,3,9,3065,0,47.524,-122.2,2210,8400,8505,10610,3065,5,5
5,2.5,2900,5901,2,0,0,3,9,2900,0,47.5396,-121.998,3200,5775,8801,8975,2900,13,13
5,2.5,2570,7412,2,0,0,3,8,2570,0,47.7265,-121.957,2890,8056,9982,10946,2570,13,13
3,1,1600,5001,1,0,0,5,6,1080,520,47.7232,-122.289,1340,5001,6601,6341,1600,89,89
4,2.5,2190,9880,1,0,0,4,8,1410,780,47.6926,-122.186,2190,9198,12070,11388,2190,40,40
4,2.5,2480,91911,1,0,2,4,7,1470,1010,47.4579,-121.981,2540,91911,94391,94451,2480,46,46
3,1.75,1650,11220,1,0,0,4,7,1650,0,47.7567,-122.071,1340,10129,12870,11469,1650,50,50
3,3.25,1876,1531,3,0,0,3,9,1876,0,47.6864,-122.265,1876,1533,3407,3409,1876,10,10
3,1.75,1610,22496,1,0,0,4,7,1610,0,47.3443,-122.073,2050,35772,24106,37822,1610,45,45
4,2.5,2500,5831,2,0,0,3,8,2500,0,47.3454,-122.039,2500,5188,8331,7688,2500,12,12
3,2.25,1610,3764,2,0,0,3,7,1610,0,47.3589,-122.083,1610,3825,5374,5435,1610,7,7
3,1.75,1910,4800,1,0,0,3,7,1080,830,47.6844,-122.332,1750,4800,6710,6550,1910,60,60
3,1,1110,8593,1,0,0,3,7,1110,0,47.7595,-122.309,1780,8593,9703,10373,1110,40,40
1,1,780,10235,1,0,0,3,6,780,0,47.713,-121.315,930,10165,11015,11095,780,30,30
4,2.5,1950,5451,2,0,0,3,7,1950,0,47.4341,-122.144,2240,6221,7401,8461,1950,15,15
4,2.25,1810,4970,2,0,0,3,7,1810,0,47.5003,-122.156,1810,4858,6780,6668,1810,16,16
3,2.5,2160,1912,2,0,0,3,9,1970,190,47.5642,-122.292,1810,2653,4072,4463,2160,5,5
4,2.5,2280,7568,2,0,0,4,7,2280,0,47.5115,-122.194,2280,5312,9848,7592,2280,18,18
4,1.75,2520,21834,1,1,4,3,8,1420,1100,47.4996,-122.378,1700,8100,24354,9800,2520,59,59
3,1.75,1270,7350,1,0,0,4,7,1270,0,47.6046,-122.168,1880,7350,8620,9230,1270,52,52
3,1.5,1300,7370,1,0,0,4,7,900,400,47.3025,-122.37,1430,7500,8670,8930,1300,43,43
4,2,1570,11200,1,0,0,3,7,1120,450,47.7573,-122.217,1570,11200,12770,12770,1570,60,60
2,1.5,1480,43645,1,0,0,3,8,1480,0,47.5484,-122.045,1600,34326,45125,35926,1480,45,8
3,2.25,2570,8491,2,0,0,4,8,2570,0,47.3759,-122.125,2400,8049,11061,10449,2570,30,30
3,1.5,1440,9711,1,0,0,3,7,1140,300,47.7394,-122.252,1590,9711,11151,11301,1440,63,63
3,2.25,1850,2575,2,0,0,3,9,1850,0,47.5525,-122.273,1080,4120,4425,5200,1850,6,6
4,3.5,2650,3060,2,0,0,3,9,2060,590,47.6735,-122.332,1470,3060,5710,4530,2650,18,18
3,2.5,3370,167706,1,0,0,3,10,3370,0,47.4379,-122.022,3350,213444,171076,216794,3370,19,19
2,2.5,1560,1222,2,0,0,3,8,1080,480,47.604,-122.307,1560,2081,2782,3641,1560,11,11
2,1,980,5100,1,0,0,4,6,980,0,47.6824,-122.38,1190,5100,6080,6290,980,112,112
4,3.25,3200,4477,2,0,0,3,9,2390,810,47.664,-122.402,1830,4920,7677,6750,3200,13,13
3,2.5,2190,34528,2,0,0,3,8,2190,0,47.4594,-121.986,2460,37901,36718,40361,2190,25,25
4,2.5,2480,4334,2,0,0,3,8,2480,0,47.3826,-122.036,2480,5632,6814,8112,2480,7,7
2,1,900,1818,2,0,0,4,7,900,0,47.6485,-122.397,1570,1830,2718,3400,900,74,74
6,1.75,2750,9563,2,0,0,4,8,2750,0,47.6368,-122.097,2040,9563,12313,11603,2750,46,46
2,1,1600,7936,1,0,0,3,7,1600,0,47.7411,-122.322,1580,7440,9536,9020,1600,72,72
5,2.25,3700,7207,1,0,1,5,8,1850,1850,47.7736,-122.371,2340,7900,10907,10240,3700,49,49
4,1.5,1370,7904,1,0,0,3,7,900,470,47.3344,-122.28,1370,7900,9274,9270,1370,49,49
4,2,1440,5911,1,0,0,5,5,1440,0,47.5072,-122.181,1500,11089,7351,12589,1440,76,76
3,2.5,1330,2183,3,0,0,3,8,1330,0,47.6987,-122.365,1310,5000,3513,6310,1330,5,5
3,2.5,3000,8250,1,0,0,4,8,1760,1240,47.6191,-122.112,2040,8250,11250,10290,3000,56,56
3,1.75,1590,1113,3,0,0,3,8,1590,0,47.6691,-122.402,1520,1357,2703,2877,1590,5,5
2,1,890,5200,1,0,0,4,6,890,0,47.5311,-122.373,950,5200,6090,6150,890,78,78
6,4.5,3600,6110,2,0,0,3,9,2510,1090,47.5687,-122.291,1360,5800,9710,7160,3600,7,7
4,2.75,2620,4743,1,0,2,4,8,1310,1310,47.6829,-122.4,1900,4764,7363,6664,2620,70,70
3,1.75,2160,6272,1,0,0,4,8,1390,770,47.6777,-122.306,1290,5376,8432,6666,2160,59,59
4,1.75,1930,7245,1,0,0,4,8,1510,420,47.6396,-122.112,1880,7245,9175,9125,1930,47,47
6,2,2320,210830,2,0,0,4,8,2320,0,47.398,-122.081,2540,217800,213150,220340,2320,57,57
6,3,2320,4502,1,0,0,4,7,1200,1120,47.5552,-122.3,1160,5628,6822,6788,2320,32,32
3,2,1690,9583,1,0,0,4,7,1690,0,47.4825,-122.164,1690,9583,11273,11273,1690,50,50
4,3.75,5090,14823,1,0,0,3,11,4180,910,47.62,-122.207,3030,12752,19913,15782,5090,6,6
4,2.25,2420,59800,1,0,0,4,8,1350,1070,47.6206,-122.056,2160,17598,62220,19758,2420,34,34
2,1,1740,8100,1,0,0,3,6,1050,690,47.4942,-122.304,960,8100,9840,9060,1740,72,72
4,3.25,2557,9480,2,0,2,3,7,2557,0,47.5449,-122.262,2220,8340,12037,10560,2557,71,21
3,2.5,2200,4240,2,0,0,3,7,2200,0,47.3715,-122.127,2200,4311,6440,6511,2200,16,16
4,2.75,2910,9000,1,0,0,4,8,2130,780,47.544,-122.176,1970,9000,11910,10970,2910,53,53
3,1.75,1500,10269,1,0,0,3,7,1030,470,47.7672,-122.348,2090,10269,11769,12359,1500,61,61
2,1,1230,3800,1,0,0,3,7,1230,0,47.6797,-122.292,1610,3800,5030,5410,1230,91,91
3,2,720,7598,1,0,0,5,6,720,0,47.5483,-122.36,1080,7209,8318,8289,720,72,72
4,2.5,2660,9030,1,0,0,4,7,1450,1210,47.4558,-122.212,1870,9030,11690,10900,2660,42,42
3,1.5,990,4500,1,0,0,5,7,990,0,47.6051,-122.298,1490,4000,5490,5490,990,71,71
3,1,1120,8407,1,0,0,5,6,1120,0,47.2051,-122.006,1250,8658,9527,9908,1120,32,32
3,2.5,1370,1350,2,0,0,3,7,1010,360,47.5534,-122.382,1450,6000,2720,7450,1370,12,12
3,2.5,2497,4400,2,0,0,3,8,2497,0,47.2873,-122.283,2434,4400,6897,6834,2497,12,12
4,4,4550,54013,1,0,1,4,9,2300,2250,47.5964,-122.077,3540,39634,58563,43174,4550,30,30
3,2.5,1740,2350,2,0,0,3,8,1120,620,47.6206,-122.297,1750,3802,4090,5552,1740,23,23
4,2.75,1970,37026,1,0,0,4,8,1970,0,47.4375,-122.446,1970,51836,38996,53806,1970,58,58
5,3,2750,3800,1,0,0,5,7,1750,1000,47.6845,-122.313,1900,3800,6550,5700,2750,93,93
3,1.75,1760,7482,1,0,0,4,8,1760,0,47.3129,-122.369,2000,7500,9242,9500,1760,53,53
3,2.25,1350,944,2,0,0,3,8,1050,300,47.5997,-122.312,1350,1245,2294,2595,1350,12,12
3,1,1280,9898,1,0,0,3,7,1280,0,47.7677,-122.163,1290,9625,11178,10915,1280,51,51
3,1.75,1660,7210,1,0,0,4,7,1660,0,47.3609,-122.274,2150,7350,8870,9500,1660,42,42
3,2.5,2760,11287,2,0,3,3,10,2000,760,47.739,-122.264,2760,13719,14047,16479,2760,28,28
3,2,1260,1125,2,0,0,3,7,810,450,47.5262,-122.361,1260,1172,2385,2432,1260,8,8
4,1.75,2320,7500,1,0,0,3,7,1220,1100,47.7574,-122.343,2230,7500,9820,9730,2320,64,64
3,3.5,2740,3785,2,0,0,3,9,2190,550,47.7195,-122.182,2060,3457,6525,5517,2740,18,18
4,1.5,1240,8158,1,0,0,4,7,1110,130,47.3716,-122.31,1520,8147,9398,9667,1240,58,58
3,1.5,1350,7620,1,0,0,5,6,1350,0,47.4565,-122.35,1350,7620,8970,8970,1350,78,78
3,2,1290,5700,1,0,0,5,7,1290,0,47.5713,-122.397,1160,5700,6990,6860,1290,69,69
4,3.5,4500,44384,1,0,0,3,12,3340,1160,47.6323,-122.192,2540,26287,48884,28827,4500,29,29
3,1.5,1480,9606,1,0,0,4,7,1100,380,47.2978,-122.363,1600,9619,11086,11219,1480,55,55
4,2.5,3910,22710,1,0,0,3,8,3910,0,47.6295,-122.217,2920,16544,26620,19464,3910,111,11
4,2.5,4010,37076,2,0,0,4,12,4010,0,47.7139,-122.106,4280,35326,41086,39606,4010,29,29
3,2.25,1800,43647,1,0,0,4,8,1800,0,47.7757,-122.132,2480,25608,45447,28088,1800,43,43
2,1,590,10945,1,0,0,3,5,590,0,47.3364,-122.033,2020,15180,11535,17200,590,36,36
4,2.5,2190,8100,1,0,0,4,8,1250,940,47.3131,-122.392,2100,8840,10290,10940,2190,41,41
3,1.5,1370,4790,2,0,0,4,7,1370,0,47.7253,-122.164,1370,3799,6160,5169,1370,37,37
2,1,840,4500,1,0,0,3,6,840,0,47.5441,-122.39,1300,5000,5340,6300,840,80,80
3,2.5,1980,7309,2,0,0,3,7,1980,0,47.7257,-122.172,2060,9681,9289,11741,1980,26,26
4,1.75,2220,15600,1,0,0,5,7,1140,1080,47.492,-122.166,1670,4800,17820,6470,2220,56,56
3,1.75,2030,32565,1,0,0,3,8,1600,430,47.7112,-122.098,2910,34190,34595,37100,2030,38,38
3,2.5,2010,3300,2,0,0,3,9,1610,400,47.5573,-122.287,1660,4950,5310,6610,2010,5,5
4,2.5,2030,39049,1,0,0,4,7,1530,500,47.4413,-122.345,2400,14605,41079,17005,2030,66,66
2,1,1300,11080,1,0,0,4,7,1300,0,47.7281,-122.233,1600,9259,12380,10859,1300,64,64
4,2.5,2050,6705,1,0,0,4,7,1230,820,47.7242,-122.217,1610,7292,8755,8902,2050,46,46
3,2.5,2450,4332,2,0,0,3,8,2450,0,47.6942,-122.016,2450,4154,6782,6604,2450,9,9
2,1.75,1540,4025,1,0,0,4,7,1190,350,47.5876,-122.391,1950,4420,5565,6370,1540,111,111
4,2.5,2370,10858,2,0,0,3,9,2370,0,47.6336,-122.192,2510,21673,13228,24183,2370,16,16
2,1,870,7020,1,0,0,4,6,570,300,47.5404,-122.352,1730,7020,7890,8750,870,77,77
4,2.5,2170,14024,2,0,0,3,8,2170,0,47.7346,-121.97,2240,14029,16194,16269,2170,27,27
4,3.75,4610,40202,1,0,0,4,10,2500,2110,47.4599,-122,3050,41056,44812,44106,4610,39,39
3,1.75,1560,21000,1,0,0,3,7,1560,0,47.4776,-122.337,1070,7920,22560,8990,1560,65,65
3,2.5,1790,4038,2,0,0,3,8,1790,0,47.5499,-121.998,1700,3365,5828,5065,1790,14,14
4,1,1150,8184,1,0,0,3,6,1150,0,47.7431,-122.319,990,8184,9334,9174,1150,72,72
4,2.5,2434,4400,2,0,0,3,8,2434,0,47.2874,-122.283,2434,4400,6834,6834,2434,12,12
2,2.5,1230,987,2,0,0,3,7,1060,170,47.6007,-122.305,1290,1328,2217,2618,1230,8,8
4,3.25,3730,7071,3,0,2,3,11,3730,0,47.6292,-122.355,3730,7680,10801,11410,3730,34,34
4,1.75,2100,6613,2,0,0,3,8,2100,0,47.567,-122.385,1630,5750,8713,7380,2100,110,10
4,2.5,2640,4725,2,0,0,3,8,2640,0,47.371,-122.017,2370,4725,7365,7095,2640,5,5
3,1.75,1800,5102,1,0,0,3,7,1170,630,47.6514,-122.407,1720,5102,6902,6822,1800,67,67
2,1.75,1350,4614,1,0,0,3,8,1350,0,47.7091,-122.015,1680,4775,5964,6455,1350,11,11
4,2.5,2720,8666,2,0,0,3,9,2720,0,47.3846,-122.169,2410,8100,11386,10510,2720,27,27
3,2.25,1900,18000,1,0,0,4,7,1280,620,47.3251,-122.354,1920,15000,19900,16920,1900,51,51
4,1.75,2060,4080,1,0,0,3,7,1460,600,47.6698,-122.325,1620,4080,6140,5700,2060,97,18
4,1.75,1730,11700,1,0,0,3,7,880,850,47.6031,-122.13,1570,7820,13430,9390,1730,63,63
4,3.25,3660,5800,2,0,0,3,10,3360,300,47.6283,-122.312,3240,5800,9460,9040,3660,110,19
3,2.25,1300,1180,3,0,0,3,8,1300,0,47.6871,-122.339,1300,1174,2480,2474,1300,11,11
4,2.25,2090,35040,1,0,0,3,8,1490,600,47.5739,-122.032,2910,21132,37130,24042,2090,39,39
4,2.5,3380,27589,2,0,0,3,10,3380,0,47.6292,-122.225,3390,20075,30969,23465,3380,53,53
4,2,2000,6250,1,0,0,3,7,1480,520,47.5532,-122.389,1110,6250,8250,7360,2000,89,89
3,1.75,1340,6300,1,0,0,3,7,1340,0,47.7186,-122.218,1780,7200,7640,8980,1340,47,47
3,2.25,2080,26574,1,0,2,3,7,1380,700,47.2846,-122.192,1770,8140,28654,9910,2080,26,26
2,1,1000,6000,1,0,0,3,6,1000,0,47.5208,-122.372,1250,6000,7000,7250,1000,68,68
4,1,1620,6000,1,0,0,5,7,1620,0,47.4763,-122.206,1310,6000,7620,7310,1620,114,114
4,2.75,3140,9085,1,0,2,5,8,1570,1570,47.5675,-122.16,2430,9350,12225,11780,3140,58,58
3,1,1430,3840,1,0,0,3,7,950,480,47.6847,-122.381,1430,3840,5270,5270,1430,74,74
3,1.5,1650,9936,1,0,0,3,7,1090,560,47.3285,-122.328,1560,9890,11586,11450,1650,52,52
2,1.5,1220,3568,1,0,0,4,8,1220,0,47.3804,-122.318,1180,3678,4788,4858,1220,43,43
4,2.5,2430,9103,2,0,0,3,8,2430,0,47.2939,-122.368,2260,8090,11533,10350,2430,29,29
3,2.5,2340,3466,2,0,0,3,7,2340,0,47.5322,-121.851,1970,3739,5806,5709,2340,15,15
4,2,1740,6369,1,0,0,5,6,870,870,47.7461,-122.332,1560,7200,8109,8760,1740,65,65
3,1.5,1390,12500,1,0,0,4,6,1390,0,47.6496,-121.908,1390,9000,13890,10390,1390,43,43
3,1,2020,8100,1,0,0,3,7,1170,850,47.7136,-122.288,1480,7620,10120,9100,2020,63,63
2,2.25,1260,1032,2,0,0,3,7,1170,90,47.5323,-122.072,1240,809,2292,2049,1260,11,11
5,1.75,2000,10246,1,0,2,3,7,1200,800,47.5084,-122.246,2340,9030,12246,11370,2000,66,66
3,2.5,1340,10290,1,0,0,4,7,1140,200,47.3553,-122.149,1760,7903,11630,9663,1340,38,38
3,1,820,5200,1,0,0,4,6,820,0,47.363,-122.094,1120,5200,6020,6320,820,42,42
3,2.5,1690,4584,2,0,0,3,7,1690,0,47.6866,-122.043,1600,3164,6274,4764,1690,17,17
3,1.75,1530,7650,1,0,0,4,8,1530,0,47.4435,-122.128,1850,6804,9180,8654,1530,42,42
3,2.25,1590,9960,1,0,0,3,7,1060,530,47.7742,-122.287,1860,9760,11550,11620,1590,43,43
3,1,1200,5525,1,0,0,2,7,1200,0,47.6981,-122.325,1580,7200,6725,8780,1200,72,72
2,2.25,1800,2748,2,0,0,4,9,1800,0,47.6104,-122.113,1800,2755,4548,4555,1800,40,40
4,2.5,2210,49375,1,0,0,3,8,2210,0,47.3828,-122.071,2670,49385,51585,52055,2210,22,22
5,2.5,2080,8347,1,0,0,4,7,1460,620,47.7334,-122.168,1840,7713,10427,9553,2080,44,44
3,2.5,2760,9471,1,0,2,3,8,1760,1000,47.676,-122.272,3040,6765,12231,9805,2760,63,63
1,0.75,470,15000,1,0,0,3,4,470,0,47.6554,-121.908,1730,22500,15470,24230,470,72,72
3,2.5,1870,7942,2,0,0,3,7,1870,0,47.342,-122.279,1870,7392,9812,9262,1870,29,29
9,7.5,4050,6504,2,0,0,3,7,4050,0,47.5923,-122.301,1448,3866,10554,5314,4050,23,23
3,1.5,1120,6653,1,0,0,4,7,1120,0,47.7321,-122.334,1580,7355,7773,8935,1120,82,82
3,1.75,1690,9826,1,0,0,4,7,1690,0,47.314,-122.365,1980,9826,11516,11806,1690,31,31
5,2,1910,5508,1,0,0,3,7,1020,890,47.7074,-122.349,1030,7440,7418,8470,1910,51,51
4,4,1550,6596,1,0,0,5,7,1550,0,47.6711,-122.398,1830,4850,8146,6680,1550,112,112
3,2.25,1850,4050,2,0,0,4,7,1850,0,47.5669,-122.017,1650,4468,5900,6118,1850,34,34
5,2.75,2860,5280,2,0,0,3,9,2860,0,47.707,-122.102,3150,6442,8140,9592,2860,13,13
3,1.75,1080,1306,1,0,0,3,7,580,500,47.6601,-122.4,1440,2225,2386,3665,1080,65,11
3,1,1550,8778,1,0,0,3,7,1250,300,47.5413,-122.281,2120,7268,10328,9388,1550,67,67
3,2,2632,18743,2,0,3,3,10,2632,0,47.3743,-122.421,1970,14171,21375,16141,2632,19,19
2,1,1050,4800,1,0,0,4,7,1050,0,47.5128,-122.388,1230,4800,5850,6030,1050,50,50
4,2.5,2820,4174,2,0,0,3,9,2820,0,47.7112,-122.226,2560,4853,6994,7413,2820,15,15
3,1,1320,5000,1,0,0,4,7,1090,230,47.6674,-122.365,1700,5000,6320,6700,1320,99,99
3,2.25,1940,217800,2,0,0,3,9,1940,0,47.5636,-121.932,2580,83558,219740,86138,1940,29,29
3,1,1000,4959,1,0,0,3,8,1000,0,47.6629,-122.277,2240,4959,5959,7199,1000,74,74
3,2.75,1560,7392,1,0,0,5,7,1030,530,47.7382,-122.182,1870,7520,8952,9390,1560,47,47
4,1,1070,7467,1,0,0,3,7,1070,0,47.4942,-122.235,1160,7467,8537,8627,1070,75,75
3,2.5,2320,57063,1,0,0,4,9,1790,530,47.6163,-122.056,3290,7314,59383,10604,2320,40,40
6,2,2570,4240,1,0,0,4,7,1970,600,47.6754,-122.307,2030,4240,6810,6270,2570,108,108
3,1.5,1600,10548,1,0,0,4,7,1600,0,47.2925,-122.284,2880,13609,12148,16489,1600,57,57
3,2.5,1850,4957,2,0,0,3,8,1850,0,47.3311,-122.17,2400,6367,6807,8767,1850,20,20
3,1.75,1800,18000,1,0,0,3,8,1200,600,47.4406,-122.146,1800,18000,19800,19800,1800,51,51
2,1.75,1430,7921,1,0,0,3,7,1430,0,47.5088,-122.371,1290,8040,9351,9330,1430,36,36
3,2,1090,6090,1,0,0,3,7,940,150,47.5118,-122.259,1840,6090,7180,7930,1090,79,79
3,2.5,1610,3516,2,0,0,3,8,1610,0,47.4491,-122.188,1610,3056,5126,4666,1610,13,13
3,2.25,1920,8223,2,0,0,4,7,1920,0,47.735,-122.201,1940,7274,10143,9214,1920,30,30
4,2.5,3130,5999,2,0,0,3,7,3130,0,47.3837,-122.099,3020,5997,9129,9017,3130,13,13
2,1,1280,7861,1,0,0,4,6,1280,0,47.3007,-122.228,1020,6480,9141,7500,1280,106,106
3,2.5,1930,5790,2,0,0,4,7,1930,0,47.7733,-122.17,1790,4901,7720,6691,1930,31,31
3,2,1380,9000,2,0,0,2,7,1380,0,47.2613,-122.248,1460,9732,10380,11192,1380,73,32
2,2.5,2350,2390,3,0,2,3,10,2000,350,47.5999,-122.286,1950,2390,4740,4340,2350,12,12
2,0.75,780,55764,1,0,0,4,4,780,0,47.442,-122.105,1620,30847,56544,32467,780,74,74
3,1.75,2450,2691,2,0,0,3,8,1750,700,47.6386,-122.36,1760,3573,5141,5333,2450,104,104
4,3.25,4060,20822,2,0,0,3,10,4060,0,47.7213,-122.055,4170,23958,24882,28128,4060,28,28
4,1.75,2120,5400,1,0,0,4,8,1060,1060,47.6501,-122.395,2052,6000,7520,8052,2120,78,78
3,1,1010,9360,1,0,0,3,6,1010,0,47.6874,-122.168,1470,9360,10370,10830,1010,38,38
2,1,1760,27332,1,1,4,4,7,1300,460,47.3799,-122.325,2590,16630,29092,19220,1760,68,68
3,2.5,1420,2581,3,0,0,3,7,1420,0,47.7027,-122.357,1420,2509,4001,3929,1420,15,15
4,2.75,2390,9968,1,0,0,4,9,1390,1000,47.3706,-122.056,2560,12385,12358,14945,2390,30,30
2,2.5,1330,1249,3,0,0,3,8,1330,0,47.6668,-122.285,1430,1328,2579,2758,1330,15,15
3,1,1200,10800,1,0,0,4,7,1200,0,47.5771,-122.144,1370,9950,12000,11320,1200,64,64
3,2.25,1630,2490,2,0,0,3,7,1630,0,47.6807,-122.031,1630,2680,4120,4310,1630,15,15
4,3.25,3840,6214,1,0,3,4,10,2590,1250,47.6388,-122.406,3280,5915,10054,9195,3840,80,80
3,1.75,1700,17355,1,0,0,3,7,1200,500,47.3637,-122.057,1900,9528,19055,11428,1700,41,41
3,1.75,1670,7415,1,0,0,3,7,1320,350,47.3776,-122.116,1650,8585,9085,10235,1670,32,32
3,2.25,1410,905,3,0,0,3,9,1410,0,47.5818,-122.402,1510,1352,2315,2862,1410,5,5
3,1,1280,9656,1,0,0,4,6,920,360,47.4485,-122.175,1340,8808,10936,10148,1280,60,60
4,2.5,2190,6896,2,0,0,3,7,2190,0,47.5191,-121.869,2190,5900,9086,8090,2190,12,12
3,1.75,1580,3764,1,0,0,3,7,1280,300,47.672,-122.397,1560,3764,5344,5324,1580,74,74
4,2.5,2530,9933,2,0,2,3,8,2010,520,47.2654,-122.216,2140,9933,12463,12073,2530,29,29
3,1,680,2400,1,0,0,4,6,680,0,47.5982,-122.299,1470,3600,3080,5070,680,116,116
4,2.25,2400,13430,1,0,0,4,9,2400,0,47.5987,-122.178,2580,10077,15830,12657,2400,55,55
3,2.5,1790,4065,2,0,0,3,8,1790,0,47.7344,-121.965,2480,4252,5855,6732,1790,10,10
4,1.5,2130,5000,2,0,0,4,8,2130,0,47.5828,-122.291,2560,5000,7130,7560,2130,99,99
4,2,2195,2681,1,0,0,3,7,1060,1135,47.6965,-122.342,1710,1280,4876,2990,2195,107,107
3,2.25,1430,7222,2,0,0,3,7,1430,0,47.5112,-122.19,1430,7220,8652,8650,1430,26,26
3,2,1490,7599,1,0,0,3,7,1490,0,47.3687,-122.088,1560,7710,9089,9270,1490,29,29
3,1.5,1630,9282,1,0,0,4,7,1630,0,47.2021,-122.002,1420,9282,10912,10702,1630,56,56
3,1.5,2110,5195,1,0,0,3,7,1210,900,47.5283,-122.286,1950,5195,7305,7145,2110,60,60
4,2.5,3180,9603,2,0,2,3,9,3180,0,47.7717,-122.277,2440,15261,12783,17701,3180,17,17
3,2.25,2610,9409,1,1,4,4,8,2610,0,47.5789,-122.076,2970,9156,12019,12126,2610,56,56
4,2,1764,15600,1,0,0,5,7,1764,0,47.4318,-122.181,1490,22387,17364,23877,1764,77,77
3,2.5,2370,5344,2,0,0,3,9,2370,0,47.54,-121.863,2990,5418,7714,8408,2370,16,16
3,2,1220,6404,1,0,0,3,7,1220,0,47.3523,-122.059,1570,7000,7624,8570,1220,25,25
3,2,1800,5000,2,0,0,5,7,1600,200,47.5447,-122.389,1640,5000,6800,6640,1800,94,94
5,3.5,4330,11979,1,0,4,3,12,2090,2240,47.6251,-122.218,4320,12000,16309,16320,4330,11,11
4,1.75,1670,10200,1,0,0,3,7,1390,280,47.5524,-122.267,1720,6860,11870,8580,1670,66,66
3,1.75,1310,8600,1,0,0,4,7,1310,0,47.686,-122.185,2510,8515,9910,11025,1310,32,32
4,2.5,2150,7670,1,0,0,5,7,1240,910,47.3942,-122.189,1610,7350,9820,8960,2150,43,43
5,2.5,3860,42733,1,0,3,4,8,2300,1560,47.3117,-122.254,2520,19353,46593,21873,3860,64,64
2,1.75,950,15219,1,0,0,3,8,950,0,47.7723,-122.262,1560,12416,16169,13976,950,10,10
3,2,2500,6733,1,0,0,3,8,1770,730,47.6691,-122.36,1770,6343,9233,8113,2500,40,40
3,1.5,1230,7200,1,0,0,3,7,1230,0,47.7281,-122.311,1400,6240,8430,7640,1230,66,66
3,1.75,1090,7200,1,0,0,3,7,1090,0,47.7227,-122.179,1240,7200,8290,8440,1090,51,51
4,4.5,5030,11023,2,0,2,3,11,3250,1780,47.5722,-122.236,3640,11490,16053,15130,5030,11,11
3,3,1260,1251,2,0,0,3,7,1040,220,47.5943,-122.296,1780,7715,2511,9495,1260,16,16
4,1,1450,8960,1,0,0,3,6,1450,0,47.4972,-122.348,1160,7680,10410,8840,1450,76,76
1,0.75,1170,14149,1,0,0,5,7,880,290,47.2653,-121.91,1130,24513,15319,25643,1170,57,57
2,2.5,1500,1174,2,0,0,3,8,1140,360,47.6689,-122.363,1550,1519,2674,3069,1500,5,5
4,1.5,2180,22870,1,0,0,4,6,1280,900,47.3187,-122.081,2420,22614,25050,25034,2180,65,39
3,2.5,3420,25150,1,0,0,4,10,1750,1670,47.5706,-122.152,2900,19604,28570,22504,3420,32,32
3,2,1010,14183,1,0,0,3,8,1010,0,47.6232,-122.043,1750,11700,15193,13450,1010,37,37
2,1.75,1870,6625,1,0,0,3,7,960,910,47.5071,-122.249,1680,6000,8495,7680,1870,71,71
3,2.25,2730,7521,2,0,2,3,9,2730,0,47.7704,-122.196,2700,8204,10251,10904,2730,27,27
3,2.5,2870,5163,2,0,0,3,9,2870,0,47.6935,-122.352,1630,7995,8033,9625,2870,5,5
3,2,1310,7349,1,0,0,3,7,870,440,47.3639,-122.186,1690,6580,8659,8270,1310,24,24
4,3.5,2550,3600,2,0,2,3,8,1880,670,47.7709,-122.39,2090,6000,6150,8090,2550,22,22
3,3.75,1950,8625,1,0,0,3,8,1360,590,47.505,-122.258,1950,6670,10575,8620,1950,60,60
4,2,3090,41147,1,0,0,3,7,3090,0,47.6748,-122.049,3300,34280,44237,37580,3090,29,29
2,1.75,2050,11900,1,0,0,4,8,2050,0,47.6209,-122.219,2980,11900,13950,14880,2050,69,69
5,3.5,7350,12231,2,0,4,3,11,4750,2600,47.5373,-121.865,5380,12587,19581,17967,7350,18,18
4,2.5,2410,55931,2,0,0,3,9,2410,0,47.3109,-122.097,2780,55931,58341,58711,2410,30,30
2,2.25,2910,6110,2,0,2,4,9,2910,0,47.5279,-122.387,2090,5763,9020,7853,2910,34,34
3,1,1460,8400,1,0,0,3,7,1460,0,47.4243,-122.198,1460,9600,9860,11060,1460,61,61
4,4.25,5770,21300,2,1,4,4,11,5770,0,47.585,-122.222,4620,22748,27070,27368,5770,39,39
3,2.5,1880,4499,2,0,0,3,8,1880,0,47.5664,-121.999,2130,5114,6379,7244,1880,26,26
4,2.5,2170,7275,1,0,0,3,8,1820,350,47.5672,-122.09,2390,7275,9445,9665,2170,41,41
2,1,880,1712,2,0,0,4,7,880,0,47.6475,-122.397,1360,1748,2592,3108,880,74,74
4,1.5,1600,6180,1,0,0,3,6,1600,0,47.5681,-122.285,1410,6180,7780,7590,1600,73,73
3,1.5,1170,1174,2,0,0,3,7,840,330,47.5459,-122.376,1170,2537,2344,3707,1170,12,12
4,1.75,4060,4000,2,0,3,3,10,2890,1170,47.6375,-122.389,1860,4000,8060,5860,4060,66,19
2,1,860,10400,1,0,0,4,6,860,0,47.3682,-122.096,1390,9086,11260,10476,860,36,36
5,2.5,3340,24755,2,0,0,3,10,3340,0,47.4565,-122.066,3420,23274,28095,26694,3340,17,17
5,2.25,3120,10400,2,0,0,3,8,3120,0,47.3097,-122.34,2160,8267,13520,10427,3120,39,39
4,2.5,3240,20301,2,0,0,3,10,3240,0,47.719,-122.114,3010,23650,23541,26660,3240,34,34
3,1,1430,5960,1,0,0,4,7,1430,0,47.562,-122.289,1140,3960,7390,5100,1430,102,102
3,1,1230,9600,1,0,0,3,7,1230,0,47.5553,-122.288,1510,6600,10830,8110,1230,67,67
3,2.5,2280,6031,2,0,0,3,8,2280,0,47.7322,-121.966,2430,7200,8311,9630,2280,8,8
5,3,2430,8000,1,0,0,4,7,1370,1060,47.603,-122.12,1770,8000,10430,9770,2430,62,62
3,1,1040,7288,1,0,0,3,7,1040,0,47.7287,-122.311,1160,7287,8328,8447,1040,60,60
3,1.75,2040,5000,1,0,0,3,7,1780,260,47.6756,-122.299,1690,5000,7040,6690,2040,95,95
3,2.5,2480,4950,2,0,0,3,7,2480,0,47.4389,-122.116,2230,5298,7430,7528,2480,15,15
2,1,1400,4500,1,0,0,3,7,900,500,47.4866,-122.219,1400,5500,5900,6900,1400,97,97
4,2.5,3000,9793,2,0,0,3,7,3000,0,47.3655,-122.028,1890,7557,12793,9447,3000,17,17
2,1,660,6509,1,0,0,4,5,660,0,47.4938,-122.171,970,5713,7169,6683,660,67,67
3,2,1800,43995,2,0,0,3,8,1800,0,47.7585,-122.022,2290,51400,45795,53690,1800,31,31
5,1.75,2150,7171,1,0,0,4,7,1460,690,47.3952,-122.176,1710,7300,9321,9010,2150,49,49
2,1,1070,5000,1,0,0,3,7,1070,0,47.6666,-122.331,1710,5000,6070,6710,1070,95,95
3,1.75,1350,8548,1,0,0,3,7,1350,0,47.3179,-122.33,1660,8538,9898,10198,1350,34,34
2,1.75,1320,2609,1,0,0,4,7,920,400,47.6878,-122.366,1200,4220,3929,5420,1320,81,81
3,2.5,1530,5032,2,0,0,3,7,1530,0,47.6985,-122.349,1450,2136,6562,3586,1530,21,21
3,2,1360,3090,2,0,0,3,8,1360,0,47.6838,-122.353,1500,3090,4450,4590,1360,29,29
3,2.5,1530,3464,2,0,0,3,8,1530,0,47.6179,-122.141,1530,3446,4994,4976,1530,21,21
5,2.5,2980,5377,2,0,0,3,9,2980,0,47.7074,-122.101,3150,6593,8357,9743,2980,13,13
2,1,920,2332,1,0,0,4,8,920,0,47.3779,-122.32,1310,2853,3252,4163,920,39,39
2,2.5,2380,6600,1,0,0,3,8,2380,0,47.717,-122.02,1870,6600,8980,8470,2380,9,9
4,2.5,2810,4500,2,0,0,3,9,2810,0,47.3552,-122.023,2980,5046,7310,8026,2810,5,5
5,2.75,2210,13500,1,0,0,5,7,1460,750,47.4468,-122.282,1590,10850,15710,12440,2210,56,56
3,2.25,1220,2980,2,0,0,3,7,1220,0,47.7151,-122.203,1220,2140,4200,3360,1220,33,33
4,2.25,2350,18600,2,0,0,4,9,2350,0,47.7473,-122.257,2880,14400,20950,17280,2350,42,42
3,2.5,1560,2740,2,0,0,3,8,1560,0,47.4909,-122.154,1310,2698,4300,4008,1560,20,20
4,2.5,3010,5040,2,0,0,3,8,3010,0,47.709,-122.35,1090,5040,8050,6130,3010,13,13
3,1.5,1990,5978,1,1,4,4,7,1990,0,47.3449,-122.329,2100,6221,7968,8321,1990,93,93
3,1.5,1050,6615,1,0,0,4,6,800,250,47.6578,-122.39,1530,5250,7665,6780,1050,69,69
5,2.75,2910,16410,1,0,0,4,8,2910,0,47.44,-122.145,1980,18000,19320,19980,2910,52,52
6,3,1880,7200,1,0,0,4,7,1880,0,47.5029,-122.188,1540,13022,9080,14562,1880,53,53
5,2.25,2120,4000,1,0,0,4,7,1720,400,47.644,-122.353,1960,4000,6120,5960,2120,109,109
3,3,1910,4800,1,0,0,3,9,1910,0,47.6572,-122.346,1280,1310,6710,2590,1910,119,23
3,1,980,7560,1,0,0,3,7,980,0,47.5256,-122.375,1300,7560,8540,8860,980,68,68
6,2,2390,8660,1,0,0,4,7,2390,0,47.7589,-122.216,2250,12942,11050,15192,2390,94,94
3,1.75,1500,7560,1,0,0,3,7,1500,0,47.3467,-122.296,1500,7560,9060,9060,1500,40,40
4,3.5,3090,100835,2,0,0,3,9,3090,0,47.3087,-122.088,2400,50543,103925,52943,3090,20,20
3,2,1610,6911,1,0,0,3,7,1260,350,47.7188,-122.177,1630,6911,8521,8541,1610,31,31
4,2.5,3140,14421,2,0,0,3,10,3140,0,47.5943,-122.018,3140,17417,17561,20557,3140,25,25
4,2.5,2410,4708,2,0,0,3,8,2410,0,47.3229,-122.182,2517,5290,7118,7807,2410,17,17
3,1.75,1270,12420,1,0,0,4,7,1270,0,47.5387,-122.179,1560,9910,13690,11470,1270,57,57
2,1,1210,4800,1,0,0,3,8,1060,150,47.5625,-122.316,1380,4800,6010,6180,1210,69,69
4,2.5,3220,20251,1,0,0,3,10,3220,0,47.5692,-122.192,4200,22114,23471,26314,3220,50,50
3,2.5,1180,1262,3,0,0,3,8,1180,0,47.6381,-122.375,1180,2632,2442,3812,1180,9,9
3,2,1980,7680,1,0,0,4,6,1070,910,47.6839,-122.195,1330,8704,9660,10034,1980,108,108
2,1,1250,4960,1,0,0,3,7,940,310,47.6893,-122.325,2030,7440,6210,9470,1250,81,81
4,2.5,2020,32710,1,0,0,3,7,1070,950,47.4969,-122.33,1340,17700,34730,19040,2020,78,78
4,4.5,3870,35889,2,0,0,3,10,2530,1340,47.4677,-122.01,3020,35366,39759,38386,3870,18,18
4,2.5,1940,10200,1,0,0,4,8,1140,800,47.4157,-122.161,1920,12600,12140,14520,1940,42,42
5,3.5,3900,4400,2,0,0,3,9,2650,1250,47.6607,-122.362,1190,4400,8300,5590,3900,5,5
4,1.75,2400,21196,1,0,0,5,8,1590,810,47.4282,-122.347,2200,19134,23596,21334,2400,63,63
3,2.5,2040,2500,2,0,0,3,7,1470,570,47.573,-122.372,1410,2500,4540,3910,2040,11,11
3,2.5,1460,1613,2,0,0,3,8,1180,280,47.6781,-122.375,1460,1403,3073,2863,1460,12,12
3,1,1380,9875,1,0,0,3,7,1380,0,47.5131,-122.334,1200,6250,11255,7450,1380,60,60
3,2.5,2140,40173,2,0,0,4,8,2140,0,47.4786,-122.066,2380,43016,42313,45396,2140,29,29
4,2.75,2730,4683,2,0,0,3,7,2730,0,47.3608,-122.043,2230,4924,7413,7154,2730,14,14
3,2.5,2790,48994,2,0,0,4,9,2790,0,47.3487,-122.088,2550,37834,51784,40384,2790,35,35
2,1,1670,8195,1,0,0,3,7,1670,0,47.6627,-122.192,1980,7500,9865,9480,1670,65,40
5,3,2170,2440,1,0,0,4,8,1450,720,47.6724,-122.317,2070,4000,4610,6070,2170,108,108
3,3.25,1689,1388,3,0,0,3,8,1689,0,47.7174,-122.317,1459,1384,3077,2843,1689,11,11
3,2.5,1730,8490,1,0,0,3,7,1210,520,47.7187,-122.219,1870,7400,10220,9270,1730,50,50
4,2.5,3010,6903,2,0,0,3,9,3010,0,47.5213,-122.193,2860,6435,9913,9295,3010,18,18
4,2.5,1714,3250,2,0,0,3,8,1714,0,47.429,-122.189,1714,3250,4964,4964,1714,9,9
4,2.5,2250,4119,2,0,0,3,8,2250,0,47.5973,-122.034,2290,3115,6369,5405,2250,18,18
3,2.5,1720,4120,2,0,0,3,7,1720,0,47.4319,-122.328,1720,5544,5840,7264,1720,20,20
3,2.5,1710,1904,2,0,0,3,8,1140,570,47.5827,-122.387,1260,1316,3614,2576,1710,16,16
4,2.25,2210,7665,2,0,0,4,8,2210,0,47.5424,-122.168,1960,7903,9875,9863,2210,51,51
3,1,1690,4250,1,0,0,3,7,1020,670,47.4945,-122.258,1820,8865,5940,10685,1690,52,52
4,1.75,2160,4333,1,0,0,4,8,1260,900,47.6893,-122.388,1670,4426,6493,6096,2160,77,77
3,2,2100,72745,1,0,0,4,9,2100,0,47.7479,-122.062,2290,54885,74845,57175,2100,24,24
4,3,2920,33976,1,0,3,5,8,1460,1460,47.6164,-122.104,2970,15210,36896,18180,2920,55,55
4,3.5,4210,10308,2,0,0,3,10,4210,0,47.5905,-122.117,3860,10200,14518,14060,4210,13,13
5,4,4700,22326,2,0,0,3,11,4700,0,47.5417,-122.111,4730,27110,27026,31840,4700,17,17
3,1.5,1740,9547,1,0,0,4,7,1740,0,47.4475,-122.213,1780,9936,11287,11716,1740,57,57
4,3,4040,20001,1,0,0,3,9,2020,2020,47.6408,-122.212,2990,20098,24041,23088,4040,47,13
3,2.5,2070,6145,2,0,0,3,7,2070,0,47.3357,-122.172,2070,5297,8215,7367,2070,16,16
5,2.5,2030,8400,1,0,0,3,7,1330,700,47.6713,-122.152,1920,8400,10430,10320,2030,51,51
3,2.25,2120,6710,1,0,0,5,7,1420,700,47.7461,-122.324,1880,6960,8830,8840,2120,60,60
3,2.5,3680,203860,1,0,0,3,9,3680,0,47.6903,-121.929,2410,144183,207540,146593,3680,25,25
3,2,1720,4200,2,0,0,3,8,1720,0,47.6285,-122.301,1720,4200,5920,5920,1720,111,22
4,2.5,3620,42580,2,0,0,3,10,3620,0,47.7204,-122.115,2950,33167,46200,36117,3620,35,35
5,3.25,2980,7095,2,0,0,3,9,2980,0,47.6919,-122.294,1670,7140,10075,8810,2980,21,8
3,2.5,1600,9830,2,0,0,4,8,1600,0,47.339,-122.266,1890,8910,11430,10800,1600,26,26
3,1,1250,7280,1,0,0,3,7,1250,0,47.6986,-122.129,1690,7280,8530,8970,1250,44,44
4,2,1980,4500,2,0,0,4,7,1980,0,47.6728,-122.379,1550,2541,6480,4091,1980,109,109
3,1,1050,5233,1,0,0,5,5,1050,0,47.3106,-121.999,970,7500,6283,8470,1050,113,113
3,1.5,1860,10379,1,0,0,3,7,1240,620,47.3962,-122.309,2240,11328,12239,13568,1860,56,56
4,2,1680,5000,1,0,0,3,7,980,700,47.6858,-122.286,1680,6000,6680,7680,1680,69,69
5,2.5,2540,5100,2,0,0,3,7,2540,0,47.5123,-122.316,1400,9440,7640,10840,2540,5,5
3,3.5,1710,2212,2,0,0,3,7,1400,310,47.5459,-122.368,1580,2212,3922,3792,1710,6,6
3,2,2040,4800,1,0,0,4,7,1020,1020,47.5561,-122.377,1640,4800,6840,6440,2040,94,94
3,2.5,1700,4000,2,0,0,3,7,1700,0,47.5327,-121.871,1700,4417,5700,6117,1700,16,16
2,1.75,1250,7029,1,0,0,4,7,1250,0,47.6936,-122.186,1680,8470,8279,10150,1250,33,33
3,1.5,1540,8110,1,0,0,4,7,1190,350,47.7329,-122.291,1290,8110,9650,9400,1540,60,60
3,2,1450,2400,1,0,0,3,8,1450,0,47.6726,-122.381,1450,4275,3850,5725,1450,119,11
3,1.75,1070,7200,1,0,0,3,7,1070,0,47.3134,-122.023,1480,7200,8270,8680,1070,25,25
4,3.5,2210,7597,1,0,0,4,9,1550,660,47.5816,-122.197,2370,8811,9807,11181,2210,42,8
3,1,1290,4000,1,0,0,3,7,1290,0,47.5462,-122.277,1160,5040,5290,6200,1290,93,93
3,2.25,2110,11319,2,0,0,4,8,2110,0,47.742,-122.105,1860,11319,13429,13179,2110,41,41
4,2.75,1610,11201,1,0,0,5,7,1020,590,47.7024,-122.198,1610,9000,12811,10610,1610,37,37
4,2.5,3160,6961,2,0,0,3,8,3160,0,47.6125,-122.01,3110,5058,10121,8168,3160,14,14
5,3,3030,4120,1,0,0,4,7,1930,1100,47.6771,-122.319,1280,3090,7150,4370,3030,106,106
4,1.5,1940,6386,1,0,0,3,7,1140,800,47.5533,-122.285,1340,6165,8326,7505,1940,65,65
4,1.5,1420,4923,1,0,0,4,8,1420,0,47.6901,-122.339,1470,4923,6343,6393,1420,91,91
3,2.5,1400,4400,1,0,0,3,7,1400,0,47.553,-122.365,1060,4400,5800,5460,1400,89,0
3,1,1010,3520,1,0,0,3,7,1010,0,47.6208,-122.319,1300,1233,4530,2533,1010,117,117
4,3.5,2680,10000,2,0,0,3,8,2040,640,47.726,-122.296,1530,8000,12680,9530,2680,77,0
3,2.75,1320,1125,3,0,0,3,8,1320,0,47.6598,-122.348,1320,1266,2445,2586,1320,11,11
3,1.75,1360,4998,1,0,0,3,8,1360,0,47.547,-122.302,1350,4998,6358,6348,1360,51,1
5,3,4290,17100,1,0,3,3,9,2480,1810,47.5473,-122.211,3550,16988,21390,20538,4290,47,7
2,1,770,5160,1,0,0,3,6,770,0,47.5304,-122.356,920,5160,5930,6080,770,76,76
2,1.75,2110,8700,1,0,4,4,9,1760,350,47.4912,-122.365,2120,9500,10810,11620,2110,59,59
4,4.25,3500,8750,1,0,4,5,9,2140,1360,47.7222,-122.367,3110,8750,12250,11860,3500,68,68
3,1.5,1520,9041,1,0,0,4,7,1520,0,47.6158,-122.213,3260,10020,10561,13280,1520,65,65
4,2.25,3440,35025,2,0,0,3,10,3440,0,47.6674,-122.055,3210,35005,38465,38215,3440,31,31
3,2.25,1700,8800,1,0,0,5,7,850,850,47.6863,-122.189,2180,8960,10500,11140,1700,50,50
4,2.25,2130,8410,2,0,0,4,8,2130,0,47.5589,-122.128,2170,8400,10540,10570,2130,42,42
4,2.5,2920,7200,1,0,3,3,8,1470,1450,47.5947,-122.288,3210,6825,10120,10035,2920,98,8
3,1.75,1590,9417,1,0,0,4,7,1590,0,47.7617,-122.36,1600,9272,11007,10872,1590,65,65
3,1.75,2050,5160,1,0,0,4,8,1300,750,47.6374,-122.304,2220,5960,7210,8180,2050,93,93
4,2.25,2480,9780,1,0,0,4,8,1900,580,47.6388,-122.099,2640,9780,12260,12420,2480,44,44
4,2.5,2100,8800,1,0,0,5,8,1250,850,47.6909,-122.186,2100,9000,10900,11100,2100,39,39
4,4.25,4480,5715,2,0,0,3,7,3680,800,47.373,-122.179,2190,6070,10195,8260,4480,16,16
4,1.75,1814,5000,1,0,0,4,7,944,870,47.684,-122.281,1290,5000,6814,6290,1814,68,68
4,2.5,2770,9798,2,0,0,4,9,2770,0,47.562,-122.081,3040,11100,12568,14140,2770,33,33
2,1,1470,25661,1,0,0,3,4,1470,0,47.4878,-122.13,1670,43301,27131,44971,1470,87,87
4,2.25,2090,8941,2,0,0,3,7,2090,0,47.4332,-122.167,1890,7946,11031,9836,2090,44,44
3,1.75,1400,4000,1,0,0,4,7,1400,0,47.6902,-122.388,1050,4330,5400,5380,1400,94,94
3,2.5,2150,4332,2,0,0,3,8,2150,0,47.7373,-121.969,2140,4332,6482,6472,2150,6,6
3,1.75,1360,10742,1,0,0,5,7,960,400,47.4351,-122.173,1830,9000,12102,10830,1360,48,48
4,1.75,1720,7200,1,0,0,3,7,1220,500,47.306,-122.375,1790,7200,8920,8990,1720,45,45
3,2.75,2430,14861,1,0,0,3,9,1530,900,47.7461,-122.247,2230,10300,17291,12530,2430,31,31
4,2.5,2690,6124,2,0,0,3,7,2690,0,47.3343,-122.058,2300,6002,8814,8302,2690,12,12
4,3.5,3560,16782,2,0,0,3,10,2560,1000,47.5569,-122.225,3100,18047,20342,21147,3560,5,5
3,2,1680,7900,2,0,0,4,7,1680,0,47.3255,-122.305,1250,15600,9580,16850,1680,66,66
3,2.25,2510,6339,1,0,2,5,8,1810,700,47.6496,-122.391,1820,5741,8849,7561,2510,87,87
2,1.5,1440,725,2,0,0,3,8,1100,340,47.5607,-122.378,1440,4255,2165,5695,1440,8,8
4,2.5,2150,8165,1,0,0,3,8,1430,720,47.773,-122.371,2360,7980,10315,10340,2150,62,62
5,3.5,5430,10327,2,0,2,3,10,4010,1420,47.5476,-122.116,4340,10324,15757,14664,5430,12,12
3,1,1160,10881,1,0,0,2,7,920,240,47.6339,-122.033,1280,10843,12041,12123,1160,36,36
2,1,1030,4365,1,0,0,3,7,1030,0,47.6875,-122.387,1420,4268,5395,5688,1030,77,77
3,2.5,2450,7062,2,0,0,3,8,2450,0,47.3061,-122.36,1960,7200,9512,9160,2450,26,26
4,1.75,1760,6000,1,0,0,3,7,880,880,47.6508,-122.373,2040,6000,7760,8040,1760,73,73
1,1,1090,32010,1,0,0,4,6,1090,0,47.6928,-121.87,1870,25346,33100,27216,1090,61,61
4,2.5,2250,14440,1,0,0,3,7,1550,700,47.5221,-122.045,2090,11400,16690,13490,2250,52,52
4,2.25,2100,12172,1,0,0,5,9,2100,0,47.5458,-122.227,2400,10713,14272,13113,2100,58,58
3,1.75,1830,51836,1,0,0,4,7,1430,400,47.4774,-122.098,1320,51400,53666,52720,1830,53,53
3,2.5,1860,3730,2,0,0,3,8,1860,0,47.7442,-121.984,2110,4509,5590,6619,1860,7,7
3,1.5,1320,15053,1,0,0,3,7,1320,0,47.7405,-122.095,1250,13368,16373,14618,1320,40,40
3,2.5,2790,6720,2,0,0,3,8,2790,0,47.5958,-122.038,2620,6720,9510,9340,2790,17,17
2,1,1310,7128,1,0,0,4,7,940,370,47.3958,-122.189,1400,7161,8438,8561,1310,39,39
2,1,710,4618,1,0,1,3,5,710,0,47.64,-122.394,1810,4988,5328,6798,710,94,94
4,3.5,2600,5100,2,0,0,3,8,1820,780,47.6948,-122.395,2000,6720,7700,8720,2600,16,16
4,2.25,2350,10664,1,0,1,2,7,1510,840,47.5743,-122.238,2350,10140,13014,12490,2350,67,67
2,1,790,5240,1,0,0,4,6,790,0,47.5303,-122.288,1430,5320,6030,6750,790,94,94
1,0.75,680,9600,1,0,0,3,5,680,0,47.6964,-122.306,1580,6624,10280,8204,680,72,72
3,2.5,1180,932,3,0,0,3,8,1180,0,47.638,-122.375,1180,2632,2112,3812,1180,9,9
3,2.25,1830,8831,1,0,0,3,7,1460,370,47.7286,-122.215,2330,8064,10661,10394,1830,40,40
3,2.5,2890,21780,2,0,0,3,8,2890,0,47.4326,-122.286,2120,8117,24670,10237,2890,19,19
3,2.5,1450,3850,2,0,0,3,7,1450,0,47.5318,-121.85,1970,3748,5300,5718,1450,15,15
3,2.5,1660,2890,2,0,0,3,7,1660,0,47.5434,-122.293,1540,2890,4550,4430,1660,18,18
4,2.5,2490,7694,2,0,0,3,8,2490,0,47.567,-122.016,2140,8126,10184,10266,2490,32,32
3,1.75,1670,5209,1,0,0,5,7,1670,0,47.5362,-122.271,1990,4960,6879,6950,1670,111,111
3,2,2220,94300,1,0,0,5,7,1640,580,47.3459,-121.95,2070,80100,96520,82170,2220,43,43
3,2.25,1940,6500,1,0,0,3,8,1440,500,47.3565,-122.149,1880,8991,8440,10871,1940,40,40
4,2.5,3060,7920,1,0,0,3,8,1810,1250,47.7675,-122.261,2690,7767,10980,10457,3060,45,45
3,2.5,1630,7700,1,0,0,3,7,1120,510,47.3876,-122.211,1640,8160,9330,9800,1630,41,41
4,1.75,960,8863,1,0,0,5,6,580,380,47.5372,-122.289,1720,8249,9823,9969,960,70,70
2,1.5,770,850,2,0,0,3,7,770,0,47.5644,-122.388,1350,915,1620,2265,770,13,13
4,2.5,2303,3680,2,0,0,3,8,2303,0,47.2599,-122.283,2303,3760,5983,6063,2303,6,6
3,1,1160,7912,1,0,0,4,7,1160,0,47.7336,-122.306,1190,7482,9072,8672,1160,63,63
3,1.75,1720,8867,1,0,0,3,8,1320,400,47.44,-122.136,2200,9170,10587,11370,1720,34,34
3,2.5,1800,2790,2,0,0,3,8,1800,0,47.5455,-122.371,1580,2036,4590,3616,1800,8,8
3,1.5,2010,9480,1,0,0,3,8,1570,440,47.7102,-122.281,1920,8791,11490,10711,2010,68,68
5,2.5,2970,24759,1,0,0,4,8,1670,1300,47.3908,-122.173,2100,21803,27729,23903,2970,50,50
4,2.5,3210,8938,2,0,0,3,10,3210,0,47.582,-121.971,3740,8108,12148,11848,3210,14,14
6,3.75,2940,5054,2,0,0,3,7,2940,0,47.5122,-122.385,1530,5320,7994,6850,2940,77,12
3,1,1070,4000,1,0,0,4,7,1070,0,47.5529,-122.305,1090,4000,5070,5090,1070,48,48
3,1.75,1150,10466,1,0,0,5,7,1150,0,47.5531,-122.177,1350,10384,11616,11734,1150,60,60
3,1,1470,7680,1,0,0,3,7,1220,250,47.5276,-122.359,1470,6784,9150,8254,1470,73,73
4,1.75,1890,9623,1,0,0,4,7,1290,600,47.2901,-122.279,1510,9711,11513,11221,1890,50,50
3,1,1100,4600,1,0,0,3,7,1100,0,47.5686,-122.385,1200,5175,5700,6375,1100,102,102
2,2.5,1470,690,3,0,3,3,8,1470,0,47.6523,-122.346,1480,1284,2160,2764,1470,11,11
3,2,1710,4697,1,0,0,5,6,1710,0,47.3048,-122.218,1030,4705,6407,5735,1710,78,78
9,4.5,3830,6988,2,0,0,3,7,2450,1380,47.6927,-122.338,1460,6291,10818,7751,3830,81,81
3,2,1970,4166,2,0,3,5,8,1270,700,47.5717,-122.375,2390,4166,6136,6556,1970,90,90
3,1,1230,10170,1,0,0,3,7,1230,0,47.4437,-121.772,1380,10098,11400,11478,1230,40,40
4,2.5,2270,11500,1,0,0,3,8,1540,730,47.7089,-122.241,2020,10918,13770,12938,2270,52,52
5,5.5,6640,40014,2,1,4,3,12,6350,290,47.7493,-122.28,3030,23408,46654,26438,6640,15,15
4,2.5,3670,49658,2,0,0,3,10,3670,0,47.6219,-122.015,3040,49658,53328,52698,3670,20,20
4,2.25,2730,35100,2,0,0,3,8,2730,0,47.5913,-122.012,2730,36677,37830,39407,2730,42,42
3,1.75,1780,11096,1,0,0,3,7,1210,570,47.617,-122.051,1780,10640,12876,12420,1780,40,40
3,2,2000,10490,1,0,0,3,8,1430,570,47.6976,-122.166,1530,7659,12490,9189,2000,41,41
3,2,1920,33630,1,0,0,3,8,1920,0,47.4983,-122.167,2080,7505,35550,9585,1920,27,27
3,1,1300,8800,1,0,0,3,7,1300,0,47.64,-121.966,1600,12210,10100,13810,1300,42,42
3,1,1780,7800,1,0,0,3,7,1060,720,47.4932,-122.263,1450,7800,9580,9250,1780,62,62
3,2.25,1440,9806,1,0,0,3,7,1440,0,47.3857,-122.212,1590,9782,11246,11372,1440,54,54
3,1,1160,11799,1,0,0,3,7,1160,0,47.7263,-122.229,1220,10500,12959,11720,1160,53,53
3,2.25,1370,1533,3,0,0,3,8,1370,0,47.7326,-122.343,1370,1125,2903,2495,1370,10,10
4,2,2280,7200,1,0,0,4,7,2280,0,47.7132,-122.355,1100,7620,9480,8720,2280,63,63
3,1,1270,8508,1,0,0,4,6,650,620,47.4961,-122.322,1200,9415,9778,10615,1270,77,77
4,3.5,3570,27699,2,0,0,3,11,3570,0,47.7173,-122.098,3800,35880,31269,39680,3570,29,29
3,1.5,1070,5150,1,0,0,4,6,1070,0,47.5335,-122.349,1020,4800,6220,5820,1070,79,79
5,5.25,3410,8118,2,0,0,3,11,3410,0,47.6295,-122.236,3410,16236,11528,19646,3410,13,13
4,4.25,6410,43838,2,0,2,4,12,5610,800,47.5703,-122.28,2270,6630,50248,8900,6410,113,113
5,2.75,2810,13144,1,0,0,3,8,1440,1370,47.6199,-122.141,2480,13144,15954,15624,2810,55,55
4,2.75,3800,9606,2,0,0,3,9,3800,0,47.7368,-122.208,3400,9677,13406,13077,3800,11,11
4,2.5,2660,4000,2,0,0,3,8,2660,0,47.6876,-122.038,2330,4517,6660,6847,2660,18,18
4,1.75,2190,8400,2,0,0,2,8,2190,0,47.3003,-122.373,2410,7700,10590,10110,2190,41,41
4,2,2240,7725,1,0,0,5,7,1120,1120,47.5331,-122.365,1340,6300,9965,7640,2240,63,63
4,2.25,1790,7203,1,0,0,4,7,1110,680,47.7709,-122.294,2270,9000,8993,11270,1790,46,46
3,3.5,3620,8072,2,0,0,3,10,2920,700,47.5646,-122.127,3680,9624,11692,13304,3620,20,20
3,1,1280,8184,1,0,0,4,6,1280,0,47.7467,-122.319,1120,8184,9464,9304,1280,72,72
4,2,2310,31850,1,0,0,4,8,2310,0,47.7713,-122.122,2710,36042,34160,38752,2310,35,35
3,1.75,2050,9580,1,0,0,3,8,1400,650,47.6212,-122.038,1740,11952,11630,13692,2050,35,35
5,1.75,3240,34510,2,0,0,4,7,2690,550,47.5529,-122.027,2650,28250,37750,30900,3240,56,56
3,1.75,1480,800,2,0,0,3,8,1000,480,47.5493,-122.387,1480,1143,2280,2623,1480,5,5
4,2.75,2060,6659,1,0,0,3,7,1280,780,47.4276,-122.157,2020,8720,8719,10740,2060,38,38
3,1,900,4770,1,0,0,3,6,900,0,47.3038,-122.362,900,3480,5670,4380,900,50,5
3,1,1250,150117,1,0,0,3,7,1250,0,47.5956,-122.009,3060,50055,151367,53115,1250,44,44
4,2.25,2360,11523,2,0,0,4,10,2360,0,47.5318,-122.224,2850,11362,13883,14212,2360,51,51
4,2.5,2030,4596,2,0,0,3,8,2030,0,47.3515,-122.275,2040,4705,6626,6745,2030,5,5
2,2,1640,3021,1,0,2,3,7,840,800,47.666,-122.358,1780,4500,4661,6280,1640,60,60
4,2.25,1910,5120,1,0,0,3,8,1300,610,47.6534,-122.409,1810,5153,7030,6963,1910,65,65
4,2,2350,4815,1,0,0,4,7,1450,900,47.6681,-122.338,1640,4013,7165,5653,2350,105,105
5,2.75,2660,8737,1,0,4,5,8,1470,1190,47.5667,-122.155,3280,8783,11397,12063,2660,50,50
3,1.5,1560,20251,1,0,0,5,7,1200,360,47.619,-122.054,1560,19119,21811,20679,1560,30,30
3,2.5,1490,8102,2,0,0,4,7,1490,0,47.3712,-122.092,1640,7943,9592,9583,1490,29,29
3,1.75,2210,8955,1,0,1,3,8,1560,650,47.6621,-122.189,2210,8976,11165,11186,2210,45,45
4,2.5,3180,15358,2,0,0,3,9,3180,0,47.5172,-122.053,3020,15522,18538,18542,3180,31,31
4,2.75,2110,8751,1,0,0,3,7,1510,600,47.7617,-122.215,1660,10295,10861,11955,2110,57,57
6,3,2980,7200,1,0,2,3,8,2980,0,47.6366,-122.362,1720,3600,10180,5320,2980,108,108
3,2.25,2260,54014,1,0,0,3,7,1450,810,47.7657,-122.131,2140,44431,56274,46571,2260,57,57
6,5.25,6160,27490,2,0,0,3,11,4040,2120,47.6094,-122.023,4225,9100,33650,13325,6160,12,12
3,1,1230,171190,1,0,0,3,7,1230,0,47.4397,-122.46,1550,15450,172420,17000,1230,46,46
3,2.25,1780,9315,2,0,0,3,7,1780,0,47.7484,-122.353,1780,8545,11095,10325,1780,23,23
3,1,970,6828,1,0,0,3,6,970,0,47.5476,-122.36,1160,11666,7798,12826,970,91,91
3,1.75,1300,8500,1,0,0,4,7,1300,0,47.209,-122.005,1410,7800,9800,9210,1300,55,55
3,1.75,1490,10844,1,0,0,3,7,1210,280,47.6208,-122.106,2090,9944,12334,12034,1490,45,45
3,2.5,2100,6825,2,0,0,3,8,2100,0,47.4314,-122.189,2180,7614,8925,9794,2100,25,25
3,2,1840,3075,1,0,0,5,7,920,920,47.6894,-122.35,1480,3774,4915,5254,1840,91,91
3,2,1430,14250,1,0,0,3,7,1430,0,47.701,-122.199,1530,11475,15680,13005,1430,66,66
4,2.5,3284,6516,2,0,0,3,8,3284,0,47.3393,-122.181,2555,5008,9800,7563,3284,5,5
3,1.75,1250,5963,1,0,0,4,7,1250,0,47.6796,-122.301,970,5100,7213,6070,1250,66,66
3,1.75,1470,27000,1,0,0,3,7,1470,0,47.3943,-122.311,2230,14186,28470,16416,1470,61,61
4,2.75,2240,8162,2,0,0,5,7,1380,860,47.7427,-122.34,1550,8163,10402,9713,2240,73,73
3,2.5,2100,12338,2,0,0,3,9,2100,0,47.7412,-122.168,2320,6257,14438,8577,2100,22,22
3,2.5,1810,4332,2,0,0,3,8,1810,0,47.5776,-121.996,1740,4332,6142,6072,1810,27,27
4,2.5,3000,8584,2,0,0,3,7,3000,0,47.369,-122.032,2610,7570,11584,10180,3000,16,16
2,1,1290,6272,1,0,0,4,6,890,400,47.6777,-122.305,1260,5376,7562,6636,1290,97,97
3,2.5,1830,7585,2,0,0,4,8,1830,0,47.3893,-122.154,2070,7585,9415,9655,1830,24,24
4,3,2230,108900,1,0,0,3,7,1410,820,47.52,-121.845,1960,65340,111130,67300,2230,41,41
3,2.25,1550,1919,3,0,0,3,8,1550,0,47.6729,-122.379,1550,2918,3469,4468,1550,16,16
3,1,1090,10620,1,0,0,3,7,1090,0,47.3748,-122.294,1380,10620,11710,12000,1090,60,60
3,1,1870,7671,1,0,0,4,8,1720,150,47.7162,-122.36,1460,7679,9541,9139,1870,82,82
2,1,1010,3627,1,0,2,4,6,1010,0,47.5873,-122.294,1630,4040,4637,5670,1010,95,95
2,1,960,4400,1,0,0,4,7,960,0,47.5269,-122.264,1520,5000,5360,6520,960,68,68
6,2.5,2680,11250,1,0,0,5,7,1340,1340,47.6553,-122.19,2200,9875,13930,12075,2680,52,52
3,1,1830,6453,1,0,0,4,7,1830,0,47.7139,-122.288,1670,8012,8283,9682,1830,63,63
5,2.5,2730,17240,1,0,0,5,7,1660,1070,47.7646,-122.267,2250,13200,19970,15450,2730,61,61
2,1,1080,4000,1,0,0,3,7,1080,0,47.6902,-122.387,1530,4240,5080,5770,1080,79,79
5,2.25,2560,10360,1,0,0,4,8,1870,690,47.5819,-122.126,2070,7875,12920,9945,2560,53,53
4,3,5430,108900,2,0,0,4,10,5430,0,47.6582,-122.038,3170,107076,114330,110246,5430,32,32
3,2.5,2120,10021,1,0,0,4,8,1230,890,47.5621,-122.135,2690,10183,12141,12873,2120,43,43
3,1.75,1720,8102,1,0,0,5,6,860,860,47.7336,-122.29,1440,8106,9822,9546,1720,79,79
4,1,1680,5043,1,0,0,4,6,1680,0,47.5354,-122.273,1560,5765,6723,7325,1680,108,108
5,1.75,2000,3750,2,0,0,4,7,2000,0,47.6618,-122.355,1520,3750,5750,5270,2000,98,98
5,2.5,2780,12335,1,0,0,4,8,1590,1190,47.5681,-122.128,2750,9930,15115,12680,2780,51,51
2,1,770,7554,1,0,0,3,6,770,0,47.7057,-122.36,1390,7500,8324,8890,770,73,73
3,1,1140,7785,1,0,0,3,8,1140,0,47.709,-122.363,2080,10620,8925,12700,1140,65,65
3,2.5,1540,7773,2,0,0,4,8,1540,0,47.722,-122.194,1630,7340,9313,8970,1540,37,37
3,1.75,1450,61419,1,0,0,4,8,1450,0,47.3343,-122.16,2256,82328,62869,84584,1450,43,43
3,1.5,1820,5756,1,0,0,3,7,1640,180,47.6479,-122.367,1760,6169,7576,7929,1820,73,73
2,1,860,6800,1,0,0,3,6,860,0,47.7274,-122.337,1220,6800,7660,8020,860,76,76
4,1.75,2120,6250,1,0,0,5,7,1060,1060,47.5506,-122.385,1410,6250,8370,7660,2120,102,102
2,1.5,1320,1194,3,0,0,3,7,1320,0,47.6704,-122.39,1320,1250,2514,2570,1320,18,18
2,1,1210,10000,1,0,0,3,7,1210,0,47.4402,-122.333,1620,10959,11210,12579,1210,66,66
5,2.75,2980,9838,1,0,0,3,7,1710,1270,47.3807,-122.222,2240,9838,12818,12078,2980,51,51
3,2.5,1430,1002,3,0,0,3,8,1430,0,47.698,-122.349,1430,1530,2432,2960,1430,17,17
3,1,1430,15246,1,0,0,4,7,980,450,47.4075,-122.214,1960,13068,16676,15028,1430,58,58
5,2.25,3410,35536,2,0,0,3,10,2530,880,47.65,-122.155,3140,43453,38946,46593,3410,45,45
2,1.5,2440,6900,2,0,0,3,7,1590,850,47.5568,-122.271,1770,6900,9340,8670,2440,109,109
4,2,1710,4178,1,0,0,4,8,1710,0,47.6373,-122.3,1760,4178,5888,5938,1710,93,93
5,1.75,1400,5071,1,0,0,3,5,1400,0,47.6499,-121.908,1200,7500,6471,8700,1400,103,103
4,2.5,2880,12349,2,0,0,3,10,2880,0,47.5879,-121.973,3490,11539,15229,15029,2880,23,23
4,2.5,1520,3370,2,0,0,3,8,1520,0,47.5696,-122.004,1860,4486,4890,6346,1520,25,25
3,2.25,1820,7326,2,0,0,3,8,1820,0,47.7133,-122.217,2430,7696,9146,10126,1820,36,36
3,2,2140,4923,1,0,0,4,8,1070,1070,47.6902,-122.339,1470,4923,7063,6393,2140,91,91
2,1.75,1560,7575,1,0,0,3,8,1560,0,47.3776,-122.228,2050,9000,9135,11050,1560,17,17
4,2.5,2612,5850,2,0,0,3,8,2612,0,47.3751,-122.189,2419,8984,8462,11403,2612,5,5
3,2,2050,11454,1,0,0,3,8,2050,0,47.6389,-122.11,1980,11424,13504,13404,2050,32,32
2,2.5,2540,7089,2,0,0,3,9,2540,0,47.5747,-122.414,1330,7089,9629,8419,2540,15,15
3,1.5,1660,7221,1,0,0,3,7,980,680,47.4962,-122.32,1770,8083,8881,9853,1660,57,57
2,1.75,1210,7507,1,0,0,3,7,1210,0,47.7078,-122.234,1840,7500,8717,9340,1210,37,37
2,2,1480,804,3,0,0,3,8,1480,0,47.602,-122.308,1380,1751,2284,3131,1480,11,11
4,2.5,2120,9603,2,0,0,3,8,2120,0,47.5348,-122.053,1990,9611,11723,11601,2120,34,34
2,1,990,10556,2,0,0,3,7,990,0,47.5118,-122.188,1350,7295,11546,8645,990,38,38
4,1.75,2520,15205,1,0,0,4,7,2040,480,47.7642,-122.264,1680,10000,17725,11680,2520,65,65
4,2.5,1820,6916,2,0,0,3,7,1820,0,47.3862,-122.029,1680,6995,8736,8675,1820,25,25
3,2.5,2630,10131,2,0,0,3,9,2630,0,47.7695,-122.259,2800,10123,12761,12923,2630,30,30
4,4,2790,16117,2,0,0,4,9,2790,0,47.6033,-122.155,2740,25369,18907,28109,2790,20,20
3,1.75,1100,10005,1,0,0,5,7,1100,0,47.5374,-122.173,1340,9709,11105,11049,1100,55,55
3,2.5,1530,1131,3,0,0,3,8,1530,0,47.6993,-122.346,1530,1445,2661,2975,1530,10,10
3,1.5,1220,9000,1,0,0,4,7,1220,0,47.3642,-122.109,1220,9472,10220,10692,1220,51,51
4,2.5,2660,8027,2,0,0,3,8,2660,0,47.4831,-121.781,2480,8095,10687,10575,2660,22,22
2,1.5,1260,5100,1,0,0,3,7,1260,0,47.6914,-122.288,1640,5100,6360,6740,1260,78,78
5,2.5,3370,5092,2,0,0,3,7,3370,0,47.3594,-122.036,2910,5092,8462,8002,3370,13,13
4,2.5,2360,81892,1,0,0,3,8,2360,0,47.369,-122.156,1730,18096,84252,19826,2360,19,19
5,3.25,3760,9792,2,0,0,3,9,2550,1210,47.5654,-122.115,2960,16500,13552,19460,3760,35,35
3,2.5,2550,7709,2,0,0,3,9,2550,0,47.3081,-122.391,2410,9250,10259,11660,2550,30,30
3,2,2240,11250,1,0,0,3,8,2240,0,47.6371,-122.119,2200,12500,13490,14700,2240,51,51
4,2,1960,2166,1,0,0,4,7,1260,700,47.6545,-122.344,1670,4000,4126,5670,1960,93,93
4,2.75,2270,24237,1,0,0,4,7,1360,910,47.4672,-122.175,2050,8016,26507,10066,2270,42,42
5,2.5,2803,8550,1,0,0,3,8,2803,0,47.3032,-122.306,1810,8550,11353,10360,2803,56,4
4,1,1200,7552,1,0,0,3,6,1060,140,47.5317,-122.37,1580,7680,8752,9260,1200,100,100
3,2.25,1352,1694,3,0,0,3,8,1352,0,47.7265,-122.315,1439,1387,3046,2826,1352,12,12
4,3,3080,10757,2,0,3,5,8,3080,0,47.5671,-122.159,2810,10757,13837,13567,3080,58,58
5,2,2900,11970,2,0,0,4,7,2900,0,47.741,-122.095,1260,12398,14870,13658,2900,50,50
4,2.25,2270,8480,1,0,0,5,8,1310,960,47.5448,-122.174,1910,9050,10750,10960,2270,46,46
3,2.5,2790,21043,2,0,0,3,9,2790,0,47.673,-122.03,2900,34589,23833,37489,2790,26,26
3,1,1240,4000,1,0,0,3,8,1240,0,47.5467,-122.359,1200,17707,5240,18907,1240,91,15
3,2.25,2130,8466,1,0,0,3,7,1290,840,47.4537,-122.211,2250,9682,10596,11932,2130,36,36
4,3,3220,8936,2,0,0,3,9,2450,770,47.4208,-122.213,2810,10500,12156,13310,3220,29,29
4,2.25,2070,8893,2,0,0,4,8,2070,0,47.4388,-122.162,2390,7700,10963,10090,2070,33,33
3,2.75,1720,28000,1,0,0,4,7,1720,0,47.4375,-122.176,2000,41817,29720,43817,1720,61,61
4,2.5,2550,10623,2,0,0,3,9,2550,0,47.5695,-121.992,2750,8100,13173,10850,2550,27,27
2,1.5,1200,6380,1,0,0,3,7,1200,0,47.697,-122.319,1290,6598,7580,7888,1200,90,90
3,1.75,2080,5200,1,0,0,3,7,1040,1040,47.4738,-122.35,1410,6550,7280,7960,2080,45,45
4,2.5,2495,5751,2,0,0,3,7,2495,0,47.7243,-121.957,2490,6300,8246,8790,2495,17,17
4,1,1220,7980,1,0,0,3,6,1220,0,47.4924,-122.237,1210,7920,9200,9130,1220,75,75
2,1,900,23000,1,0,0,2,7,900,0,47.3576,-122.156,1460,8265,23900,9725,900,66,66
4,2.75,1930,3840,1,0,0,3,7,1170,760,47.5303,-122.346,1610,3840,5770,5450,1930,22,22
4,1.75,2400,7700,1,0,0,4,7,1500,900,47.7125,-122.332,1530,7700,10100,9230,2400,92,92
3,1.75,1850,8667,1,0,0,4,7,880,970,47.7025,-122.198,1450,10530,10517,11980,1850,37,37
4,2.5,2990,5280,2,0,0,3,9,2210,780,47.5353,-122.066,2990,6299,8270,9289,2990,16,16
3,2.5,1510,6095,2,0,0,4,7,1510,0,47.3498,-122.037,1520,6000,7605,7520,1510,28,28
3,1.75,2050,11313,1,0,0,3,7,1520,530,47.2837,-122.358,1620,8065,13363,9685,2050,32,32
4,3.5,3770,47480,2,0,0,3,9,3770,0,47.3552,-121.99,3380,42689,51250,46069,3770,16,16
3,1.5,1460,15000,1,0,0,3,7,1460,0,47.3182,-122.271,1510,15000,16460,16510,1460,53,53
3,2,1770,7251,1,0,0,4,8,1770,0,47.4087,-122.17,2560,7210,9021,9770,1770,29,29
6,3,2960,5000,1,0,0,3,8,1790,1170,47.6971,-122.341,1280,1251,7960,2531,2960,51,51
3,3.5,3950,111078,1,0,0,3,9,2460,1490,47.697,-122.072,2480,88500,115028,90980,3950,30,30
3,3,3040,5067,3,0,2,3,10,3040,0,47.5409,-122.267,1820,5998,8107,7818,3040,26,26
3,1,1090,7400,1,0,0,4,7,1090,0,47.2923,-122.19,1140,8165,8490,9305,1090,57,57
4,2.5,4570,74487,2,0,4,5,12,4570,0,47.7282,-122.372,3810,74487,79057,78297,4570,71,29
4,2.5,2680,8062,1,0,3,4,7,1530,1150,47.4132,-122.328,1920,8600,10742,10520,2680,52,52
3,1.75,1760,26055,1,0,0,3,7,920,840,47.3664,-122.1,1350,13475,27815,14825,1760,40,40
3,2.5,2313,5700,2,0,0,3,9,2313,0,47.3572,-122.202,2323,5701,8013,8024,2313,8,8
2,1.5,1340,1210,2,0,0,3,8,1120,220,47.588,-122.305,1340,1213,2550,2553,1340,11,11
4,2,2660,8160,1,0,0,4,7,1380,1280,47.7229,-122.359,1660,8160,10820,9820,2660,70,70
2,1,990,8250,1,0,0,3,7,990,0,47.7252,-122.331,1080,8168,9240,9248,990,64,64
3,2.5,2290,3475,2,0,0,3,9,2290,0,47.5551,-122.001,2340,3626,5765,5966,2290,13,13
3,1.75,2040,273556,1,0,0,3,7,2040,0,47.4361,-122.469,1790,273556,275596,275346,2040,22,22
4,2.5,2040,21781,2,0,0,3,8,2040,0,47.6458,-121.904,2410,21781,23821,24191,2040,25,25
4,3,2320,7200,2,0,0,3,7,2320,0,47.7703,-122.312,2050,10000,9520,12050,2320,43,43
2,1.5,1790,4250,1,0,0,3,7,920,870,47.6367,-122.301,1910,4250,6040,6160,1790,104,0
4,2,2260,6000,1,0,0,3,8,1430,830,47.6876,-122.298,2030,5874,8260,7904,2260,61,61
4,3.5,3350,3752,2,0,0,3,9,2550,800,47.6782,-122.365,1050,4960,7102,6010,3350,12,12
2,2.5,1390,1302,2,0,0,3,7,1390,0,47.3081,-122.329,1390,2052,2692,3442,1390,32,32
4,2.5,2990,5342,2,0,0,3,8,2990,0,47.6124,-122.009,2990,5936,8332,8926,2990,15,15
2,1,920,5000,1,0,0,4,6,490,430,47.7008,-122.338,1500,5000,5920,6500,920,70,70
3,2.5,1570,3143,2,0,0,3,7,1570,0,47.7364,-121.969,1740,3591,4713,5331,1570,18,18
3,2.25,1970,7210,1,0,0,4,8,1380,590,47.3821,-122.171,1970,7350,9180,9320,1970,41,41
3,1.75,1840,7350,1,0,0,3,8,1310,530,47.7089,-122.23,1860,7000,9190,8860,1840,43,43
4,2.5,2800,28254,2,0,0,3,9,2800,0,47.3552,-122.063,2530,4694,31054,7224,2800,18,18
3,1.75,1100,7224,1,0,0,3,7,1100,0,47.3717,-122.277,1700,8447,8324,10147,1100,38,38
3,1.75,1680,2552,1,0,0,4,7,840,840,47.6848,-122.391,1220,3880,4232,5100,1680,67,67
3,2.5,2110,4099,2,0,0,3,8,2110,0,47.7508,-122.17,2110,4871,6209,6981,2110,18,18
3,3.25,2640,16090,1,0,2,4,8,1960,680,47.5374,-122.213,3690,15000,18730,18690,2640,43,43
3,1,1020,6120,1,0,0,3,7,1020,0,47.6787,-122.285,2370,6695,7140,9065,1020,78,78
3,1.75,1680,8725,1,0,0,3,8,1240,440,47.3107,-122.397,2020,8352,10405,10372,1680,41,41
3,3,3450,16200,2,0,0,3,10,3450,0,47.6319,-122.041,3130,12150,19650,15280,3450,36,36
3,2.5,2750,35440,2,0,0,3,9,2750,0,47.4745,-121.723,2710,35440,38190,38150,2750,25,25
5,2.5,3597,4972,2,0,0,3,7,3597,0,47.3002,-122.282,3193,6000,8569,9193,3597,13,13
4,1,1220,5120,1,0,0,5,6,1220,0,47.205,-121.996,1540,7670,6340,9210,1220,79,79
3,1.5,1640,8922,1,0,0,4,7,1640,0,47.495,-122.342,1540,9040,10562,10580,1640,56,56
3,2.5,2020,4845,2,0,0,3,7,2020,0,47.3848,-122.033,1930,5134,6865,7064,2020,18,18
3,2.25,1660,6000,1,0,0,3,7,1110,550,47.6113,-122.297,1440,4080,7660,5520,1660,40,40
1,1,830,3200,1,0,0,3,7,830,0,47.6557,-122.348,1350,2512,4030,3862,830,95,95
3,1,1100,10125,1,0,0,3,7,1100,0,47.367,-122.107,1570,10650,11225,12220,1100,50,50
2,1,1120,4284,1,0,0,3,6,730,390,47.6688,-122.324,2050,4160,5404,6210,1120,98,98
3,1,940,8400,1,0,0,5,7,940,0,47.5112,-122.167,950,8400,9340,9350,940,61,61
2,1,760,5240,1,0,0,3,6,760,0,47.388,-122.234,980,5080,6000,6060,760,70,70
3,2,1010,2820,1,0,0,3,7,1010,0,47.6066,-122.304,1330,3000,3830,4330,1010,114,114
3,1.5,2220,4830,2,0,3,3,9,1790,430,47.5825,-122.4,1670,4830,7050,6500,2220,91,5
3,2,1800,11419,1,0,0,3,8,1800,0,47.2623,-122.217,2220,11406,13219,13626,1800,30,30
4,1.75,1420,5382,1,0,0,5,5,1040,380,47.4946,-122.187,1150,5382,6802,6532,1420,77,77
3,2.5,3080,12476,2,0,0,3,10,3080,0,47.3752,-122.029,3130,13631,15556,16761,3080,29,29
3,2.25,2520,212137,2,0,0,3,9,1590,930,47.7384,-121.878,2000,212137,214657,214137,2520,14,14
3,2.5,1370,1911,2,0,0,3,9,1370,0,47.6375,-122.354,1630,2090,3281,3720,1370,112,3
4,3.5,4460,16271,2,0,2,3,11,4460,0,47.5862,-121.97,4540,17122,20731,21662,4460,18,18
3,2.5,1520,3041,2,0,0,3,7,1520,0,47.4874,-122.152,1820,3229,4561,5049,1520,10,10
3,2.5,3120,12406,2,0,2,3,9,1940,1180,47.5507,-122.141,3240,13141,15526,16381,3120,36,36
3,2,1410,10078,1,0,0,4,6,1410,0,47.7587,-122.144,2090,9202,11488,11292,1410,36,36
3,2.75,1960,2500,1,0,0,5,7,1410,550,47.6744,-122.353,2040,5000,4460,7040,1960,93,93
3,1,1660,8800,1,0,0,4,7,960,700,47.3212,-122.352,1370,10112,10460,11482,1660,56,56
4,1.75,1580,9382,1,0,0,3,7,1080,500,47.6353,-122.232,2010,9382,10962,11392,1580,56,56
4,5,6055,21630,1,0,3,4,12,3555,2500,47.5524,-122.112,4890,19223,27685,24113,6055,23,23
4,2.5,2880,8833,2,0,0,3,7,2880,0,47.5388,-121.89,2570,5234,11713,7804,2880,13,13
4,2.5,2530,7563,1,0,0,3,7,1440,1090,47.7762,-122.21,1960,7811,10093,9771,2530,41,41
4,1.5,2120,8554,1,0,0,4,7,1170,950,47.2933,-122.195,1790,8554,10674,10344,2120,42,42
3,2.5,2040,10086,2,0,0,3,8,2040,0,47.679,-122.113,1940,10272,12126,12212,2040,32,32
3,2.25,2680,100188,2,0,0,4,8,1580,1100,47.4776,-122.02,2540,60548,102868,63088,2680,41,41
5,1.5,2170,8610,1,0,0,4,7,1230,940,47.6111,-122.126,1670,8610,10780,10280,2170,60,60
5,4,1400,8580,1,0,0,5,7,900,500,47.456,-122.292,1220,8832,9980,10052,1400,65,65
3,1,1020,12289,1,0,0,4,7,1020,0,47.4235,-122.155,1300,9894,13309,11194,1020,52,52
4,2.25,1780,6120,1,0,0,3,8,1310,470,47.6955,-122.287,1780,6120,7900,7900,1780,68,68
4,2.75,2900,5803,2,0,0,3,9,2900,0,47.7368,-122.232,2900,6212,8703,9112,2900,12,12
3,1.75,1610,7200,1,0,0,3,7,1180,430,47.5966,-122.144,1520,7973,8810,9493,1610,43,43
4,3,3330,7650,1,0,0,3,9,1830,1500,47.6889,-122.352,1200,3876,10980,5076,3330,11,11
3,1.5,1290,1286,3,0,0,3,7,1290,0,47.6617,-122.349,1720,1286,2576,3006,1290,19,19
2,1,940,7700,1,0,0,4,6,940,0,47.7067,-122.354,1290,7375,8640,8665,940,103,103
4,2.5,2310,5813,2,0,0,3,8,2310,0,47.5107,-122.362,1830,7200,8123,9030,2310,5,5
4,2.5,2930,7806,2,0,0,3,9,2930,0,47.6219,-122.024,2600,6051,10736,8651,2930,14,14
3,1.75,1570,12506,1,0,0,4,8,1570,0,47.3365,-122.319,2120,13243,14076,15363,1570,60,60
4,1.75,1880,8800,1,0,0,3,7,1130,750,47.5137,-122.333,1340,8733,10680,10073,1880,59,59
2,1,1070,4200,1,0,0,4,6,1070,0,47.3336,-122.215,1150,4200,5270,5350,1070,36,36
3,1.75,1470,8645,1,0,0,3,6,1470,0,47.7524,-122.323,1470,7680,10115,9150,1470,70,70
3,1.75,1790,50529,1,0,0,5,7,1090,700,47.3511,-122.073,1940,50529,52319,52469,1790,54,54
2,1,890,2100,1,0,0,4,6,760,130,47.656,-122.359,1600,4250,2990,5850,890,100,100
4,1.75,2000,3728,1,0,0,4,9,1820,180,47.643,-122.299,1950,3728,5728,5678,2000,93,93
4,2.5,2500,11070,1,0,2,4,8,1300,1200,47.336,-122.334,2500,11070,13570,13570,2500,55,55
3,2.5,2200,4544,2,0,0,3,8,2200,0,47.5319,-121.867,2400,5431,6744,7831,2200,19,19
2,1,790,7153,1,0,0,4,6,790,0,47.4869,-122.324,810,7128,7943,7938,790,75,75
2,1,1140,5400,1,0,0,5,7,1140,0,47.6205,-122.294,1520,4800,6540,6320,1140,111,111
4,1,1120,2685,1,0,0,3,5,860,260,47.4904,-122.203,1120,4838,3805,5958,1120,80,80
4,2.5,2630,6283,2,0,0,3,9,2630,0,47.5079,-122.158,2630,7210,8913,9840,2630,13,13
3,2,2350,12480,1,0,0,3,7,1600,750,47.7661,-122.262,2160,12000,14830,14160,2350,38,38
2,1,920,5157,1,0,0,3,6,920,0,47.5499,-122.269,1700,5150,6077,6850,920,110,110
3,2.25,2820,8100,1,0,0,4,7,1720,1100,47.4944,-122.304,1040,8100,10920,9140,2820,72,72
2,1.5,1260,6660,1,0,0,4,7,1260,0,47.6792,-122.287,2140,4770,7920,6910,1260,93,93
3,2.5,1620,7320,2,0,0,3,7,1620,0,47.3617,-122.054,1550,7686,8940,9236,1620,30,30
5,2.75,3300,7560,2,0,0,3,10,3300,0,47.6467,-122.118,3150,8580,10860,11730,3300,12,12
5,2.5,1900,9460,1,0,0,3,7,1190,710,47.7096,-122.202,1940,8360,11360,10300,1900,50,50
5,4.25,4050,18827,1,0,2,4,10,2150,1900,47.5323,-122.237,3600,25120,22877,28720,4050,40,40
3,3.5,1690,1432,2,0,0,3,7,1360,330,47.6513,-122.4,1650,2788,3122,4438,1690,11,11
3,1.75,1300,10030,1,0,0,4,7,1300,0,47.7359,-122.192,1520,7713,11330,9233,1300,52,52
3,1.75,1760,6300,1,0,0,3,7,1060,700,47.5003,-122.26,1340,7300,8060,8640,1760,56,56
3,1.75,1380,7350,1,0,0,3,7,990,390,47.369,-122.093,1660,8400,8730,10060,1380,38,38
4,2.25,1750,6120,1,0,0,3,7,1150,600,47.6958,-122.29,1350,6120,7870,7470,1750,57,57
3,2,1790,32379,1,0,0,3,7,1790,0,47.4826,-121.698,2290,43560,34169,45850,1790,12,12
3,1,1030,6127,1,0,0,3,7,880,150,47.7192,-122.32,1610,6127,7157,7737,1030,72,72
3,1.75,1960,7705,1,0,0,4,7,980,980,47.53,-122.347,1380,4349,9665,5729,1960,69,69
4,2.5,1900,4054,2,0,0,3,7,1900,0,47.3767,-122.124,2520,4085,5954,6605,1900,16,16
3,2.25,1740,9682,1,0,0,5,8,1740,0,47.5138,-122.173,2100,9536,11422,11636,1740,50,50
3,1.75,1560,7930,2,0,0,4,7,1560,0,47.4779,-122.161,1720,8073,9490,9793,1560,39,39
5,3.5,3080,7759,2,0,0,3,8,2310,770,47.7454,-121.977,2980,8223,10839,11203,3080,16,16
3,1,1660,6992,1,0,0,5,7,1260,400,47.7576,-122.318,1390,7359,8652,8749,1660,67,67
5,1.5,2050,9360,1,0,0,3,7,1520,530,47.436,-122.195,1840,9383,11410,11223,2050,51,51
0,2.5,1810,5669,2,0,0,3,7,1810,0,47.3493,-122.053,1810,5685,7479,7495,1810,16,16
4,2.75,2390,9650,1,0,2,3,8,1620,770,47.3438,-122.322,2390,10000,12040,12390,2390,43,43
4,1.75,1960,9300,1,0,0,5,7,1340,620,47.4487,-121.772,1500,9752,11260,11252,1960,40,40
4,2.75,5440,239580,1,0,0,2,9,2720,2720,47.354,-122.293,1970,40392,245020,42362,5440,50,50
3,1.75,2259,26831,1,0,3,5,7,1491,768,47.2741,-122.266,1980,15794,29090,17774,2259,111,111
2,1,2160,2192,1,0,0,5,8,1170,990,47.6364,-122.371,1150,2152,4352,3302,2160,94,94
3,1.5,1750,32500,1,0,0,4,7,1750,0,47.5316,-121.959,1820,102801,34250,104621,1750,53,53
3,1.75,1340,63597,1,0,0,4,7,1340,0,47.4379,-122.011,1950,87120,64937,89070,1340,56,56
3,2.5,2210,10119,1,0,0,4,7,1450,760,47.3783,-122.22,2110,10119,12329,12229,2210,53,53
3,2,1250,1306,3,0,0,3,7,1250,0,47.6705,-122.39,1320,1306,2556,2626,1250,19,19
3,2.25,1440,10500,1,0,0,3,8,1130,310,47.318,-122.391,1510,8125,11940,9635,1440,36,36
5,2.5,2340,5670,2,0,0,3,7,2340,0,47.4913,-122.152,2190,4869,8010,7059,2340,10,10
5,2,2300,7897,2,0,0,4,8,2300,0,47.7556,-122.356,2030,7902,10197,9932,2300,63,63
3,2.5,1810,1988,2,0,0,3,7,1350,460,47.6513,-122.385,1600,1525,3798,3125,1810,22,22
3,1.75,1890,5000,1,0,0,3,7,1890,0,47.3357,-122.175,2960,5421,6890,8381,1890,16,16
3,3.25,3230,5000,2,0,0,3,9,3230,0,47.5558,-122.002,2670,3977,8230,6647,3230,13,13
4,1,3410,5000,2,0,0,5,8,2190,1220,47.5807,-122.291,2550,5000,8410,7550,3410,109,109
4,1.5,1100,9600,1,0,0,4,6,1100,0,47.7,-122.175,1100,9630,10700,10730,1100,59,59
4,3.75,3370,6766,2,0,0,3,9,3370,0,47.7063,-122.106,3530,6766,10136,10296,3370,14,14
4,1.75,2140,8162,1,0,0,3,7,1420,720,47.3096,-122.377,2040,7632,10302,9672,2140,51,51
4,3,2090,7500,1,0,0,3,7,1370,720,47.4888,-122.182,1810,7650,9590,9460,2090,33,33
3,2,1640,9750,1,0,0,3,7,1640,0,47.7425,-122.241,1340,9750,11390,11090,1640,60,60
4,2,1400,4800,2,0,0,3,7,1400,0,47.6168,-122.298,1620,2595,6200,4215,1400,33,33
3,2.5,2110,8304,1,0,0,4,7,2110,0,47.3558,-122.173,1680,7508,10414,9188,2110,34,34
3,3.25,3680,7650,2,0,0,3,9,2340,1340,47.6272,-122.033,2280,8515,11330,10795,3680,31,31
3,1,1330,5850,1,0,0,3,7,930,400,47.5498,-122.298,1440,5850,7180,7290,1330,65,65
3,2.25,1350,6775,1,0,0,3,7,930,420,47.3593,-122.289,1460,7210,8125,8670,1350,38,38
5,3.5,4410,13000,2,0,3,3,10,2920,1490,47.5382,-122.111,5790,12969,17410,18759,4410,5,5
3,2.25,1520,1245,3,0,0,3,8,1520,0,47.6907,-122.34,1520,1470,2765,2990,1520,15,15
5,2.75,2530,7601,1,0,0,3,7,1520,1010,47.4683,-122.263,2400,7776,10131,10176,2530,27,27
3,1,1000,8470,1,0,0,4,6,1000,0,47.3056,-122.37,1020,8470,9470,9490,1000,56,56
4,1.75,2150,9000,1,0,0,4,7,1110,1040,47.6812,-122.113,2040,9000,11150,11040,2150,53,53
2,1,860,8189,1,0,0,3,6,860,0,47.735,-122.306,1180,8189,9049,9369,860,71,71
3,2.5,2530,43733,2,0,0,3,8,1530,1000,47.46,-121.708,1730,43548,46263,45278,2530,28,28
4,1.75,2550,39460,1,0,0,3,8,1890,660,47.7707,-122.123,2560,38638,42010,41198,2550,37,37
4,2.5,2150,3721,2,0,0,3,8,2150,0,47.3363,-122.217,2150,3721,5871,5871,2150,13,13
3,2.5,2310,11993,2,0,0,3,9,2310,0,47.5438,-122.139,2830,10031,14303,12861,2310,31,31
4,1.75,1370,9993,1,0,0,3,6,1370,0,47.7572,-122.228,1650,11592,11363,13242,1370,101,101
3,2.5,1920,1896,3,0,3,3,8,1920,0,47.6616,-122.356,1670,2994,3816,4664,1920,19,19
2,0.75,890,19703,1,0,0,3,6,890,0,47.4922,-121.783,1270,9800,20593,11070,890,85,85
4,2.5,2870,5118,2,0,0,3,9,2870,0,47.5544,-121.99,2940,4800,7988,7740,2870,13,13
4,2.5,2580,7465,2,0,0,3,8,2580,0,47.6319,-122.022,2350,7596,10045,9946,2580,26,26
4,2.75,2900,17400,1,0,0,4,8,2410,490,47.6431,-122.108,2620,12240,20300,14860,2900,41,41
2,1,870,5400,1,0,0,3,6,870,0,47.52,-122.374,990,5200,6270,6190,870,69,7
5,3.25,3340,4900,2,0,2,3,9,2500,840,47.5193,-121.877,3220,5200,8240,8420,3340,5,5
3,1.75,1850,10920,1,0,0,3,6,1850,0,47.7244,-122.222,1510,7871,12770,9381,1850,104,104
4,3.25,3080,4120,2,0,0,3,9,2380,700,47.6845,-122.359,1410,4120,7200,5530,3080,5,5
4,1.5,1410,10648,1,0,0,4,7,1410,0,47.3736,-122.188,1410,10522,12058,11932,1410,53,53
3,2.5,2100,2200,2,0,0,4,7,1500,600,47.614,-122.294,1750,4400,4300,6150,2100,100,100
3,1,1440,4268,1,0,0,3,7,1040,400,47.5468,-122.293,1370,4268,5708,5638,1440,66,66
2,1,1150,7552,1,0,0,3,7,1150,0,47.7215,-122.323,1150,7346,8702,8496,1150,68,68
3,2.75,1990,19991,1,0,0,3,7,1340,650,47.7434,-122.106,1750,9775,21981,11525,1990,42,42
4,2.5,3370,10602,2,0,0,3,10,3370,0,47.6591,-122.147,2950,9949,13972,12899,3370,20,20
3,2.5,2670,10481,2,0,0,3,9,2670,0,47.6673,-122.176,2620,8895,13151,11515,2670,16,16
3,2,1190,4072,1,0,0,5,6,1190,0,47.5276,-122.274,1680,5850,5262,7530,1190,112,112
3,1.75,1870,12381,1,0,0,4,8,1870,0,47.3358,-122.32,1950,12667,14251,14617,1870,62,62
4,2.5,2400,7270,2,0,0,3,8,2400,0,47.2697,-122.312,2150,6584,9670,8734,2400,26,26
3,2.25,1830,7651,2,0,0,3,8,1830,0,47.2642,-122.219,2160,8442,9481,10602,1830,33,33
2,1,1100,8281,1,0,0,4,7,1100,0,47.7414,-122.315,1510,8281,9381,9791,1100,72,72
4,1,1530,7920,1,0,0,3,7,1030,500,47.4544,-122.36,1690,7920,9450,9610,1530,64,64
3,3.5,2300,5611,1,0,0,3,8,2300,0,47.7122,-122.026,2170,5926,7911,8096,2300,15,15
4,2.5,1980,6568,2,0,0,3,8,1980,0,47.704,-122.101,2310,6496,8548,8806,1980,15,15
4,2.5,2110,35091,1,0,0,4,8,1290,820,47.467,-122.014,2740,36427,37201,39167,2110,34,34
3,2.5,2370,11172,2,0,0,3,9,2370,0,47.5345,-122.179,2550,11558,13542,14108,2370,26,26
3,2.5,1720,3676,2,0,0,3,7,1720,0,47.4039,-122.188,1720,3510,5396,5230,1720,27,27
4,2.5,2310,5573,2,0,0,4,9,2310,0,47.5197,-122.2,2310,6189,7883,8499,2310,16,16
3,2.5,1900,3255,2,0,0,3,8,1900,0,47.6075,-122.147,1880,3350,5155,5230,1900,31,14
4,3.5,2100,7560,2,0,0,5,8,2100,0,47.7076,-122.356,1250,7560,9660,8810,2100,14,14
3,2,1730,12219,1,0,0,4,7,1730,0,47.5825,-122.189,2470,13594,13949,16064,1730,33,33
4,2.75,1960,8937,1,0,0,5,7,980,980,47.451,-122.278,1480,10016,10897,11496,1960,65,65
4,1.5,1890,6938,1,0,0,3,8,1890,0,47.5896,-122.389,1700,6250,8828,7950,1890,100,100
3,2,1270,1333,3,0,0,3,8,1270,0,47.6933,-122.342,1330,1333,2603,2663,1270,13,13
3,1.75,2000,14733,1,0,0,4,8,2000,0,47.6001,-122.178,2620,14733,16733,17353,2000,61,61
3,2.5,1365,1090,3,0,0,3,7,1315,50,47.6776,-122.324,1360,1124,2455,2484,1365,16,16
3,2.5,1408,989,3,0,0,3,8,1408,0,47.6856,-122.315,1408,1342,2397,2750,1408,14,14
3,2.5,1920,4480,2,0,1,3,9,1920,0,47.6472,-122.373,1790,4500,6400,6290,1920,70,18
3,2.5,1600,2231,2,0,0,3,7,1600,0,47.3314,-122.29,1600,2962,3831,4562,1600,16,16
4,2.5,2930,8679,2,0,0,3,8,2930,0,47.5164,-122.19,2030,7264,11609,9294,2930,5,5
4,2,1720,5413,2,0,0,3,7,1470,250,47.6929,-122.321,1510,5413,7133,6923,1720,81,35
3,2,1270,1320,3,0,0,3,8,1270,0,47.6937,-122.342,1370,1320,2590,2690,1270,13,13
3,2.5,2120,196995,1,0,1,3,9,2120,0,47.4089,-122.459,1304,92423,199115,93727,2120,22,22
4,2.5,4250,19387,2,0,2,4,9,3260,990,47.5578,-122.212,3690,17024,23637,20714,4250,47,47
2,1.5,1930,3521,2,0,0,3,8,1930,0,47.6092,-122.146,1840,3576,5451,5416,1930,30,30
2,1,730,5200,1,0,0,3,6,730,0,47.4943,-122.337,1220,6240,5930,7460,730,91,91
4,2.5,2223,5780,2,0,0,3,8,2223,0,47.3586,-122.157,1690,7766,8003,9456,2223,9,9
3,2.5,2810,7700,2,0,0,3,9,2810,0,47.5464,-122.191,2910,8250,10510,11160,2810,18,18
2,1,940,5000,1,0,0,3,7,940,0,47.7518,-122.279,1800,7400,5940,9200,940,69,69
3,1.75,1150,9600,1,0,0,3,7,1150,0,47.4434,-121.774,1520,9976,10750,11496,1150,40,40
4,2.5,3080,4553,2,0,0,3,8,3080,0,47.7066,-122.112,2750,4929,7633,7679,3080,11,11
2,2,920,1201,2,0,0,3,8,800,120,47.5926,-122.295,1150,1161,2121,2311,920,10,10
2,1,2020,7540,1,0,0,3,7,1010,1010,47.5359,-122.28,1270,4652,9560,5922,2020,98,98
4,2.25,2470,8686,1,0,0,4,7,1270,1200,47.4371,-122.166,1900,7350,11156,9250,2470,45,45
4,2,1790,61419,2,0,2,2,7,1790,0,47.7216,-121.907,1790,62290,63209,64080,1790,31,31
3,2.25,1470,2500,2,0,0,3,8,1080,390,47.6762,-122.36,1640,4300,3970,5940,1470,35,35
3,2.5,1950,3600,2,0,0,3,7,1950,0,47.3658,-122.021,1870,4184,5550,6054,1950,9,9
4,2.5,1660,2500,2,0,0,3,7,1660,0,47.5437,-122.283,1030,5000,4160,6030,1660,12,12
3,2.25,1720,9000,1,0,0,4,8,1320,400,47.3191,-122.383,1930,8000,10720,9930,1720,50,50
4,2.5,2110,3825,2,0,0,3,7,2110,0,47.359,-122.082,1950,3825,5935,5775,2110,6,6
5,2,1600,4168,1,0,0,3,7,1600,0,47.5297,-122.381,1190,4168,5768,5358,1600,92,92
3,3,1520,1800,3,0,0,3,7,1520,0,47.6822,-122.326,1520,1500,3320,3020,1520,16,16
4,2.5,2040,4443,2,0,0,3,8,2040,0,47.3182,-122.189,2040,4637,6483,6677,2040,18,18
4,2.5,2100,7355,1,0,0,5,7,2100,0,47.5078,-122.161,1750,7200,9455,8950,2100,50,50
2,1,1060,6120,1,0,0,3,7,1060,0,47.6739,-122.329,1730,4080,7180,5810,1060,111,111
3,1.75,1950,52256,1,0,0,4,8,1950,0,47.3133,-122.078,2450,51836,54206,54286,1950,34,34
3,2.5,2420,7307,2,0,0,3,7,2420,0,47.5361,-121.871,2420,5577,9727,7997,2420,21,21
3,2.5,3200,203425,1,0,0,3,10,3200,0,47.7614,-122.015,3200,203425,206625,206625,3200,19,19
3,1.75,1490,8000,1,0,0,4,7,1200,290,47.3187,-122.18,1540,8000,9490,9540,1490,41,41
5,4.5,5160,44315,2,0,0,3,12,5160,0,47.6568,-122.154,4760,44315,49475,49075,5160,23,23
3,2.5,2450,19744,2,0,0,3,10,2450,0,47.3746,-122.026,2650,19597,22194,22247,2450,29,29
4,2.5,3010,9323,2,0,0,3,10,3010,0,47.578,-122.053,2840,8413,12333,11253,3010,27,27
3,1.5,1450,9477,1,0,0,4,7,1450,0,47.4215,-122.203,1460,9477,10927,10937,1450,56,56
3,1,1010,8906,1,0,0,5,7,1010,0,47.3627,-122.108,1150,10414,9916,11564,1010,51,51
3,1.75,1560,7245,1,0,0,3,7,1560,0,47.6868,-122.119,2220,8502,8805,10722,1560,57,29
3,2,2190,5400,1,0,2,5,7,1260,930,47.6737,-122.4,2160,5400,7590,7560,2190,67,67
3,2.25,1310,12825,1,0,0,3,7,1310,0,47.4515,-122.368,1600,11250,14135,12850,1310,69,1
2,1.5,1240,1055,2,0,0,3,8,1200,40,47.6104,-122.112,1410,1340,2295,2750,1240,52,52
3,1,970,9600,1,0,0,3,7,970,0,47.4451,-121.768,1110,9600,10570,10710,970,47,47
4,1.5,1400,8500,2,0,0,3,7,1400,0,47.3314,-122.275,1580,7650,9900,9230,1400,44,44
4,1.75,2290,4400,1,0,3,3,7,1290,1000,47.5698,-122.375,1820,4000,6690,5820,2290,60,60
4,2.5,1880,3853,2,0,0,3,8,1880,0,47.5636,-122.094,1890,3078,5733,4968,1880,9,9
2,1,960,8236,1,0,0,2,6,960,0,47.4698,-122.166,1260,8236,9196,9496,960,71,71
3,3.5,1890,1710,2,0,0,3,8,1640,250,47.6592,-122.349,1680,1562,3600,3242,1890,20,20
4,1,1420,6000,1,0,0,3,7,1420,0,47.6844,-122.302,1420,6180,7420,7600,1420,69,69
3,1.75,1550,9720,1,0,0,3,7,1050,500,47.3433,-122.037,1550,9750,11270,11300,1550,43,43
2,1,1040,7372,1,0,0,5,7,840,200,47.5285,-122.378,1930,5150,8412,7080,1040,80,80
4,1.75,2460,10061,1,1,4,3,7,1410,1050,47.5105,-122.238,2300,10061,12521,12361,2460,58,58
3,2,1660,7509,1,0,0,3,7,1660,0,47.4872,-122.144,2380,8598,9169,10978,1660,17,17
4,3.5,4200,14353,2,0,2,3,12,3640,560,47.5331,-122.217,3750,16316,18553,20066,4200,23,23
3,1.75,2010,3090,1,0,0,5,7,1510,500,47.682,-122.348,1600,3150,5100,4750,2010,93,93
2,1,1170,8925,1,0,2,3,6,1170,0,47.4017,-122.321,1380,7440,10095,8820,1170,108,108
3,1,1130,4100,1,0,0,3,7,990,140,47.6856,-122.385,1800,4100,5230,5900,1130,78,78
4,2.25,2270,5102,1,0,0,5,8,1340,930,47.6528,-122.408,1800,5102,7372,6902,2270,65,65
4,2.5,4070,57587,2,0,0,3,10,4070,0,47.6908,-122.052,3890,35960,61657,39850,4070,30,30
2,2.5,1590,1679,2,0,0,3,8,1590,0,47.5449,-122.011,1590,1680,3269,3270,1590,7,7
3,2.5,2140,9897,1,0,0,4,8,2140,0,47.5505,-122.219,2680,10083,12037,12763,2140,60,60
3,1,2000,21780,1,0,0,3,8,1480,520,47.6064,-122.039,2000,45738,23780,47738,2000,41,41
4,2,1400,3600,1,0,0,3,7,1100,300,47.6385,-122.37,1630,2048,5000,3678,1400,119,119
5,2.75,3010,5398,2,0,0,3,9,3010,0,47.6067,-122.053,3360,5407,8408,8767,3010,5,5
3,2.5,2510,9240,2,0,0,4,8,2510,0,47.1896,-122.013,2690,9240,11750,11930,2510,18,18
2,2,1180,2553,2,0,0,3,6,1180,0,47.3501,-122.02,1310,2687,3733,3997,1180,14,14
4,2.75,2790,7803,2,0,0,3,8,2790,0,47.4823,-121.772,2620,6178,10593,8798,2790,6,6
4,1.75,2010,5070,1,0,1,4,7,1300,710,47.5793,-122.402,2180,5400,7080,7580,2010,56,56
3,1.75,2030,9032,2,0,2,4,7,2030,0,47.586,-122.117,2350,8937,11062,11287,2030,56,56
4,2.5,2460,4862,2,0,0,3,8,2460,0,47.7719,-122.235,2900,4895,7322,7795,2460,15,15
4,3,2890,6885,1,0,0,3,7,1590,1300,47.6763,-122.282,2180,6885,9775,9065,2890,74,0
3,1.5,1340,11744,1,0,0,2,7,1340,0,47.4947,-122.36,2020,13673,13084,15693,1340,69,69
4,2.25,1800,2752,2,0,0,3,8,1800,0,47.5167,-122.346,1650,2752,4552,4402,1800,5,5
4,2.5,2100,6783,2,0,0,3,8,2100,0,47.3504,-122.141,2100,6192,8883,8292,2100,16,16
2,1,1330,4140,1,0,0,4,7,930,400,47.6802,-122.306,1410,5100,5470,6510,1330,100,74
4,1.75,2000,10890,1,0,0,4,7,1390,610,47.3203,-122.321,1520,9250,12890,10770,2000,58,58
3,2.5,2370,6752,2,0,0,3,8,2370,0,47.2703,-122.312,1870,7455,9122,9325,2370,25,25
4,2.75,2500,11659,1,0,2,3,9,1490,1010,47.3381,-122.332,2830,9915,14159,12745,2500,40,40
2,1,1150,3775,1,0,0,3,7,1150,0,47.6539,-122.329,2240,3753,4925,5993,1150,102,102
4,2.25,2000,10374,2,0,1,4,7,2000,0,47.3342,-122.34,2170,10374,12374,12544,2000,52,52
4,2,1930,5398,1,0,0,3,7,1430,500,47.646,-122.363,1910,4902,7328,6812,1930,66,66
3,1,1270,6612,1,0,3,3,7,1270,0,47.5433,-122.264,2100,7680,7882,9780,1270,92,92
5,1.75,2020,7902,1,0,0,3,7,1220,800,47.51,-122.327,2220,8819,9922,11039,2020,57,57
5,4.75,6390,13180,2,0,0,3,10,4560,1830,47.6312,-122.291,4010,8137,19570,12147,6390,79,79
3,2.5,2640,432036,1,0,3,3,10,2640,0,47.1795,-122.036,1500,560617,434676,562117,2640,23,23
3,1,920,6612,1,0,0,3,6,920,0,47.548,-122.284,1860,8424,7532,10284,920,71,71
2,1,700,5940,1,0,0,3,7,700,0,47.7289,-122.337,1070,5995,6640,7065,700,71,71
4,2.5,2660,5043,2,0,2,3,9,2660,0,47.5445,-121.996,3010,5500,7703,8510,2660,16,16
4,1.75,1930,7650,1,0,0,4,8,1280,650,47.3078,-122.386,1860,8800,9580,10660,1930,38,38
2,2.25,1100,1695,2,0,0,3,9,1100,0,47.5663,-122.289,1100,3082,2795,4182,1100,10,10
3,1,1860,6360,1,0,0,3,8,1470,390,47.5327,-122.392,1770,6175,8220,7945,1860,65,65
3,2.5,3050,7410,1,0,0,5,8,1950,1100,47.6772,-122.296,1890,5814,10460,7704,3050,69,69
3,2.5,2060,4030,2,0,0,3,7,2060,0,47.3909,-122.238,2060,4029,6090,6089,2060,20,20
3,2.5,2330,3141,2,0,0,3,8,2330,0,47.5622,-122.392,1980,5265,5471,7245,2330,16,16
3,1.75,2340,12443,1,0,0,4,8,2340,0,47.5432,-122.177,1970,9600,14783,11570,2340,54,54
4,3,4410,5104,2,0,0,3,9,3400,1010,47.5392,-121.861,4390,5537,9514,9927,4410,13,13
2,1,860,8250,1,0,0,3,7,860,0,47.7132,-122.334,1780,11200,9110,12980,860,79,79
3,2.5,3200,35012,1,0,0,3,8,2100,1100,47.4651,-121.993,2690,35100,38212,37790,3200,54,54
4,2.5,2460,45738,1,0,0,4,8,1650,810,47.5952,-122.056,2550,32040,48198,34590,2460,50,50
5,2.75,2520,4643,1,0,0,4,8,2120,400,47.6348,-122.301,2100,4564,7163,6664,2520,103,103
4,2.5,2510,6853,2,0,2,3,9,2510,0,47.3547,-122.003,3400,6965,9363,10365,2510,13,13
5,2.5,3780,20000,1,0,1,4,9,1890,1890,47.7603,-122.273,2840,19908,23780,22748,3780,41,41
3,1.75,2350,20820,1,0,0,4,8,1800,550,47.6095,-122.059,2040,10800,23170,12840,2350,41,41
3,1.75,2700,18246,1,0,0,4,7,1510,1190,47.4817,-122.097,1620,16986,20946,18606,2700,52,52
2,1.75,1180,5000,1,0,0,2,7,880,300,47.6749,-122.398,1470,5000,6180,6470,1180,94,94
3,2.75,3010,12432,1,0,0,4,8,1890,1120,47.6392,-122.108,2500,12432,15442,14932,3010,49,49
3,2.5,1650,13816,2,0,0,3,7,1650,0,47.6553,-121.913,1630,18750,15466,20380,1650,21,21
4,1,1040,4420,1,0,0,3,6,1040,0,47.6945,-122.368,1310,4920,5460,6230,1040,75,75
3,1.75,1400,8640,1,0,0,3,7,1400,0,47.7659,-122.204,1630,8640,10040,10270,1400,57,57
4,1.75,2440,7475,1,0,0,4,9,2040,400,47.6339,-122.096,2040,8480,9915,10520,2440,50,50
4,2.75,2310,5000,2,0,0,3,7,2310,0,47.3614,-122.035,1980,5000,7310,6980,2310,13,13
2,1,1290,4650,1,0,0,4,7,1290,0,47.6877,-122.325,1640,3900,5940,5540,1290,113,113
5,2.25,2440,20828,1,0,0,4,8,2440,0,47.3762,-122.158,2670,14472,23268,17142,2440,44,44
2,2.75,1310,1268,3,0,0,3,8,1310,0,47.6534,-122.355,1350,1288,2578,2638,1310,12,12
3,1.75,1480,7700,1,0,0,3,8,1480,0,47.7225,-122.202,1930,8560,9180,10490,1480,44,44
3,1.5,1320,4400,1,0,0,3,6,1320,0,47.6231,-122.292,1350,4400,5720,5750,1320,110,110
5,3,2320,7229,1,0,0,4,8,1370,950,47.697,-122.097,2090,7554,9549,9644,2320,33,33
3,2.5,1750,2150,2,0,0,3,7,1230,520,47.6037,-122.311,1410,3300,3900,4710,1750,119,0
4,2.5,2620,4469,2,0,0,3,7,2620,0,47.3663,-122.115,2250,4500,7089,6750,2620,11,11
3,2.75,2760,8476,1,0,0,4,8,1690,1070,47.5402,-122.215,2610,9835,11236,12445,2760,52,52
4,2.75,2190,14937,2,0,0,3,8,2190,0,47.3535,-122.273,1920,11360,17127,13280,2190,26,26
8,3,2850,12714,1,0,0,3,7,2850,0,47.4859,-122.205,1480,4942,15564,6422,2850,60,60
5,2.5,3000,10560,1,0,0,3,8,1500,1500,47.6249,-122.206,2690,11616,13560,14306,3000,53,53
5,3,3880,8432,2,0,0,3,7,3880,0,47.4806,-122.176,2620,5623,12312,8243,3880,15,15
2,2.25,1330,1380,2,0,0,3,8,1060,270,47.577,-122.41,1580,4802,2710,6382,1330,14,14
3,2.5,2340,3630,2,0,0,3,9,2340,0,47.6059,-122.307,1820,5120,5970,6940,2340,21,21
3,2,1980,3478,1,0,0,4,7,1440,540,47.6775,-122.372,1610,3478,5458,5088,1980,90,90
3,1.75,1140,9800,1,0,0,4,7,1140,0,47.3063,-122.27,1370,9800,10940,11170,1140,51,51
4,2.75,2620,6019,2,0,0,3,8,2620,0,47.484,-121.771,2790,6716,8639,9506,2620,6,6
3,1.75,1830,5488,1,0,2,4,7,1010,820,47.6914,-122.309,1200,5488,7318,6688,1830,80,80
3,1.75,2090,7667,1,0,2,3,7,1200,890,47.7007,-122.312,1480,7666,9757,9146,2090,67,67
3,2.5,2100,15120,1,0,0,4,8,2100,0,47.6201,-122.222,3070,16078,17220,19148,2100,66,66
4,2,2180,6000,1,0,0,3,8,2060,120,47.5958,-122.306,1370,4500,8180,5870,2180,92,92
4,2.5,2240,12032,1,0,0,3,9,2240,0,47.6143,-122.017,2520,12368,14272,14888,2240,36,36
6,3,2020,4129,1,0,0,3,7,1230,790,47.6648,-122.324,2080,4080,6149,6160,2020,25,25
5,3.5,4790,12957,2,0,1,3,9,3110,1680,47.5469,-122.194,2620,13538,17747,16158,4790,14,14
4,4.75,4790,25412,2,0,0,3,12,4790,0,47.603,-122.012,3830,16314,30202,20144,4790,20,20
2,1,620,6600,1,0,0,3,6,620,0,47.4862,-122.33,1050,6600,7220,7650,620,56,56
4,2.25,2350,8140,1,0,0,4,8,1430,920,47.5579,-122.129,2640,8700,10490,11340,2350,42,42
3,1,1120,10665,1,0,0,4,6,1120,0,47.2886,-122.274,1240,10639,11785,11879,1120,58,58
5,2.5,3050,8200,1,0,4,4,8,1650,1400,47.5647,-122.155,2970,8792,11250,11762,3050,57,57
3,2.5,2230,5348,2,0,0,3,8,2230,0,47.5347,-121.866,2190,5205,7578,7395,2230,19,19
4,3.5,6370,205603,2,0,0,3,12,6370,0,47.5016,-121.905,1490,33580,211973,35070,6370,11,11
4,2.25,2240,45738,2,0,0,3,7,2240,0,47.687,-122.047,3180,45738,47978,48918,2240,31,31
3,1.75,2320,6090,2,0,3,3,8,2040,280,47.643,-122.412,3110,7052,8410,10162,2320,80,80
3,1,880,7648,1,0,2,4,6,880,0,47.1963,-121.997,1020,7566,8528,8586,880,79,79
3,1,880,6050,1,0,0,3,6,880,0,47.4995,-122.248,1130,6050,6930,7180,880,74,74
4,1.75,1810,7480,1,0,0,3,7,1230,580,47.3275,-122.361,1870,9594,9290,11464,1810,42,42
3,1,1190,8820,1,0,0,3,6,1190,0,47.4616,-122.184,1230,7980,10010,9210,1190,60,60
3,2.25,1750,1879,3,0,0,3,8,1750,0,47.6722,-122.391,1750,3155,3629,4905,1750,18,18
2,2,1370,7920,1,0,0,3,8,950,420,47.6589,-122.397,1370,4680,9290,6050,1370,70,70
3,1,1160,9600,1,0,0,4,7,1160,0,47.7419,-122.073,1160,9730,10760,10890,1160,52,52
3,1,1580,3774,1,0,0,3,6,1580,0,47.6839,-122.361,1580,3860,5354,5440,1580,119,119
3,2.5,1232,1130,3,0,0,3,7,1232,0,47.7185,-122.317,1232,1202,2362,2434,1232,12,12
5,1.75,3000,6000,1,0,0,5,7,1500,1500,47.492,-122.225,2230,7125,9000,9355,3000,61,61
5,4,4390,6656,2,0,0,3,9,2930,1460,47.648,-122.397,1560,6656,11046,8216,4390,11,11
4,3.5,4230,20377,2,0,0,3,11,4230,0,47.5954,-122.206,3980,20489,24607,24469,4230,22,22
5,1,1880,3774,1,0,0,3,6,1360,520,47.566,-122.37,1420,2550,5654,3970,1880,102,102
3,2.5,1280,1920,3,0,0,3,8,1280,0,47.6621,-122.324,1450,1900,3200,3350,1280,10,10
3,2,1750,7000,1,0,0,3,8,1750,0,47.3693,-122.041,1840,6969,8750,8809,1750,26,26
4,2.5,2680,4499,2,0,0,3,9,2680,0,47.565,-122.125,2920,4500,7179,7420,2680,20,20
3,1,1220,4800,1,0,0,3,6,1220,0,47.6101,-122.307,1200,4800,6020,6000,1220,118,118
3,2.5,1470,1256,2,0,0,3,8,930,540,47.6033,-122.309,1510,1797,2726,3307,1470,13,13
2,1,840,7414,1,0,0,4,6,840,0,47.6771,-122.172,1740,9784,8254,11524,840,91,91
4,2.5,1830,5331,2,0,0,3,7,1830,0,47.3557,-122.016,1830,5175,7161,7005,1830,17,17
3,2.5,2120,9653,2,0,0,3,8,2120,0,47.3843,-122.213,1780,9801,11773,11581,2120,27,27
4,3,3680,5854,1,0,3,3,10,2060,1620,47.6327,-122.395,3140,5000,9534,8140,3680,52,52
2,1.75,1330,6000,1,0,0,4,7,960,370,47.6539,-122.396,1620,6000,7330,7620,1330,105,69
4,3.5,3950,9600,2,0,0,3,10,3950,0,47.5945,-121.981,3110,10213,13550,13323,3950,21,21
3,2.25,1510,6071,1,0,0,4,7,1150,360,47.3619,-122.077,1510,7271,7581,8781,1510,34,34
3,2,1620,5101,1,0,0,3,7,590,1030,47.5448,-122.288,1700,7750,6721,9450,1620,13,13
3,1,990,8840,1,0,0,3,6,990,0,47.3074,-122.371,1120,8625,9830,9745,990,53,53
3,2.25,2300,7200,1,0,0,4,8,1550,750,47.324,-122.328,2000,7350,9500,9350,2300,41,41
4,2,2100,4857,2,0,0,3,8,2100,0,47.7521,-122.279,1450,5965,6957,7415,2100,54,30
4,2.5,2210,17715,2,0,0,3,8,2210,0,47.3818,-122.2,2210,16907,19925,19117,2210,22,22
2,1,1100,27007,1,0,0,4,6,1100,0,47.4471,-122.473,1746,91476,28107,93222,1100,76,76
4,3.5,2770,10505,2,0,0,3,8,2770,0,47.7412,-122.355,1760,10505,13275,12265,2770,79,0
5,2.5,2500,11900,1,0,0,3,7,1400,1100,47.5915,-122.132,2820,11900,14400,14720,2500,56,56
3,1.75,1930,14389,1,0,0,3,7,1130,800,47.7733,-122.317,1730,14378,16319,16108,1930,56,17
3,1.5,1310,10491,1,0,0,4,7,1310,0,47.3682,-122.148,1430,9664,11801,11094,1310,50,50
3,2.75,2840,39324,1,0,0,3,9,2200,640,47.3076,-122.101,2840,39413,42164,42253,2840,31,31
4,1.5,2020,8474,1,0,0,5,7,1010,1010,47.4579,-122.17,1720,8166,10494,9886,2020,57,57
3,2,1870,3388,1,0,0,4,8,1230,640,47.6372,-122.395,1780,4050,5258,5830,1870,94,94
4,2.75,2930,22000,1,0,3,4,9,1580,1350,47.3227,-122.384,2930,9758,24930,12688,2930,41,41
5,4.5,4000,6713,2,0,0,3,9,4000,0,47.5254,-121.886,3690,6600,10713,10290,4000,4,4
3,1.75,1540,13002,1,0,0,2,8,1200,340,47.6231,-122.044,1620,10098,14542,11718,1540,35,35
4,2,1580,6250,1,0,0,3,7,860,720,47.7659,-122.31,1580,6250,7830,7830,1580,42,42
4,1.75,1490,8544,1,0,0,4,7,1490,0,47.3894,-122.166,1180,8372,10034,9552,1490,49,49
3,1,1200,7210,1,0,0,4,6,1200,0,47.3729,-122.183,1200,7650,8410,8850,1200,42,42
3,1,960,6500,1,0,0,4,5,960,0,47.497,-122.171,1150,6500,7460,7650,960,65,65
3,2.25,1990,4977,3,0,0,3,9,1990,0,47.5404,-122.268,1280,5000,6967,6280,1990,7,7
2,1,840,7425,1,0,0,4,6,840,0,47.4749,-122.339,1300,11674,8265,12974,840,67,67
5,2.25,2480,12070,2,0,0,3,9,2480,0,47.631,-122.052,2570,12000,14550,14570,2480,41,41
3,2.5,1760,3097,2,0,0,3,8,1760,0,47.5764,-121.996,1760,3285,4857,5045,1760,27,27
3,2.5,1930,5080,2,0,0,4,8,1930,0,47.5694,-122.001,2190,5085,7010,7275,1930,29,29
4,2.5,1820,9161,1,0,0,4,7,1220,600,47.4333,-122.168,1860,7650,10981,9510,1820,44,44
3,2.25,2220,16020,1,0,0,4,8,1780,440,47.3758,-122.217,2080,9583,18240,11663,2220,53,53
4,1.75,2780,9900,2,0,0,4,10,2780,0,47.6348,-122.06,2600,12000,12680,14600,2780,41,41
3,2.5,2400,7478,2,0,0,3,9,2400,0,47.7362,-121.974,2980,8182,9878,11162,2400,17,17
3,1,1320,8625,1,0,0,4,7,1320,0,47.4902,-122.179,1370,8295,9945,9665,1320,62,62
2,1,1000,5375,1,0,0,3,7,1000,0,47.5404,-122.268,1380,5000,6375,6380,1000,66,66
3,2.5,1420,1237,3,0,0,3,8,1420,0,47.674,-122.387,1510,2501,2657,4011,1420,5,5
2,1.75,1550,9230,1,0,0,3,6,970,580,47.4701,-121.744,1550,10856,10780,12406,1550,50,50
2,1,820,6771,1,0,0,4,6,820,0,47.52,-122.354,1000,4440,7591,5440,820,101,101
3,2.75,2460,3600,2,0,0,3,9,2460,0,47.5409,-121.994,2570,3600,6060,6170,2460,12,12
3,2.5,1730,46638,2,0,0,3,8,1730,0,47.4614,-121.709,1750,35508,48368,37258,1730,28,28
3,2,1310,8440,1,0,0,5,6,1310,0,47.5003,-122.269,1790,10775,9750,12565,1310,68,68
3,2.5,1690,17383,2,0,0,3,7,1690,0,47.3691,-122.031,2610,7999,19073,10609,1690,16,16
3,2.25,1740,8491,1,0,0,3,8,1240,500,47.7758,-122.379,2080,8494,10231,10574,1740,61,61
4,3.5,4970,16582,2,0,3,4,11,3930,1040,47.5496,-122.12,3580,13335,21552,16915,4970,27,27
4,2.5,2100,7208,2,0,0,3,8,2100,0,47.4478,-122.128,2060,7480,9308,9540,2100,45,45
2,1,940,8532,1,0,0,4,7,940,0,47.4814,-122.343,1050,8100,9472,9150,940,60,60
3,3,2230,1407,2,0,0,3,8,1850,380,47.5446,-122.017,2290,1407,3637,3697,2230,6,6
3,2.25,2120,18500,2,0,0,4,8,2120,0,47.3914,-122.169,2120,14479,20620,16599,2120,36,36
4,2.5,1889,6000,2,0,0,3,7,1889,0,47.2676,-122.256,1990,6350,7889,8340,1889,7,7
4,1.75,1360,4840,1,0,0,4,7,1360,0,47.556,-122.376,1320,4840,6200,6160,1360,91,91
4,2.5,3520,9901,2,0,0,3,10,3520,0,47.6084,-122.011,3490,9667,13421,13157,3520,21,21
2,1.5,1800,4144,1,0,4,4,7,900,900,47.5934,-122.39,2090,4173,5944,6263,1800,57,57
4,4,4690,6900,2,0,0,3,11,3480,1210,47.6165,-122.216,2800,11240,11590,14040,4690,18,18
4,4,3280,8448,2,0,0,3,10,3280,0,47.5818,-121.973,3730,8030,11728,11760,3280,12,12
3,3,1970,24318,1,0,0,3,8,1970,0,47.7651,-122.246,2150,14695,26288,16845,1970,9,9
4,2.5,3010,46173,2,0,0,3,9,3010,0,47.6471,-121.964,2590,49222,49183,51812,3010,23,23
4,2.5,2960,26742,1,0,3,3,8,1480,1480,47.6846,-122.268,2500,9460,29702,11960,2960,70,18
2,1,1550,15250,1,0,0,5,7,1550,0,47.407,-122.045,1520,34929,16800,36449,1550,99,99
3,2.25,2510,9900,1,0,0,3,8,1610,900,47.2988,-122.374,1940,8510,12410,10450,2510,41,41
5,3.75,2890,5000,1,0,0,3,7,1310,1580,47.5701,-122.296,1930,5117,7890,7047,2890,13,13
3,2.25,1640,1204,3,0,0,3,8,1640,0,47.6196,-122.297,1630,3136,2844,4766,1640,5,5
3,1,1330,8912,1,0,0,3,6,1330,0,47.4493,-122.274,1200,8913,10242,10113,1330,71,71
3,1.75,1960,5000,1,0,0,5,6,980,980,47.5576,-122.317,1790,5000,6960,6790,1960,108,108
5,4.25,4010,8252,2,0,0,3,10,4010,0,47.5974,-122.013,3370,8252,12262,11622,4010,4,4
4,2.5,2730,4847,2,0,0,3,9,2730,0,47.549,-122.374,1250,4840,7577,6090,2730,11,11
4,2.25,2520,2370,2,0,0,3,8,1690,830,47.6109,-122.303,1530,2370,4890,3900,2520,111,111
4,3.5,4490,5805,2,0,0,3,9,3390,1100,47.5389,-121.86,4410,6299,10295,10709,4490,13,13
2,0.75,1160,15029,1,0,0,4,6,870,290,47.6929,-121.87,1870,25346,16189,27216,1160,82,82
4,3,2170,2500,2,0,0,3,8,1710,460,47.6742,-122.303,2170,4080,4670,6250,2170,22,22
3,1.75,2790,36585,1,0,0,4,8,1410,1380,47.4734,-121.999,1900,45302,39375,47202,2790,49,49
2,1,1040,5527,1,0,0,3,7,1040,0,47.6774,-122.284,2080,7020,6567,9100,1040,68,68
3,1,1890,3330,1,0,0,4,7,1390,500,47.6597,-122.352,1530,3330,5220,4860,1890,118,118
5,2.75,2470,19200,1,0,0,5,8,1250,1220,47.4496,-122.083,2140,35140,21670,37280,2470,42,42
3,1,940,6695,1,0,0,4,6,940,0,47.6195,-122.12,1230,7400,7635,8630,940,60,60
4,2.25,2330,8994,2,0,0,3,8,2330,0,47.7264,-122.104,2330,8396,11324,10726,2330,33,33
4,3.25,3430,9870,2,0,0,3,9,3430,0,47.776,-122.173,3360,9724,13300,13084,3430,5,5
4,1,1670,4600,1,0,0,5,8,1670,0,47.6838,-122.332,1820,4600,6270,6420,1670,113,113
2,1,1020,47044,1,0,0,5,7,1020,0,47.4206,-122.155,1930,12139,48064,14069,1020,115,56
4,3,2840,13554,1,0,2,4,9,1990,850,47.7153,-122.257,2840,16940,16394,19780,2840,45,45
3,2,2930,29136,2,0,0,3,8,2240,690,47.3102,-122.042,2110,29362,32066,31472,2930,29,29
3,2.25,2130,8721,1,0,0,3,8,1570,560,47.4202,-122.204,2130,9477,10851,11607,2130,32,32
3,1,1220,20400,1,0,0,5,6,1220,0,47.2063,-122.023,1640,53578,21620,55218,1220,60,60
4,2.5,2110,3750,2,0,0,3,8,2110,0,47.6789,-122.363,1700,5000,5860,6700,2110,19,19
4,3,2240,7035,2,0,0,3,7,2240,0,47.5124,-122.374,1060,6300,9275,7360,2240,77,21
3,1,1380,6250,1,0,0,4,7,1380,0,47.5514,-122.385,2270,6250,7630,8520,1380,101,101
3,1,970,8580,1,0,0,3,7,970,0,47.3363,-122.311,1430,11907,9550,13337,970,60,60
2,1,910,9612,1,0,0,4,7,910,0,47.4297,-122.152,1410,9611,10522,11021,910,38,38
3,1.75,2440,10179,1,0,0,4,7,1220,1220,47.4118,-122.314,1650,9711,12619,11361,2440,57,57
4,2.5,2440,14470,1,0,0,4,9,1660,780,47.6401,-122.168,2810,15564,16910,18374,2440,49,49
3,1,1100,5132,1,0,0,3,6,840,260,47.7011,-122.336,1280,5132,6232,6412,1100,71,71
3,2.25,1540,1005,3,0,0,3,8,1540,0,47.6827,-122.346,1510,1501,2545,3011,1540,11,11
3,2,1010,7896,1,0,0,3,7,1010,0,47.4046,-122.181,1540,7896,8906,9436,1010,35,35
3,2.5,2170,8140,2,0,0,3,9,2170,0,47.385,-122.169,2390,8100,10310,10490,2170,25,25
3,1,1030,7620,1,0,0,3,7,1030,0,47.5281,-122.375,1030,7560,8650,8590,1030,66,66
4,3,3350,199253,2,0,0,3,10,3350,0,47.3602,-121.988,3350,183897,202603,187247,3350,15,15
5,3,2010,7264,1,0,0,3,7,1290,720,47.6945,-122.33,1510,7326,9274,8836,2010,29,29
4,2,2680,14157,1,0,0,3,8,1460,1220,47.4286,-122.292,2100,9199,16837,11299,2680,53,53
3,1,1420,6000,1,0,0,3,6,1420,0,47.4913,-122.336,1480,6000,7420,7480,1420,78,78
3,1,1500,6250,1,0,0,3,6,890,610,47.5365,-122.368,1210,6250,7750,7460,1500,74,74
3,1.75,1540,8400,1,0,0,3,7,1540,0,47.6187,-122.295,1330,4800,9940,6130,1540,117,117
3,2.5,2490,4343,2,0,0,3,9,2490,0,47.5493,-121.993,2130,4106,6833,6236,2490,16,16
2,2,1300,3865,1,0,0,3,8,1300,0,47.7193,-122.024,1350,4199,5165,5549,1300,13,13
4,2.75,3210,41689,1,0,0,4,8,1610,1600,47.3493,-122.062,2100,41384,44899,43484,3210,30,30
3,2,1980,3525,1,0,0,4,8,1590,390,47.6847,-122.368,1760,3760,5505,5520,1980,87,87
3,2.5,2300,5500,1,0,0,4,8,2000,300,47.5785,-122.293,2100,5000,7800,7100,2300,98,98
3,1.5,1330,12500,1,0,0,3,7,1330,0,47.5263,-122.051,2310,12500,13830,14810,1330,53,53
4,2.5,2700,4004,2,0,0,3,9,2700,0,47.5521,-121.995,2260,4459,6704,6719,2700,15,15
4,2.25,2100,3671,1,0,0,3,8,1750,350,47.6359,-122.3,1800,4560,5771,6360,2100,90,90
4,2.5,3220,7875,1,0,0,4,8,3220,0,47.626,-122.12,1600,7875,11095,9475,3220,53,53
3,2.5,1610,2937,2,0,0,3,8,1610,0,47.4489,-122.188,1610,3049,4547,4659,1610,13,13
3,2.5,2760,17377,2,0,0,3,9,2760,0,47.4929,-122.188,1940,8504,20137,10444,2760,17,17
6,2.75,2830,10579,1,0,0,4,8,1430,1400,47.636,-122.171,2060,10745,13409,12805,2830,52,52
3,2.5,2480,5082,2,0,0,3,7,2480,0,47.5297,-121.846,2480,5874,7562,8354,2480,15,15
4,1.75,1700,5846,1,0,0,3,8,1700,0,47.6539,-122.408,1480,5177,7546,6657,1700,62,62
3,2.5,2440,7632,2,0,0,3,8,2440,0,47.3494,-122.301,2510,7903,10072,10413,2440,21,21
4,1.75,3010,12523,1,0,0,3,8,1780,1230,47.707,-122.316,2040,7560,15533,9600,3010,67,67
3,2,2390,8025,2,0,0,5,7,2390,0,47.6707,-122.288,1920,5350,10415,7270,2390,98,98
4,2.5,2670,5895,2,0,0,3,8,2670,0,47.6066,-122.016,2820,6531,8565,9351,2670,20,20
5,2,1430,5600,1,0,0,3,6,1430,0,47.5192,-122.266,1860,5980,7030,7840,1430,72,72
3,2.25,1450,13439,1,0,0,4,7,1180,270,47.2811,-122.299,1520,12348,14889,13868,1450,56,56
3,2.25,1420,7297,1,0,0,3,7,1130,290,47.4046,-122.194,1730,7419,8717,9149,1420,35,35
3,2.5,2150,4084,2,0,0,3,8,2150,0,47.5488,-122.372,1750,2385,6234,4135,2150,12,12
3,2,2350,5080,1,0,0,3,8,1780,570,47.5516,-122.263,1700,5080,7430,6780,2350,90,90
5,3.5,2440,10200,2,0,0,4,7,2440,0,47.5814,-122.003,2000,10568,12640,12568,2440,45,45
3,1.5,2440,7200,1,0,0,3,7,2440,0,47.5604,-122.274,1920,6900,9640,8820,2440,70,70
2,1,1290,2482,2,0,0,3,7,1290,0,47.6972,-122.025,1290,2482,3772,3772,1290,11,11
2,1,750,34133,1,0,0,3,6,750,0,47.4781,-122.294,1460,25792,34883,27252,750,69,69
3,2,2140,26600,1,0,0,4,7,2140,0,47.4066,-122.169,2310,8783,28740,11093,2140,36,36
3,2.5,1390,2815,2,0,0,3,8,1390,0,47.566,-122.366,1390,3700,4205,5090,1390,20,20
4,2.25,2510,8165,1,0,0,4,7,1610,900,47.3092,-122.372,1940,8250,10675,10190,2510,47,47
3,2.25,1200,1400,3,0,0,3,8,1200,0,47.7046,-122.357,1370,6552,2600,7922,1200,14,14
3,1.75,1710,7210,1,0,0,4,7,1240,470,47.4094,-122.175,1840,7245,8920,9085,1710,45,45
3,2,1460,7860,1,0,0,5,7,1460,0,47.6233,-122.108,1850,8148,9320,9998,1460,52,52
3,2,1480,7480,1,0,0,4,7,1480,0,47.3542,-122.055,1680,7146,8960,8826,1480,27,27
3,2.25,1220,5739,1,0,0,3,7,790,430,47.6952,-122.326,1870,5739,6959,7609,1220,35,35
2,1,580,7500,1,0,0,3,5,580,0,47.4852,-122.251,1700,11250,8080,12950,580,76,76
4,2.5,2640,25038,2,0,0,4,8,2640,0,47.5277,-122.174,2630,16668,27678,19298,2640,24,24
3,1.75,1680,3000,1,0,2,4,6,840,840,47.686,-122.346,1540,3700,4680,5240,1680,119,119
3,1.75,1390,7399,1,0,0,4,7,1390,0,47.4183,-122.182,1460,7800,8789,9260,1390,44,44
4,2.5,4070,129808,2,0,0,3,10,4070,0,47.4433,-122.016,4070,102366,133878,106436,4070,21,21
3,1.5,1900,9994,1,0,0,3,7,1120,780,47.4729,-122.301,1900,9994,11894,11894,1900,59,59
3,1.75,1650,7807,1,0,0,3,7,1650,0,47.3514,-122.167,1810,8475,9457,10285,1650,33,33
3,1,1310,18135,1,0,0,3,7,1310,0,47.6065,-122.113,2150,18135,19445,20285,1310,71,71
4,2.5,1660,6724,2,0,0,3,7,1660,0,47.259,-122.256,1544,6054,8384,7598,1660,10,10
4,3.25,3830,6765,2,0,0,3,9,3830,0,47.685,-122.016,3830,6507,10595,10337,3830,5,5
3,2.5,2270,7887,2,0,2,3,8,2270,0,47.5326,-121.855,2550,7133,10157,9683,2270,15,15
3,2.5,2460,12600,1,0,0,4,8,1810,650,47.473,-122.118,1820,11180,15060,13000,2460,49,49
3,1.75,2840,16851,1,0,3,3,8,1600,1240,47.7458,-122.287,2650,11063,19691,13713,2840,69,69
3,1.75,1470,6550,1,0,2,3,7,1070,400,47.5463,-122.381,1440,6550,8020,7990,1470,103,103
1,1,1160,64469,1,0,0,3,7,1160,0,47.7433,-122.082,1580,48352,65629,49932,1160,10,10
4,1,1740,37238,1,0,0,4,7,1740,0,47.5651,-121.902,1810,18352,38978,20162,1740,87,87
3,1.75,1600,19200,1,0,0,4,7,1600,0,47.7202,-122.249,2010,14850,20800,16860,1600,52,52
3,2,1310,8454,1,0,0,3,7,1310,0,47.3697,-122.075,1310,8454,9764,9764,1310,25,25
4,3,3720,5000,2,0,0,5,9,2720,1000,47.6282,-122.322,2610,5000,8720,7610,3720,114,114
3,2.5,1760,5390,1,0,0,3,8,1760,0,47.3482,-122.042,2310,5117,7150,7427,1760,5,5
3,2.75,2240,3600,2,0,0,3,7,1650,590,47.6244,-122.326,1716,3120,5840,4836,2240,118,118
3,2.25,1481,2820,2,0,0,3,7,1481,0,47.3457,-122.217,1481,2889,4301,4370,1481,7,7
3,1.75,1840,7412,1,0,0,4,7,1240,600,47.3933,-122.188,1980,7350,9252,9330,1840,43,43
4,4,4920,50621,2,0,0,3,10,4280,640,47.6575,-122.006,4920,74052,55541,78972,4920,7,7
4,2.5,2000,13300,1,0,0,4,7,1200,800,47.353,-122.294,1800,9810,15300,11610,2000,51,51
2,1,1240,42247,1,0,1,4,7,1240,0,47.5169,-122.201,1550,12459,43487,14009,1240,104,104
5,2.75,2860,5379,2,0,0,3,9,2860,0,47.7082,-122.104,2980,6018,8239,8998,2860,14,14
2,1,1410,4500,1,0,0,3,7,1020,390,47.6883,-122.384,1300,4500,5910,5800,1410,80,80
3,2.5,2020,7800,1,0,0,4,7,1330,690,47.7368,-122.337,1870,7800,9820,9670,2020,61,61
4,2.5,2620,7328,2,0,0,3,8,2620,0,47.5514,-122.263,1670,5080,9948,6750,2620,36,36
2,1.5,980,5000,2,0,0,3,7,980,0,47.7076,-121.359,1040,5000,5980,6040,980,97,11
3,2.75,2770,5800,1,0,0,4,8,1650,1120,47.6496,-122.413,2340,5800,8570,8140,2770,60,60
4,2,1680,3813,2,0,0,4,7,1680,0,47.593,-122.293,2540,3996,5493,6536,1680,119,119
3,1,870,8040,1,0,0,3,7,870,0,47.7048,-122.368,1440,8040,8910,9480,870,66,66
4,1.75,2251,12731,1,0,1,4,8,1390,861,47.3369,-122.32,2520,12539,14982,15059,2251,62,62
4,2.5,2990,8622,2,0,0,3,9,2990,0,47.5394,-121.875,2980,8622,11612,11602,2990,19,19
3,1,1320,11457,1,0,0,3,8,1320,0,47.7738,-122.261,1900,9800,12777,11700,1320,60,60
6,2.25,2770,5854,1,0,0,3,8,2120,650,47.6466,-122.304,2300,5450,8624,7750,2770,98,98
2,2.25,3950,3938,2,0,4,3,10,2910,1040,47.5912,-122.384,3220,4500,7888,7720,3950,28,28
3,1,1340,21336,1,0,0,4,5,1340,0,47.4023,-122.273,1340,37703,22676,39043,1340,74,74
4,1.5,1150,9360,1,0,0,3,6,1150,0,47.7197,-122.173,1480,8155,10510,9635,1150,49,49
3,3.5,1550,1233,2,0,0,3,8,1160,390,47.6034,-122.309,1490,1539,2783,3029,1550,14,14
3,2.5,2810,4984,1,0,0,3,9,1750,1060,47.4461,-122.209,2810,5711,7794,8521,2810,13,13
3,2.5,1710,2875,2,0,0,3,8,1710,0,47.5787,-122.392,1640,5750,4585,7390,1710,13,13
4,1.75,2300,13342,1,1,4,3,7,2300,0,47.7308,-122.282,2500,13342,15642,15842,2300,85,56
4,2.5,2320,8721,2,0,0,3,8,2320,0,47.7326,-122.226,2260,8268,11041,10528,2320,28,28
1,1,530,13679,1,0,0,4,6,530,0,47.6422,-121.954,1930,20624,14209,22554,530,70,70
2,1.75,1640,4080,1,0,0,3,7,840,800,47.6645,-122.326,1980,4080,5720,6060,1640,98,98
3,1.75,2050,11041,1,0,0,5,9,2050,0,47.5968,-122.174,2530,11041,13091,13571,2050,60,60
2,2,1120,780,2,0,0,3,8,760,360,47.5788,-122.41,1120,1322,1900,2442,1120,15,15
3,2.5,1150,1194,2,0,0,3,8,1020,130,47.6684,-122.365,1450,1714,2344,3164,1150,13,13
3,1,1440,10330,1,0,0,4,7,1440,0,47.6245,-122.193,2080,10327,11770,12407,1440,67,67
5,2.5,4150,96574,2,0,0,3,10,4150,0,47.6664,-122.045,3320,40803,100724,44123,4150,31,31
3,2.75,2610,5000,2,0,0,4,7,1710,900,47.6729,-122.373,1500,5000,7610,6500,2610,73,73
2,2,1440,1170,2,0,0,3,9,960,480,47.5592,-122.385,1440,1350,2610,2790,1440,15,15
4,2.25,2230,6000,1,0,2,3,8,1810,420,47.6464,-122.391,2840,6000,8230,8840,2230,91,91
3,2.25,2420,7200,1,0,0,3,8,1420,1000,47.6867,-122.275,2500,7200,9620,9700,2420,71,71
4,3,3760,8804,2,0,0,3,8,2470,1290,47.5161,-122.191,1960,7225,12564,9185,3760,17,17
3,2.25,1740,6650,1,0,0,3,7,1240,500,47.2979,-122.379,1740,7000,8390,8740,1740,41,41
3,2.5,1270,865,2,0,0,3,7,1080,190,47.5351,-122.279,1630,7752,2135,9382,1270,11,11
3,1,1030,60720,1,0,0,3,5,1030,0,47.375,-122.166,1330,10342,61750,11672,1030,107,107
3,2.5,3160,4270,2,0,0,3,8,2650,510,47.7453,-122.194,2720,12523,7430,15243,3160,13,13
4,2.5,2714,12558,2,0,0,3,9,2714,0,47.3522,-122.201,2873,8269,15272,11142,2714,5,5
3,1.5,1130,5413,1,0,0,3,7,940,190,47.7021,-122.32,1400,7168,6543,8568,1130,73,73
3,1.75,2470,9620,1,0,1,4,7,1570,900,47.3996,-122.32,2600,9620,12090,12220,2470,57,57
3,2,2400,217800,2,0,0,3,8,1590,810,47.4166,-121.94,2340,207781,220200,210121,2400,44,44
4,3,3500,13444,2,0,0,3,10,2360,1140,47.5468,-122.231,3140,12935,16944,16075,3500,42,42
4,1.75,2080,8750,1,0,0,4,8,1330,750,47.3749,-122.291,1790,8750,10830,10540,2080,52,52
3,2.5,1970,6634,2,0,0,3,8,1970,0,47.5759,-122.012,2090,6176,8604,8266,1970,30,30
4,2.25,1830,7200,2,0,2,3,8,1750,80,47.6315,-122.282,3100,7200,9030,10300,1830,96,96
3,2.5,2440,7600,1,0,0,3,7,1420,1020,47.6966,-122.127,2060,7700,10040,9760,2440,38,38
3,2.5,1420,1162,3,0,0,3,8,1420,0,47.6982,-122.349,1430,1560,2582,2990,1420,17,17
3,2.5,2620,28703,1,0,0,3,10,2620,0,47.7238,-122.114,2950,30290,31323,33240,2620,34,34
3,2.25,1950,3600,1,0,0,5,8,1430,520,47.637,-122.363,1950,3600,5550,5550,1950,108,108
4,2.5,2890,7306,2,0,0,3,7,2890,0,47.5447,-121.883,2850,6687,10196,9537,2890,13,13
4,2.75,3540,7091,1,0,1,4,8,1970,1570,47.6467,-122.394,2200,6000,10631,8200,3540,72,72
2,1,1030,5000,1,0,0,5,6,1030,0,47.6585,-122.363,1550,5000,6030,6550,1030,102,102
4,1.75,2340,9100,1,0,0,3,8,1610,730,47.6401,-122.108,2470,11000,11440,13470,2340,44,44
4,4,2530,1774,3,0,2,3,9,2100,430,47.6362,-122.369,2160,2400,4304,4560,2530,6,6
2,3,2560,982278,1,0,0,3,8,2560,0,47.6955,-121.861,1620,40946,984838,42566,2560,15,15
4,2.25,2520,4200,1,0,0,4,7,1510,1010,47.5814,-122.312,1460,4200,6720,5660,2520,110,110
3,2.25,2600,15000,2,0,0,3,9,2600,0,47.3719,-122.056,2380,15000,17600,17380,2600,41,41
4,2.5,1950,4553,2,0,0,3,7,1950,0,47.5066,-122.175,1780,4598,6503,6378,1950,19,19
4,2.75,2020,8093,1,0,0,5,7,1300,720,47.7685,-122.332,1920,8089,10113,10009,2020,58,58
3,1,1150,6800,1,0,0,3,7,1150,0,47.727,-122.339,1210,6800,7950,8010,1150,65,65
2,1.5,830,1034,2,0,0,3,8,830,0,47.5926,-122.3,1130,2534,1864,3664,830,10,10
3,2.5,1320,955,3,0,0,3,7,1320,0,47.5202,-122.357,1300,1003,2275,2303,1320,10,10
3,1,2270,4182,1,0,0,4,7,1170,1100,47.688,-122.32,1860,4080,6452,5940,2270,73,73
3,1.5,1590,7080,1,0,2,3,8,1310,280,47.5244,-122.386,2080,7200,8670,9280,1590,67,67
3,3.5,3790,10829,2,0,0,3,11,3790,0,47.5525,-122.098,3620,10989,14619,14609,3790,26,26
3,2.5,2540,11562,1,0,1,3,8,1290,1250,47.7614,-122.229,2230,10310,14102,12540,2540,55,55
3,1,1110,6000,1,0,0,5,7,1110,0,47.6496,-122.403,1420,6000,7110,7420,1110,87,87
4,2.5,2641,8091,2,0,0,3,7,2641,0,47.4043,-122.213,2641,8535,10732,11176,2641,21,21
2,1.75,1930,5570,1,0,0,3,8,1930,0,47.7173,-122.034,1810,5178,7500,6988,1930,14,14
4,2.5,3340,8384,2,0,0,3,9,3340,0,47.6761,-122.152,1560,9429,11724,10989,3340,5,5
3,2.5,1590,3480,2,0,0,3,7,1590,0,47.4805,-122.178,1680,3480,5070,5160,1590,15,15
3,1.75,1520,9600,1,0,0,4,7,1520,0,47.473,-122.149,1590,10183,11120,11773,1520,52,52
3,1.75,1410,6886,1,0,0,3,7,1410,0,47.7183,-122.353,1410,6561,8296,7971,1410,95,1
4,2,3100,8000,1,0,0,5,7,2040,1060,47.6852,-122.329,1650,4000,11100,5650,3100,80,80
3,2,1550,15040,1,0,0,4,6,1550,0,47.4873,-122.099,1510,41416,16590,42926,1550,61,61
2,1,1120,6180,1,0,0,4,7,1120,0,47.6824,-122.301,1420,5356,7300,6776,1120,80,80
3,2.25,1230,11601,1,0,0,4,7,910,320,47.1955,-121.991,1820,8465,12831,10285,1230,27,27
4,1.75,1560,9000,1,0,0,5,7,1560,0,47.6707,-122.149,1510,8848,10560,10358,1560,50,50
2,1,870,4600,1,0,0,4,7,870,0,47.5274,-122.379,930,4600,5470,5530,870,77,77
3,1,1210,7425,1,0,0,4,6,1210,0,47.7125,-122.33,1260,7425,8635,8685,1210,109,109
4,2.5,2020,7200,1,0,0,5,7,1010,1010,47.7289,-122.201,1620,7275,9220,8895,2020,51,51
4,2.5,2683,40386,2,0,0,4,9,2683,0,47.6982,-122.138,2683,34800,43069,37483,2683,32,32
3,1.75,1880,12821,1,0,0,3,7,1880,0,47.7681,-122.305,1540,12868,14701,14408,1880,60,60
3,1.75,1480,4800,2,0,0,4,7,1140,340,47.6567,-122.397,1810,4800,6280,6610,1480,75,75
4,2.25,2340,5250,2,0,0,5,7,2340,0,47.5183,-122.266,1540,5250,7590,6790,2340,54,54
3,4.5,3850,62726,2,0,0,3,10,3120,730,47.6735,-122.058,2630,46609,66576,49239,3850,6,6
2,1,1030,9192,1,0,0,4,6,1030,0,47.4565,-122.181,1030,9190,10222,10220,1030,60,60
2,2,1300,3608,1,0,0,3,7,1300,0,47.3623,-122.309,1510,3608,4908,5118,1300,15,15
4,2.5,3550,10968,2,0,0,3,9,3550,0,47.5431,-121.886,3550,8583,14518,12133,3550,13,13
3,2.5,3040,7232,2,0,0,3,7,3040,0,47.3355,-122.168,2760,6926,10272,9686,3040,16,16
4,2.25,2060,44431,2,0,0,3,7,2060,0,47.744,-122.046,2160,45657,46491,47817,2060,31,31
3,1,940,8512,1,0,0,4,7,940,0,47.7002,-122.191,1060,8512,9452,9572,940,52,52
3,2.5,1820,1855,2,0,0,3,8,1570,250,47.4643,-122.346,1470,6900,3675,8370,1820,11,11
4,2.5,1981,4828,2,0,0,3,8,1981,0,47.3252,-122.167,1981,3783,6809,5764,1981,6,6
3,1,960,9000,1,0,0,4,7,960,0,47.5765,-122.154,1520,9000,9960,10520,960,64,64
2,1.75,1270,1916,2,0,0,3,8,1270,0,47.5648,-122.294,1140,1916,3186,3056,1270,7,7
4,2.5,3370,35150,1,0,0,5,8,1770,1600,47.461,-122.002,2920,41241,38520,44161,3370,26,26
4,4,5000,12941,3,0,2,3,12,5000,0,47.55,-122.103,4560,12941,17941,17501,5000,17,17
3,1,800,3060,1,0,0,4,6,800,0,47.6769,-122.389,1180,3060,3860,4240,800,116,116
4,2.5,2130,6003,2,0,0,3,8,2130,0,47.4518,-122.12,1940,4529,8133,6469,2130,16,16
3,2.5,2600,4724,2,0,0,3,7,2600,0,47.5359,-121.878,2400,4724,7324,7124,2600,17,17
5,2.5,3001,5710,2,0,0,3,8,3001,0,47.3727,-122.177,2340,5980,8711,8320,3001,13,13
3,1.75,1770,33224,1,0,0,4,8,1770,0,47.3377,-122.194,1690,22069,34994,23759,1770,51,51
5,2.5,2140,10320,1,0,0,4,7,1330,810,47.3927,-122.194,2050,8964,12460,11014,2140,52,52
3,1,1320,24684,1,0,0,3,7,1320,0,47.4771,-122.322,1120,21214,26004,22334,1320,40,40
3,1.75,2200,12231,1,0,0,4,7,1250,950,47.5076,-122.173,2200,9825,14431,12025,2200,55,55
3,1.75,1890,32340,1,0,3,3,8,1890,0,47.4137,-122.439,1890,40180,34230,42070,1890,43,43
2,1,710,6322,1,0,0,3,6,710,0,47.5165,-122.376,740,6720,7032,7460,710,77,77
2,2.5,1660,2258,2,0,0,3,7,1660,0,47.3793,-122.146,1740,2390,3918,4130,1660,38,38
3,3,2090,7440,1,0,0,5,7,1290,800,47.6891,-122.331,1570,4960,9530,6530,2090,97,97
4,2,1620,4600,2,0,0,3,7,1620,0,47.5533,-122.307,1620,4500,6220,6120,1620,110,110
3,2.5,2820,8159,2,0,0,3,9,2820,0,47.5527,-121.992,2910,5000,10979,7910,2820,15,15
4,1.5,1130,5200,1,0,0,3,6,1130,0,47.3616,-122.089,1140,5200,6330,6340,1130,51,51
4,3.25,3020,13457,1,0,0,5,9,3020,0,47.7174,-122.336,2120,7553,16477,9673,3020,63,63
4,3.25,3440,4920,2,0,4,3,10,2520,920,47.5727,-122.409,2350,5166,8360,7516,3440,5,5
4,1.75,2020,9750,1,0,0,3,7,1100,920,47.6192,-122.055,1670,9600,11770,11270,2020,44,44
3,1,1170,11000,1,0,0,2,6,1170,0,47.7346,-121.983,1590,10894,12170,12484,1170,39,39
5,2.75,2730,22572,1,0,0,3,7,2080,650,47.5951,-122.037,2260,15458,25302,17718,2730,51,22
1,1,1940,6300,1,0,3,3,8,1940,0,47.5782,-122.4,2560,6300,8240,8860,1940,56,56
4,2.5,2720,10006,2,0,0,3,9,2720,0,47.6295,-122.042,2720,10759,12726,13479,2720,30,30
4,3.5,4210,18564,2,0,0,3,11,4210,0,47.6206,-122.225,3520,18564,22774,22084,4210,18,18
2,1,1020,5130,1,0,0,4,6,1020,0,47.301,-122.226,1200,6497,6150,7697,1020,71,71
3,2.25,3230,35306,2,0,0,3,9,3230,0,47.3065,-122.113,2760,35285,38536,38045,3230,32,32
5,1.75,2360,6150,1,0,0,5,7,1180,1180,47.6732,-122.4,2100,5500,8510,7600,2360,79,79
3,3,1990,9600,1,0,0,3,7,1440,550,47.3499,-122.296,1670,9600,11590,11270,1990,31,31
5,5,4490,10279,2,0,0,3,10,3930,560,47.5974,-122.202,2490,10279,14769,12769,4490,6,6
3,2.25,3040,52302,1,0,0,3,9,3040,0,47.7635,-122.112,2070,38600,55342,40670,3040,14,14
2,1,980,1600,2,0,0,3,8,980,0,47.638,-122.375,1180,1600,2580,2780,980,9,9
4,3.5,3906,9674,2,0,2,3,9,3906,0,47.2931,-122.264,2673,6500,13580,9173,3906,5,5
3,2.5,1820,2935,2,0,0,3,8,1820,0,47.6018,-122.021,1820,2936,4755,4756,1820,20,20
6,4,3300,5720,1,0,0,3,8,1960,1340,47.676,-122.309,2030,4080,9020,6110,3300,56,56
3,1,1200,15960,1,0,0,3,6,1200,0,47.7163,-122.299,1120,7800,17160,8920,1200,74,74
3,1.75,2190,12626,2,0,0,4,8,2190,0,47.3845,-122.154,3110,14592,14816,17702,2190,41,41
3,2.5,2070,49658,1,0,0,4,8,1540,530,47.5936,-122.013,2620,35160,51728,37780,2070,39,39
4,1.75,2260,12238,1,0,0,3,9,2260,0,47.5976,-122.178,2430,10204,14498,12634,2260,52,52
2,1.75,1210,1189,2,0,0,3,8,1210,0,47.5526,-121.998,1540,1672,2399,3212,1210,5,5
3,3,2330,1944,2,0,0,3,8,1950,380,47.5446,-122.016,2290,1407,4274,3697,2330,5,5
3,2.5,1260,895,3,0,0,3,7,1160,100,47.7072,-122.336,1190,1095,2155,2285,1260,10,10
3,2.25,1670,7606,2,0,0,3,7,1670,0,47.1949,-121.982,1670,7433,9276,9103,1670,29,29
4,2.75,2100,88426,1,0,0,3,6,2100,0,47.399,-122.011,2150,63162,90526,65312,2100,29,29
3,1,1120,10125,1,0,0,3,6,1120,0,47.4794,-122.078,1120,8820,11245,9940,1120,58,58
3,2.25,2950,7232,1,0,2,3,8,1520,1430,47.5257,-122.382,2130,7140,10182,9270,2950,36,36
3,1.75,1580,7000,1,0,0,3,7,1180,400,47.7209,-122.168,1640,7500,8580,9140,1580,43,43
4,2.75,1910,16532,1,0,0,4,7,1420,490,47.6952,-122.39,2300,8250,18442,10550,1910,79,79
4,3,2290,2350,2,0,1,3,9,1610,680,47.574,-122.415,1610,3820,4640,5430,2290,95,3
3,2.75,2600,64626,1,0,0,3,8,2600,0,47.7185,-121.405,1740,64626,67226,66366,2600,10,10
6,5.25,3600,3960,2,0,0,3,7,2400,1200,47.5656,-122.372,1450,4600,7560,6050,3600,48,48
4,2.25,2510,19550,1,0,0,4,9,1810,700,47.7041,-122.241,2450,19250,22060,21700,2510,42,42
2,0.75,840,49658,1,0,0,2,6,840,0,47.4727,-122.292,1240,11000,50498,12240,840,71,71
3,1.5,2380,14500,1,0,0,4,7,1850,530,47.7714,-122.256,1830,13600,16880,15430,2380,58,58
3,1,1320,7000,1,0,0,4,7,1320,0,47.2787,-122.205,1260,7455,8320,8715,1320,52,52
2,1,770,17334,1,0,0,3,7,770,0,47.2997,-122.269,1480,17334,18104,18814,770,41,41
3,1,1140,4200,2,0,0,4,7,1140,0,47.6012,-122.296,1510,4000,5340,5510,1140,115,115
4,3.5,2870,3225,2,0,3,3,9,2070,800,47.5009,-122.225,1770,6450,6095,8220,2870,13,13
1,1,570,6000,1,0,0,2,5,570,0,47.5517,-122.385,1530,6000,6570,7530,570,101,101
4,4.25,2360,57514,2,0,0,4,8,2360,0,47.2843,-122.294,2037,35733,59874,37770,2360,80,27
4,3.25,3450,6500,2,0,0,3,8,2450,1000,47.5437,-122.388,1750,6500,9950,8250,3450,25,25
4,2.25,2110,16200,1,0,0,3,8,1630,480,47.752,-122.144,2370,16000,18310,18370,2110,41,41
3,1,1040,8410,1,0,0,3,7,1040,0,47.453,-122.289,1350,8410,9450,9760,1040,77,0
2,1,790,13170,1,0,0,3,6,790,0,47.5487,-122.357,970,12700,13960,13670,790,72,72
4,2.25,2670,9040,1,0,0,3,8,2170,500,47.4666,-122.326,1880,2648,11710,4528,2670,64,64
3,2.25,1760,16418,1,0,0,3,7,1190,570,47.6525,-121.985,2260,20747,18178,23007,1760,29,29
5,3.5,3280,4000,2,0,0,3,9,2440,840,47.689,-122.396,1980,4000,7280,5980,3280,16,16
2,1.75,1700,18000,1,0,0,3,8,1700,0,47.5066,-122.194,1700,8225,19700,9925,1700,47,47
3,2.5,3240,12625,2,0,0,3,11,3240,0,47.5327,-122.232,3470,12331,15865,15801,3240,32,32
4,2.5,2020,8044,2,0,0,3,8,2020,0,47.6247,-122.043,2320,7328,10064,9648,2020,29,29
3,3,1520,4080,2,0,0,5,7,1520,0,47.572,-122.29,1320,4080,5600,5400,1520,71,71
3,2.5,1790,6371,2,0,0,3,8,1790,0,47.3291,-122.168,1850,6371,8161,8221,1790,21,21
5,2.5,3990,3839,1,0,0,4,8,1990,2000,47.6236,-122.299,2090,5000,7829,7090,3990,57,57
3,2.25,1750,9298,1,0,0,4,7,1410,340,47.4579,-122.164,1720,7875,11048,9595,1750,50,50
4,2.5,2200,9099,2,0,0,3,8,2200,0,47.733,-122.225,2270,8900,11299,11170,2200,25,25
2,1,860,4320,1,0,0,3,7,860,0,47.5263,-122.325,980,6000,5180,6980,860,94,94
4,3,3310,217800,1,0,0,3,9,3310,0,47.6616,-121.999,2810,217800,221110,220610,3310,30,30
3,2.5,2980,7202,2,0,0,3,8,2980,0,47.6769,-122.177,2430,7280,10182,9710,2980,20,20
4,2.5,1890,4158,2,0,0,3,8,1890,0,47.343,-122.056,2720,4549,6048,7269,1890,5,5
2,1,960,6250,1,0,0,4,6,740,220,47.5378,-122.375,1090,6000,7210,7090,960,79,79
3,2.75,3230,9576,1,0,0,4,8,3230,0,47.7307,-122.183,2820,9576,12806,12396,3230,53,53
3,1.5,1460,6480,1,0,2,4,7,980,480,47.6962,-122.397,2180,6912,7940,9092,1460,79,79
4,3.25,2790,5420,1,0,3,3,9,1130,1660,47.7698,-122.386,2530,7200,8210,9730,2790,56,1
3,2,1230,1613,2,0,0,3,8,1010,220,47.6661,-122.37,1610,1873,2843,3483,1230,16,16
3,2.5,2870,13695,2,0,0,3,10,2870,0,47.6944,-122.102,2840,8472,16565,11312,2870,28,28
5,3.5,4750,8234,2,0,2,3,10,3350,1400,47.3574,-122.318,2160,14496,12984,16656,4750,6,6
3,2.5,1830,2839,2,0,0,3,8,1830,0,47.6022,-122.021,1830,3011,4669,4841,1830,20,20
3,2.25,1520,7930,1,0,0,3,7,1160,360,47.3605,-122.049,1530,7930,9450,9460,1520,31,31
3,2.5,1510,1178,2,0,0,3,8,1060,450,47.6181,-122.301,1510,1210,2688,2720,1510,12,12
2,1.75,1610,6300,1,0,0,3,7,1010,600,47.554,-122.304,1370,5225,7910,6595,1610,78,78
4,4,3970,7314,2,0,0,3,9,3970,0,47.6173,-122.056,3560,5258,11284,8818,3970,5,5
3,2.5,2244,4079,2,0,0,3,7,2244,0,47.2606,-122.254,2077,4078,6323,6155,2244,7,7
3,1,1300,9600,1,0,0,4,6,1300,0,47.3037,-122.107,1150,10222,10900,11372,1300,44,44
4,1.75,2360,8116,1,0,0,4,7,1180,1180,47.7635,-122.335,1670,8160,10476,9830,2360,103,45
4,3.25,4290,12103,1,0,3,3,11,2690,1600,47.5503,-122.102,3860,11244,16393,15104,4290,22,22
3,3.5,3870,3819,2,0,0,3,11,2760,1110,47.6452,-122.317,2530,5500,7689,8030,3870,17,17
4,2.25,2640,34870,1,0,0,3,8,1770,870,47.4688,-122.009,2500,35580,37510,38080,2640,42,42
4,2.5,2052,3723,2,0,0,3,8,2052,0,47.2824,-122.295,2052,5250,5775,7302,2052,5,5
4,2.5,2050,4502,2,0,0,3,7,2050,0,47.5002,-122.15,2480,4504,6552,6984,2050,14,14
3,0.75,920,20412,1,1,2,5,6,920,0,47.4781,-122.49,1162,54705,21332,55867,920,69,69
5,2.25,2800,8442,2,1,4,3,9,2800,0,47.5784,-122.076,3220,9156,11242,12376,2800,56,13
4,2.5,1830,9601,2,0,0,3,7,1830,0,47.3541,-122.015,1830,5892,11431,7722,1830,16,16
3,2.5,2360,8764,2,0,0,3,8,2360,0,47.2114,-122.009,2360,8746,11124,11106,2360,28,28
3,2,1790,42399,1,0,0,4,7,1790,0,47.3143,-122.134,1330,40015,44189,41345,1790,29,29
2,2.75,1992,10946,1,1,4,5,6,1288,704,47.3551,-122.475,1110,8328,12938,9438,1992,116,116
3,3.25,1390,1278,2,0,0,3,8,1140,250,47.6735,-122.375,1390,1256,2668,2646,1390,14,14
1,1,920,8282,1,0,0,3,6,920,0,47.761,-122.214,2260,14025,9202,16285,920,75,34
4,1,1440,3600,1,0,0,4,7,1440,0,47.5694,-122.385,1010,5175,5040,6185,1440,95,95
4,2.5,2770,7000,1,0,0,4,7,1940,830,47.3396,-122.256,2140,7684,9770,9824,2770,40,40
2,2,1700,3171,1,0,0,5,5,850,850,47.3025,-122.224,1380,5906,4871,7286,1700,92,92
4,2.75,2420,8438,2,0,0,3,8,2420,0,47.2089,-122.011,2270,8770,10858,11040,2420,22,22
2,1,1210,6000,1,0,0,4,7,1000,210,47.6482,-122.402,1840,6000,7210,7840,1210,77,77
2,1,840,5100,1,0,0,4,7,840,0,47.6779,-122.384,1550,5100,5940,6650,840,70,70
3,2.5,2380,5017,2,0,0,3,9,2380,0,47.6297,-122.021,2670,6066,7397,8736,2380,16,16
3,1,1020,4960,1,0,0,3,6,920,100,47.5328,-122.275,1230,7335,5980,8565,1020,93,93
3,2.25,2890,21480,2,0,4,3,8,1790,1100,47.5027,-122.381,2110,8107,24370,10217,2890,78,25
3,2,1700,4250,1,0,0,3,6,890,810,47.6542,-122.385,1440,4250,5950,5690,1700,75,75
2,1.75,1440,6265,1,0,0,3,8,1440,0,47.7028,-122.013,1810,5209,7705,7019,1440,14,14
4,5,4630,24054,2,0,3,3,11,4630,0,47.587,-121.966,4630,17584,28684,22214,4630,14,14
5,3.5,3180,40946,1,0,3,3,7,1690,1490,47.5833,-122.073,2430,29620,44126,32050,3180,51,51
3,1,1710,12000,1,0,0,4,7,1710,0,47.2616,-122.281,1310,9600,13710,10910,1710,47,47
5,3.25,3920,4832,2,0,0,3,9,3030,890,47.5202,-121.885,2660,4832,8752,7492,3920,5,5
4,1,1330,2400,1,0,0,4,6,1330,0,47.65,-122.34,1330,4400,3730,5730,1330,118,118
2,1.5,960,7200,1,0,0,3,7,960,0,47.649,-122.403,1550,6000,8160,7550,960,109,27
5,2.5,2070,4698,2,0,0,3,7,2070,0,47.3539,-122.024,2010,4698,6768,6708,2070,20,20
2,2,1200,7131,1,0,0,3,8,1200,0,47.7199,-122.022,1670,4601,8331,6271,1200,13,13
2,2.5,1520,1588,2,0,0,3,8,1240,280,47.5825,-122.313,1660,6000,3108,7660,1520,12,12
4,2.5,2960,37430,2,0,0,3,9,2960,0,47.3988,-122.023,2800,36384,40390,39184,2960,29,29
2,1,1088,8453,1,0,0,3,6,1088,0,47.2685,-122.231,1088,8016,9541,9104,1088,67,6
3,1,1200,10500,1,0,0,3,7,1200,0,47.322,-122.351,1350,10500,11700,11850,1200,57,57
3,2.5,3590,8400,1,0,0,3,9,2950,640,47.595,-122.173,1620,7875,11990,9495,3590,61,8
4,2.75,3280,24440,2,0,0,3,10,3280,0,47.7073,-122.07,3490,25138,27720,28628,3280,23,23
3,2.25,1970,2377,2,0,0,3,8,1680,290,47.5631,-122.297,1690,1936,4347,3626,1970,11,11
3,1.75,1310,6960,1,0,0,4,7,1310,0,47.2761,-122.153,1580,7200,8270,8780,1310,45,45
3,2.5,1850,1499,2,0,0,3,9,1790,60,47.6475,-122.396,1770,1539,3349,3309,1850,14,14
3,1.5,1720,6570,1,0,0,4,8,1720,0,47.5284,-122.265,1360,6000,8290,7360,1720,110,110
2,1,1250,8100,1,0,0,4,7,1250,0,47.7294,-122.329,1710,8100,9350,9810,1250,72,72
2,1.5,790,1123,2,0,0,3,8,700,90,47.651,-122.368,1370,1281,1913,2651,790,16,16
4,2.5,2963,5797,2,0,0,3,9,2963,0,47.3831,-122.185,2665,6119,8760,8784,2963,13,13
4,1.75,1740,7208,1,0,0,3,8,1740,0,47.4483,-122.13,1680,7350,8948,9030,1740,43,43
4,2.5,3100,4699,2,0,0,3,9,3100,0,47.3785,-122.023,2450,5130,7799,7580,3100,9,9
2,1,1140,15624,1,0,0,4,6,1140,0,47.7673,-122.367,2110,15493,16764,17603,1140,110,110
3,2,1700,8400,2,0,2,3,7,1700,0,47.6825,-122.19,1820,9000,10100,10820,1700,92,92
3,3.5,3250,6000,2,0,0,3,10,2500,750,47.5533,-122.391,1650,6000,9250,7650,3250,18,18
2,1,910,9000,1,0,0,4,6,910,0,47.4463,-121.771,1410,9440,9910,10850,910,36,36
2,1.75,1660,4000,1,0,0,3,7,990,670,47.6394,-122.28,2070,4000,5660,6070,1660,79,79
5,4,4100,8120,2,0,0,3,9,4100,0,47.6917,-122.02,4100,7625,12220,11725,4100,8,8
4,3.25,4200,210394,2,0,0,4,10,4200,0,47.5607,-121.961,2370,184694,214594,187064,4200,26,26
3,2,1620,9566,1,0,0,4,7,1620,0,47.474,-122.146,1660,10011,11186,11671,1620,51,51
4,2,1500,3659,1,0,0,3,7,830,670,47.6088,-122.293,1560,3706,5159,5266,1500,113,113
3,1.75,1800,7210,1,0,0,3,7,1370,430,47.7346,-122.17,1820,8100,9010,9920,1800,43,43
4,2.25,2810,25990,2,0,0,3,8,1860,950,47.2993,-122.293,2020,16140,28800,18160,2810,60,60
4,2.5,2280,8190,1,0,3,3,7,1390,890,47.4414,-122.272,1990,9000,10470,10990,2280,36,36
5,2.25,3320,60984,2,0,0,3,9,3320,0,47.4862,-121.718,1580,55322,64304,56902,3320,19,19
2,1,820,4200,1,0,0,3,7,820,0,47.6249,-122.298,1290,4000,5020,5290,820,39,39
4,2.75,2920,6605,2,0,0,3,8,2920,0,47.4909,-122.144,3030,6605,9525,9635,2920,7,7
3,1,1060,7419,1,0,2,4,6,1060,0,47.7712,-122.392,2190,5953,8479,8143,1060,113,113
2,1,860,1800,1,0,0,3,7,860,0,47.6334,-122.371,2160,3120,2660,5280,860,110,110
3,1.75,1560,7424,1,0,0,5,8,1560,0,47.6981,-122.374,1370,7424,8984,8794,1560,79,79
3,2.5,1650,2201,3,0,0,3,8,1650,0,47.7108,-122.333,1650,1965,3851,3615,1650,12,12
3,2.75,1560,77536,1,0,0,3,7,1400,160,47.7695,-122.126,2210,41449,79096,43659,1560,41,41
3,1.75,1940,10245,1,0,0,3,7,1940,0,47.5833,-122.241,2720,11448,12185,14168,1940,62,62
4,1.75,2390,5880,1,0,2,3,8,1390,1000,47.6956,-122.399,2210,6260,8270,8470,2390,62,62
3,2.5,1920,3867,2,0,0,3,8,1920,0,47.5538,-121.994,2190,3841,5787,6031,1920,14,14
2,1,1530,6350,1,0,0,4,7,1530,0,47.6325,-122.303,2640,6350,7880,8990,1530,96,96
3,2,1810,12420,1,0,0,4,7,1810,0,47.5888,-122.127,2230,12330,14230,14560,1810,62,62
3,2.5,1440,4394,1,0,0,5,8,1440,0,47.5688,-122.019,1900,5893,5834,7793,1440,32,32
3,2.25,1750,8900,2,0,0,4,8,1750,0,47.4451,-122.136,1680,7910,10650,9590,1750,42,42
4,2.5,3520,15420,2,0,0,3,10,3520,0,47.6375,-122.016,3400,21455,18940,24855,3520,28,28
2,1.5,1580,3680,1,0,2,3,8,1280,300,47.5762,-122.377,1730,3680,5260,5410,1580,78,78
4,1.5,2140,7920,1,0,0,3,7,1190,950,47.5491,-122.272,2140,7238,10060,9378,2140,60,60
2,1,860,6120,1,0,0,3,7,860,0,47.7503,-122.328,1100,6860,6980,7960,860,71,71
5,3,2230,8560,1,0,0,3,8,1150,1080,47.6154,-122.115,2040,8560,10790,10600,2230,59,0
3,2.25,2680,10440,1,0,1,3,8,1540,1140,47.561,-122.398,2140,7560,13120,9700,2680,56,56
3,2,1450,8771,2,0,0,4,7,1450,0,47.1947,-121.989,1450,8653,10221,10103,1450,28,28
3,1.75,1740,5500,1,0,0,5,7,970,770,47.577,-122.395,1740,7250,7240,8990,1740,66,66
4,2.5,2210,5929,2,0,0,3,8,2210,0,47.35,-122.139,2200,5901,8139,8101,2210,15,15
3,1.75,1070,8100,1,0,0,4,6,1070,0,47.2853,-122.22,1260,8100,9170,9360,1070,62,62
4,2.5,3560,15450,1,0,1,5,8,2060,1500,47.5657,-122.23,3680,17314,19010,20994,3560,42,42
3,1.75,1500,15246,1,0,0,3,6,1500,0,47.4367,-122.463,1500,16988,16746,18488,1500,94,16
3,1.5,1480,7117,1,0,0,3,7,1170,310,47.7766,-122.248,2230,14775,8597,17005,1480,59,59
3,1.5,1510,8000,1,0,0,4,7,1510,0,47.5865,-122.135,1430,8000,9510,9430,1510,63,63
4,1,1560,4080,1,0,0,3,7,1560,0,47.6711,-122.331,1890,4080,5640,5970,1560,96,96
4,1,1550,7296,1,0,0,3,6,1550,0,47.5184,-122.366,1370,7680,8846,9050,1550,62,62
4,1.5,1680,10500,2,0,0,3,7,1680,0,47.6806,-122.166,1830,10264,12180,12094,1680,57,57
5,3.25,3510,10930,2,0,0,3,9,3510,0,47.6914,-122.21,1970,7488,14440,9458,3510,6,6
3,2,1270,6760,1,0,0,5,7,1270,0,47.7381,-122.179,1550,5734,8030,7284,1270,47,47
3,2,970,10000,1,0,0,5,7,970,0,47.6205,-122.063,1230,7500,10970,8730,970,47,47
4,2.5,2160,7725,1,0,0,4,8,1460,700,47.3078,-122.378,2060,8250,9885,10310,2160,41,41
2,1,1060,4960,1,0,0,3,7,1060,0,47.6896,-122.331,1420,4960,6020,6380,1060,93,93
3,1,1160,8813,1,0,0,3,7,1160,0,47.7257,-122.329,1200,7615,9973,8815,1160,67,67
3,1,1480,5100,1,0,0,3,7,1480,0,47.6915,-122.348,1300,5100,6580,6400,1480,81,55
3,1,1864,6978,1,0,0,4,7,1864,0,47.285,-122.206,990,8000,8842,8990,1864,61,61
2,1,720,4125,1,0,0,4,6,720,0,47.5245,-122.354,1000,6100,4845,7100,720,76,76
4,4,3570,8250,2,0,0,3,10,2860,710,47.5784,-122.226,2230,10000,11820,12230,3570,4,4
3,1.75,1670,5400,2,0,0,5,8,1670,0,47.635,-122.284,2100,5400,7070,7500,1670,107,107
2,2.25,1260,1312,3,0,0,3,8,1260,0,47.6538,-122.356,1300,1312,2572,2612,1260,12,12
2,2.5,1170,1811,2,0,0,3,8,1170,0,47.6132,-122.297,1250,3146,2981,4396,1170,18,18
5,4.5,4820,13165,2,0,0,4,11,3950,870,47.7295,-122.057,3880,13810,17985,17690,4820,29,29
2,3,1270,1175,2,0,0,3,8,1110,160,47.6634,-122.34,1290,1800,2445,3090,1270,19,19
4,3.5,3200,8049,1,0,0,3,8,2700,500,47.5841,-122.172,1640,8506,11249,10146,3200,39,39
4,5,5820,13906,2,0,0,3,11,3750,2070,47.3814,-122.164,2980,13000,19726,15980,5820,26,26
4,2,1650,6000,1,0,0,5,7,1000,650,47.5834,-122.307,1540,6000,7650,7540,1650,60,60
3,2.25,1690,7292,1,0,0,3,7,1250,440,47.2639,-122.303,1670,7747,8982,9417,1690,34,34
2,1,1450,4500,1,0,0,4,7,1450,0,47.6739,-122.396,1470,5000,5950,6470,1450,98,98
4,3.5,2000,2309,3,0,0,3,8,2000,0,47.7027,-122.361,1440,1548,4309,2988,2000,11,11
4,2.5,2580,5476,2,0,0,3,8,2580,0,47.4042,-122.205,2900,5476,8056,8376,2580,14,14
4,2.5,1960,5238,2,0,0,3,7,1960,0,47.3483,-122.052,1800,5894,7198,7694,1960,16,16
3,2.5,1960,8469,2,0,0,4,8,1960,0,47.7236,-122.105,2040,8189,10429,10229,1960,35,35
2,1,970,18557,1,0,0,3,6,970,0,47.5116,-122.37,1150,7200,19527,8350,970,80,80
4,2.5,2150,39449,1,0,0,3,7,1420,730,47.5531,-121.892,2010,35717,41599,37727,2150,41,41
3,2,1700,8160,1,0,0,3,7,1120,580,47.74,-122.339,1740,8181,9860,9921,1700,58,58
3,2.25,2060,38377,1,0,0,4,8,1560,500,47.2752,-122.319,2080,60513,40437,62593,2060,41,41
4,2.5,2800,8190,1,0,0,3,8,1700,1100,47.7695,-122.368,2460,8165,10990,10625,2800,48,48
4,2.5,3920,41206,2,0,0,4,10,3920,0,47.7325,-122.132,3780,36562,45126,40342,3920,31,31
3,3.25,3690,7200,2,0,0,3,11,3690,0,47.6815,-122.2,1880,7200,10890,9080,3690,12,12
3,1.5,1050,4590,1,0,0,3,7,850,200,47.6943,-122.29,1770,5400,5640,7170,1050,70,70
3,1,1040,11900,1,0,0,5,6,1040,0,47.4332,-122.446,1250,9600,12940,10850,1040,47,47
3,3.25,3790,19000,2,0,4,3,10,3790,0,47.724,-122.373,2740,18628,22790,21368,3790,34,34
3,3.25,1280,1730,2,0,0,3,8,1090,190,47.7032,-122.36,1280,2121,3010,3401,1280,14,14
6,3,3870,43787,2,0,0,3,8,2700,1170,47.7642,-122.098,2600,35381,47657,37981,3870,43,43
4,3.25,2520,3360,1,0,0,4,8,1550,970,47.6801,-122.315,1730,3360,5880,5090,2520,88,88
4,2.5,2700,9320,2,0,0,4,8,2700,0,47.6861,-122.198,2120,8056,12020,10176,2700,25,25
4,2.5,2020,4350,2,0,0,5,9,1730,290,47.6503,-122.41,1620,5800,6370,7420,2020,76,76
3,1,1830,8004,1,0,0,3,8,1200,630,47.7259,-122.297,1860,7971,9834,9831,1830,59,59
3,1.75,1250,5546,1,0,0,4,7,1250,0,47.4725,-122.187,1640,4791,6796,6431,1250,32,32
5,2.25,3070,64033,1,0,0,3,9,2730,340,47.3238,-122.292,1560,28260,67103,29820,3070,36,36
5,3.75,3570,14648,2,0,0,3,9,3570,0,47.7377,-121.974,3160,7882,18218,11042,3570,14,14
3,2,1410,6413,1,0,0,4,7,910,500,47.6826,-122.298,1330,6050,7823,7380,1410,72,72
4,1.75,2100,6480,1,0,0,5,7,1300,800,47.7049,-122.359,1840,7500,8580,9340,2100,72,72
3,1.75,1420,8738,1,0,0,4,7,1420,0,47.3113,-122.207,1660,8738,10158,10398,1420,53,53
4,2.5,2100,14773,2,0,0,3,8,2100,0,47.3045,-122.391,2370,15440,16873,17810,2100,21,21
3,2.5,2480,5007,2,0,0,3,8,1960,520,47.6974,-122.369,1650,7806,7487,9456,2480,5,5
3,1.75,1470,13068,1,0,0,4,7,1470,0,47.3096,-122.197,2090,16988,14538,19078,1470,44,44
3,2.25,1820,15000,1,0,0,3,7,1480,340,47.7401,-122.249,1930,13600,16820,15530,1820,41,41
3,1.75,2330,12141,1,0,0,3,7,1390,940,47.7607,-122.146,1850,12141,14471,13991,2330,36,36
5,1,2150,262231,1,0,0,3,7,2150,0,47.5519,-121.803,1460,46609,264381,48069,2150,119,14
3,2.5,3010,74390,2,0,0,3,10,3010,0,47.6442,-121.999,3240,109771,77400,113011,3010,21,21
5,2,2260,12500,1,0,0,4,8,1130,1130,47.3887,-122.286,1360,18000,14760,19360,2260,59,59
2,1,600,4854,1,0,0,5,6,600,0,47.4927,-122.28,1470,5000,5454,6470,600,97,97
4,2.25,2290,40946,1,0,3,4,8,1550,740,47.616,-122.103,2790,20076,43236,22866,2290,59,59
3,1.5,1900,9630,1,0,0,3,8,1900,0,47.3352,-122.344,2010,9630,11530,11640,1900,52,52
4,2.5,2960,4750,2,0,0,3,9,2960,0,47.5544,-121.993,2960,4750,7710,7710,2960,14,14
2,2,970,5000,1,0,0,3,7,970,0,47.7223,-122.16,1540,5000,5970,6540,970,36,36
3,1,1480,8415,1,0,0,3,7,1080,400,47.4585,-122.283,1780,8512,9895,10292,1480,52,52
4,2.25,2290,9900,1,0,2,4,8,1550,740,47.4434,-122.343,2320,9900,12190,12220,2290,60,60
3,1.75,1630,5999,1,0,0,4,7,1630,0,47.3816,-122.313,1540,7500,7629,9040,1630,34,34
4,2,1770,8890,1,0,0,5,6,1770,0,47.4589,-122.353,1010,7620,10660,8630,1770,70,70
3,1.75,1300,20700,1,0,0,3,7,1300,0,47.5587,-121.904,1930,37638,22000,39568,1300,57,57
4,2.25,2080,7700,1,0,0,3,7,1450,630,47.4349,-122.17,1900,7980,9780,9880,2080,51,51
4,2.5,2090,6906,2,0,0,4,8,2090,0,47.5718,-121.996,2090,6370,8996,8460,2090,27,27
3,2.75,2200,3885,2,0,0,3,8,2200,0,47.6171,-122.028,2710,6000,6085,8710,2200,17,17
2,1.75,1160,8625,1,0,0,4,6,1160,0,47.5509,-122.366,960,5750,9785,6710,1160,78,78
5,2.75,2540,5022,1,0,0,4,8,1540,1000,47.5593,-122.3,2510,5182,7562,7692,2540,64,64
3,2.25,2360,14950,1,0,0,4,9,2360,0,47.3856,-122.158,2720,14388,17310,17108,2360,41,41
4,2.75,2620,6178,2,0,0,3,8,2620,0,47.4823,-121.771,2790,6538,8798,9328,2620,6,6
3,2.5,1870,3118,2,0,0,3,8,1870,0,47.3739,-122.056,1580,3601,4988,5181,1870,26,26
3,2,1240,11172,1,0,0,3,7,1000,240,47.6364,-122.037,1330,14102,12412,15432,1240,35,35
3,1.75,1440,11364,1,0,0,3,7,1440,0,47.743,-122.328,1950,9390,12804,11340,1440,34,34
2,1,1500,3420,1,0,0,3,7,1500,0,47.661,-122.338,2050,3420,4920,5470,1500,117,117
3,1.75,1870,25157,2,0,0,3,7,1870,0,47.695,-121.915,1870,15391,27027,17261,1870,41,41
2,2,1520,1020,3,0,0,3,7,1520,0,47.7292,-122.343,1500,1245,2540,2745,1520,20,20
3,2.75,1990,31200,1,0,0,3,8,1990,0,47.5544,-122.035,3120,29625,33190,32745,1990,33,33
4,2.5,2410,7517,2,0,0,3,8,2410,0,47.4388,-122.142,2420,8095,9927,10515,2410,36,36
4,2.5,2520,10850,1,0,0,4,8,1680,840,47.7751,-122.284,2590,10800,13370,13390,2520,51,51
3,2.5,1920,12244,2,0,0,3,7,1920,0,47.7256,-121.97,1920,11859,14164,13779,1920,21,21
3,2.5,1620,1173,3,0,4,3,8,1470,150,47.6681,-122.355,1620,1505,2793,3125,1620,11,11
4,1.75,2060,26036,1,0,0,4,8,1160,900,47.4444,-122.351,2590,21891,28096,24481,2060,72,72
2,1,1130,5413,1,0,0,3,7,880,250,47.6971,-122.315,1250,5413,6543,6663,1130,80,80
2,1,800,8775,1,0,0,3,6,800,0,47.7171,-122.307,1470,8976,9575,10446,800,77,77
4,2.5,2700,5150,2,0,0,3,9,2700,0,47.5071,-122.148,3160,7620,7850,10780,2700,12,12
3,2.25,1570,43350,1,0,3,4,7,1570,0,47.2377,-122.016,1570,220849,44920,222419,1570,52,52
4,2.75,3160,8097,2,0,0,3,9,3160,0,47.6709,-122.166,2200,8097,11257,10297,3160,5,5
2,1,1140,5650,1,0,1,3,6,980,160,47.5634,-122.391,1220,5700,6790,6920,1140,99,99
4,3.25,4140,46173,2,0,0,3,9,4140,0,47.7647,-122.213,2060,43103,50313,45163,4140,12,12
3,1,950,4500,1,0,0,4,6,950,0,47.5273,-122.265,1140,4500,5450,5640,950,76,76
4,1,1140,13440,1,0,0,2,5,1140,0,47.4619,-122.344,1450,7560,14580,9010,1140,75,75
6,3,2530,9000,1,0,0,3,6,2530,0,47.6716,-122.199,1886,6000,11530,7886,2530,41,41
3,1.75,1580,14400,1,0,0,4,7,1580,0,47.2598,-122.281,1480,9600,15980,11080,1580,38,38
5,2,2280,5750,1,0,0,4,8,1140,1140,47.5672,-122.39,1780,5750,8030,7530,2280,68,68
3,1,1130,7800,1,0,0,3,7,1130,0,47.5239,-122.288,1170,7800,8930,8970,1130,67,67
2,1,990,57499,1,0,0,2,6,990,0,47.4145,-122.463,2090,27442,58489,29532,990,70,70
1,1,1110,5421,1,0,0,3,6,1110,0,47.7322,-122.359,1230,8100,6531,9330,1110,84,84
3,1,1170,1105,1,0,0,3,7,1170,0,47.5448,-122.375,1380,1399,2275,2779,1170,54,54
4,2.5,3520,8095,2,0,0,3,9,3520,0,47.7065,-122.109,2460,4676,11615,7136,3520,13,13
3,1.75,1440,4000,1,0,0,4,7,1050,390,47.5329,-122.354,1560,4000,5440,5560,1440,40,40
3,1.75,1410,1899,2,0,0,3,8,1410,0,47.5171,-122.347,1410,1811,3309,3221,1410,5,5
4,2.5,2920,9904,2,0,0,4,9,2920,0,47.5759,-121.995,1810,5617,12824,7427,2920,29,29
2,1.75,1530,4387,1,0,0,3,8,1020,510,47.6726,-122.264,1870,5029,5917,6899,1530,67,67
4,1,1460,7200,1,0,0,4,7,1460,0,47.7602,-122.306,1690,7357,8660,9047,1460,64,64
3,1.75,1496,1423,2,0,0,3,8,1248,248,47.715,-122.355,1460,1423,2919,2883,1496,13,13
5,3.25,2680,3011,2,0,0,3,9,1870,810,47.6115,-122.287,3440,5165,5691,8605,2680,109,0
3,1.75,1530,9800,1,0,0,5,8,1530,0,47.7655,-122.336,1660,9800,11330,11460,1530,61,61
3,1,1870,2807,1,0,0,4,7,1580,290,47.6674,-122.358,1640,4500,4677,6140,1870,92,92
3,2,1490,3880,1,0,0,3,7,1490,0,47.662,-122.363,1490,3880,5370,5370,1490,60,60
5,4,4280,11307,2,0,0,3,10,2710,1570,47.5503,-122.081,3080,11307,15587,14387,4280,23,23
3,2.25,2160,15360,1,0,0,3,8,1410,750,47.6232,-122.138,2180,8480,17520,10660,2160,54,14
4,3.25,3420,5012,2,0,0,3,10,2330,1090,47.732,-121.982,2320,5465,8432,7785,3420,11,11
4,1.5,1470,5100,1,0,0,3,7,1470,0,47.6769,-122.381,1470,5100,6570,6570,1470,73,73
3,1,960,12745,1,0,0,4,6,960,0,47.3617,-122.03,1160,10488,13705,11648,960,42,42
3,1,1240,4800,1,0,0,3,7,800,440,47.6563,-122.353,1440,4800,6040,6240,1240,68,68
3,1.5,1940,9887,1,0,0,4,7,1140,800,47.3289,-122.327,1410,9936,11827,11346,1940,50,50
4,3.75,4060,19290,2,0,0,3,10,4060,0,47.6051,-122.053,4020,13250,23350,17270,4060,17,17
3,1,840,12091,1,0,0,3,6,840,0,47.3281,-122.343,840,9324,12931,10164,840,60,60
3,2.25,1490,9414,2,0,0,3,7,1490,0,47.6844,-122.113,1290,10125,10904,11415,1490,38,38
4,2.5,3120,8792,2,0,0,4,9,3120,0,47.5699,-121.993,2150,7688,11912,9838,3120,27,27
3,2.25,1980,8775,1,0,0,3,7,1290,690,47.7753,-122.359,1550,9240,10755,10790,1980,60,60
3,1.75,1760,11371,1,0,0,5,8,1760,0,47.7616,-122.273,2220,19884,13131,22104,1760,60,60
3,1.5,1255,1374,3,0,0,3,7,1255,0,47.7145,-122.311,1307,1232,2629,2539,1255,15,15
3,2.25,1420,1230,2,0,0,3,8,940,480,47.5703,-122.288,1400,1230,2650,2630,1420,10,10
4,2.5,3020,36893,2,0,0,3,9,3020,0,47.768,-122.092,3020,36444,39913,39464,3020,33,8
3,1,1380,5400,1,0,0,4,7,1380,0,47.7134,-122.288,1190,6075,6780,7265,1380,65,65
4,2.25,2570,11070,2,0,0,4,8,2570,0,47.4507,-122.152,2210,9600,13640,11810,2570,53,53
3,2.75,2600,12860,1,0,0,3,7,1350,1250,47.695,-121.918,2260,12954,15460,15214,2600,54,54
3,3.5,3680,11491,2,0,2,3,11,3680,0,47.5647,-122.128,3710,10030,15171,13740,3680,20,20
3,2.5,2340,35021,1,0,0,3,9,2340,0,47.3988,-122.028,2630,35190,37361,37820,2340,33,33
5,2,1680,3240,1,0,0,3,5,840,840,47.5965,-122.311,1380,1260,4920,2640,1680,113,113
4,2.5,2060,8451,2,0,0,3,8,2060,0,47.7168,-122.333,2060,9460,10511,11520,2060,24,24
3,2.75,1850,8820,2,0,0,4,8,1850,0,47.1928,-122.01,1850,8651,10670,10501,1850,26,26
1,2,1150,9812,1,0,0,4,7,1150,0,47.2951,-122.284,1200,9812,10962,11012,1150,57,57
6,1.5,2550,33740,1,0,0,4,8,1750,800,47.3222,-122.362,2010,28200,36290,30210,2550,61,61
3,2,1270,3600,1,0,0,3,7,1270,0,47.6099,-122.297,1660,3600,4870,5260,1270,56,56
3,3.25,1470,1152,3,0,0,3,8,1470,0,47.6516,-122.337,1470,1506,2622,2976,1470,16,16
2,1,840,3522,1,0,0,3,6,840,0,47.6575,-122.395,1390,4800,4362,6190,840,72,72
4,2.5,1811,4381,2,0,0,3,8,1811,0,47.454,-122.19,1811,4150,6192,5961,1811,12,12
5,4,2710,2800,3,0,0,3,10,2380,330,47.6346,-122.364,1530,3600,5510,5130,2710,45,6
5,3.5,2950,7980,2,0,3,3,9,2350,600,47.5339,-121.858,2950,7980,10930,10930,2950,14,14
2,1,770,8150,1,0,0,3,6,770,0,47.5324,-122.275,1140,8550,8920,9690,770,68,68
3,1.75,1300,8099,1,0,0,4,7,1080,220,47.5026,-122.172,1270,8099,9399,9369,1300,43,43
3,2,1760,5000,1,0,0,5,7,960,800,47.6408,-122.403,1380,5000,6760,6380,1760,99,99
3,2.25,1440,6443,2,0,0,3,7,1440,0,47.7471,-121.979,1700,6749,7883,8449,1440,24,24
3,1,1310,9529,1,0,0,3,7,1310,0,47.4105,-122.295,1330,9529,10839,10859,1310,63,63
4,1.75,2950,9025,1,0,2,4,8,1780,1170,47.7128,-122.223,2120,9600,11975,11720,2950,44,44
3,2.25,1620,7350,1,0,0,3,7,1170,450,47.7248,-122.179,1800,7350,8970,9150,1620,50,50
2,1.5,2130,35679,1,0,0,4,7,2130,0,47.6638,-122.171,2670,35679,37809,38349,2130,56,56
2,2.5,1590,1485,2,0,0,3,8,1300,290,47.6375,-122.387,1880,3675,3075,5555,1590,25,25
3,2,2550,4794,2,0,0,3,9,2550,0,47.6955,-122.29,1630,5100,7344,6730,2550,12,12
4,3.25,2800,5291,2,0,0,3,7,2800,0,47.1937,-121.977,2380,5291,8091,7671,2800,8,8
2,2.5,2170,7665,1,0,2,3,8,2170,0,47.7112,-122.019,2300,7100,9835,9400,2170,6,6
3,2.5,1750,7208,2,0,0,3,8,1750,0,47.4315,-122.192,2050,7524,8958,9574,1750,25,25
4,2.25,3490,8400,1,0,0,4,8,3490,0,47.4513,-122.128,2320,8723,11890,11043,3490,43,43
3,3.25,1310,1072,2,0,0,3,8,1060,250,47.6744,-122.374,1160,1266,2382,2426,1310,11,11
4,2.5,3780,23623,2,0,0,3,9,3780,0,47.559,-122.118,3370,10210,27403,13580,3780,22,22
3,2.5,2060,4200,2,0,0,3,8,2060,0,47.3706,-122.018,2370,4200,6260,6570,2060,5,5
3,3.25,2950,4446,2,0,0,3,9,2450,500,47.5852,-122.391,1930,4255,7396,6185,2950,18,18
3,2.25,2860,8458,2,0,0,3,7,2860,0,47.4269,-122.148,1760,8458,11318,10218,2860,36,36
4,1.5,1690,11054,1,0,0,4,5,1690,0,47.4667,-122.215,1690,9040,12744,10730,1690,89,89
3,1.5,1860,17640,1,0,0,4,7,1860,0,47.484,-122.111,1860,17820,19500,19680,1860,53,53
3,2.25,1270,2790,1,0,0,3,7,990,280,47.6581,-122.396,1920,4000,4060,5920,1270,49,49
5,2.25,2060,9000,1,0,0,4,7,1320,740,47.6122,-122.137,2050,8800,11060,10850,2060,58,58
2,1.75,1460,10500,1,0,0,3,7,1460,0,47.4461,-121.768,1340,9600,11960,10940,1460,39,39
3,1,1690,20063,1,0,0,4,7,1690,0,47.3556,-122.294,1700,15899,21753,17599,1690,106,106
3,2.25,1530,3056,2,0,0,3,7,1530,0,47.6817,-122.035,1560,3064,4586,4624,1530,16,16
4,2.25,1740,9600,1,0,2,3,7,1160,580,47.432,-122.276,1630,9600,11340,11230,1740,62,62
2,1,1130,6908,1,0,0,3,6,1130,0,47.745,-122.313,1150,6908,8038,8058,1130,74,74
4,2.5,2550,7500,1,0,0,3,8,1750,800,47.3165,-122.386,2260,8800,10050,11060,2550,43,43
5,1,1120,9022,1,0,0,4,7,1120,0,47.7296,-122.24,1310,7500,10142,8810,1120,57,57
3,2.25,2200,8750,1,0,0,4,7,1120,1080,47.476,-122.337,1460,10139,10950,11599,2200,55,55
3,1.5,2390,4000,1,0,0,3,9,1690,700,47.6604,-122.28,2350,4000,6390,6350,2390,83,83
5,2.5,2732,9500,1,0,2,4,8,1870,862,47.3436,-122.323,2720,10000,12232,12720,2732,44,44
4,2.5,2420,5244,2,0,0,3,9,2420,0,47.4729,-122.35,1400,5250,7664,6650,2420,12,12
3,1,1150,5100,2,0,0,3,8,1150,0,47.5349,-122.384,1440,5100,6250,6540,1150,108,9
4,3.25,4030,57499,2,0,0,3,9,4030,0,47.6617,-122.026,3470,57499,61529,60969,4030,17,17
4,2.25,2500,10062,1,0,0,3,8,1600,900,47.639,-122.1,2500,9750,12562,12250,2500,44,44
2,1.5,1070,937,3,0,0,3,8,1070,0,47.6761,-122.3,1100,3200,2007,4300,1070,16,16
4,2.25,1900,7200,1,0,0,3,8,1370,530,47.5033,-122.372,2030,8008,9100,10038,1900,42,42
3,2.5,2120,2374,2,0,0,3,8,1770,350,47.674,-122.142,2480,3043,4494,5523,2120,14,14
5,2.5,2510,10240,1,0,0,4,8,1410,1100,47.4732,-122.141,2170,10500,12750,12670,2510,35,35
4,2.5,3810,7728,2,0,0,3,9,3810,0,47.5925,-122.058,3290,7728,11538,11018,3810,12,12
4,3.25,2830,4000,2,0,0,3,9,1910,920,47.5845,-122.291,2740,4000,6830,6740,2830,107,2
3,1.75,1420,1361,2,0,0,3,7,960,460,47.5684,-122.314,1340,1343,2781,2683,1420,5,5
3,1.5,2120,41325,1,0,0,4,7,1420,700,47.2906,-122.055,1780,42000,43445,43780,2120,46,46
4,3,3600,9687,2,0,0,4,9,3600,0,47.6257,-122.208,2620,10400,13287,13020,3600,60,19
3,1.75,1260,8400,1,0,0,3,7,1260,0,47.4366,-122.335,1290,8750,9660,10040,1260,65,65
4,2.25,2500,8500,2,0,0,4,8,2500,0,47.5569,-122.151,2470,9100,11000,11570,2500,40,40
3,1.75,710,5050,1,0,0,4,6,710,0,47.5194,-122.375,900,5050,5760,5950,710,69,69
5,4.5,4850,10584,2,1,4,3,10,3540,1310,47.5943,-122.11,3470,18270,15434,21740,4850,12,12
3,1.75,1900,6334,1,0,2,3,8,1450,450,47.6675,-122.276,1530,6334,8234,7864,1900,71,71
2,1,900,4800,1,0,0,4,6,780,120,47.6575,-122.4,1270,5520,5700,6790,900,75,75
3,2.5,1770,1235,3,0,0,3,8,1600,170,47.6965,-122.342,1680,1203,3005,2883,1770,12,12
3,1.75,2080,87991,1,0,0,3,6,1040,1040,47.6724,-121.865,2080,84300,90071,86380,2080,49,49
3,1.75,1350,7588,1,0,0,3,7,1350,0,47.3123,-122.023,1470,7341,8938,8811,1350,26,26
3,1,2430,10720,1,0,0,3,7,2430,0,47.4895,-121.787,1660,11560,13150,13220,2430,42,42
4,2.5,2740,5700,2,0,0,3,9,2740,0,47.3535,-122.026,3010,5281,8440,8291,2740,13,13
3,2.5,2460,10300,1,0,0,3,10,2460,0,47.6999,-122.391,2410,5250,12760,7660,2460,27,27
2,1,1040,7538,1,0,0,4,7,1040,0,47.7107,-122.352,1440,7530,8578,8970,1040,80,80
3,3,1790,2003,2,0,0,3,7,1480,310,47.5421,-122.321,1220,4000,3793,5220,1790,13,13
4,2.5,2413,5701,2,0,0,3,8,2413,0,47.3731,-122.159,2380,5725,8114,8105,2413,5,5
3,1,1330,77972,1,0,0,3,7,1330,0,47.6891,-122.159,1340,17689,79302,19029,1330,91,60
3,2.75,1420,955,2,0,0,3,8,1160,260,47.5477,-122.003,1420,955,2375,2375,1420,15,15
3,1.75,1480,8163,1,0,0,3,7,1040,440,47.638,-122.206,2170,11124,9643,13294,1480,66,66
2,1,950,3090,1,0,0,4,6,950,0,47.551,-122.276,1230,4120,4040,5350,950,110,110
3,2.5,1740,3043,2,0,0,3,7,1740,0,47.744,-122.181,1920,2869,4783,4789,1740,7,7
3,1.75,1720,9342,1,0,0,4,7,1140,580,47.3177,-122.182,1330,7540,11062,8870,1720,38,38
3,1.5,2210,6300,1,0,0,5,8,2210,0,47.5892,-122.29,2700,6300,8510,9000,2210,103,103
2,1,860,6510,1,0,0,3,7,860,0,47.6021,-122.202,1740,10800,7370,12540,860,67,67
4,2.5,2350,3800,2,0,0,3,8,2350,0,47.4783,-122.123,2670,4180,6150,6850,2350,5,5
4,1,1540,9541,1,0,0,4,7,1540,0,47.7104,-122.213,1290,9541,11081,10831,1540,58,58
4,2.5,2320,9264,2,0,0,3,8,2320,0,47.4449,-122.274,2320,9129,11584,11449,2320,25,25
4,3.5,3130,52322,2,0,0,3,9,2430,700,47.5932,-122.159,3200,5820,55452,9020,3130,8,8
3,1,1180,7669,1,0,0,4,7,1180,0,47.4479,-122.176,1190,7669,8849,8859,1180,52,52
3,2.5,2660,4975,2,0,0,3,8,2660,0,47.5487,-122.272,1840,6653,7635,8493,2660,5,5
3,1.75,1050,9871,1,0,0,5,7,1050,0,47.3816,-122.087,1300,10794,10921,12094,1050,51,51
4,1.5,1780,3120,1,0,3,3,8,1780,0,47.5589,-122.264,1710,3600,4900,5310,1780,93,93
3,2.5,2150,9375,1,0,0,3,8,1550,600,47.4578,-122.274,1950,9100,11525,11050,2150,51,51
4,1,1330,9729,1,0,0,3,6,1330,0,47.6223,-122.208,2920,10353,11059,13273,1330,67,67
5,3,2980,10064,1,0,0,3,7,1680,1300,47.7372,-122.316,1590,7800,13044,9390,2980,79,79
4,2.25,2620,98881,1,0,0,3,7,1820,800,47.4662,-122.453,1728,95832,101501,97560,2620,67,67
2,1,1500,6685,1,0,0,3,7,1190,310,47.7186,-122.354,1420,6561,8185,7981,1500,93,93
4,3,1810,5012,2,0,0,4,7,1810,0,47.5691,-122.292,1670,5161,6822,6831,1810,22,22
2,1,1570,125452,1,0,3,4,7,1570,0,47.2077,-122.016,1660,46119,127022,47779,1570,66,66
4,2.5,2290,5515,2,0,0,3,8,2290,0,47.5518,-122.357,1380,5515,7805,6895,2290,13,13
5,2,2330,6783,1,0,0,3,7,1310,1020,47.6955,-122.295,1930,6783,9113,8713,2330,63,63
6,5,2850,6600,2,0,0,3,7,2850,0,47.6813,-122.187,1870,9900,9450,11770,2850,25,25
4,2.25,3220,7700,2,0,0,4,8,3220,0,47.3188,-122.38,2570,7700,10920,10270,3220,43,43
4,2.5,1960,7230,2,0,0,3,8,1960,0,47.2855,-122.36,1850,7208,9190,9058,1960,17,17
6,2,1870,6969,1,0,0,4,7,1870,0,47.5342,-122.036,1500,6969,8839,8469,1870,51,51
4,2.5,2420,4500,2,0,0,3,7,2420,0,47.6874,-122.037,2280,4500,6920,6780,2420,18,18
3,1,1040,4240,1,0,0,4,7,860,180,47.6768,-122.367,1170,4240,5280,5410,1040,95,95
4,2.5,2340,13445,2,0,0,3,8,2340,0,47.374,-122.125,2340,11188,15785,13528,2340,29,29
3,1.75,1680,4800,1,0,0,4,7,1400,280,47.5535,-122.377,1540,5000,6480,6540,1680,59,59
3,1,1000,12070,1,0,0,4,7,1000,0,47.3621,-122.11,1010,12635,13070,13645,1000,51,51
3,3.5,2540,10578,2,0,1,3,9,2010,530,47.547,-122.192,3240,9831,13118,13071,2540,5,5
3,1.75,1500,19113,1,0,0,3,7,1500,0,47.6976,-121.916,1820,18151,20613,19971,1500,35,35
4,2.5,2960,223462,2,0,0,3,10,2960,0,47.3646,-122.211,2770,16482,226422,19252,2960,18,18
3,2.5,1070,1089,2,0,0,3,7,900,170,47.5902,-122.387,1450,1437,2159,2887,1070,10,10
4,2.25,2620,17366,1,0,3,3,9,1430,1190,47.584,-122.077,2620,15335,19986,17955,2620,35,35
3,2.5,1980,4500,2,0,0,3,7,1980,0,47.3682,-122.117,1980,4500,6480,6480,1980,7,7
4,1.75,2260,41236,1,0,0,4,8,1690,570,47.5528,-122.034,3080,30240,43496,33320,2260,57,57
4,2.25,1920,3225,1,0,0,5,7,1300,620,47.5848,-122.384,1960,3750,5145,5710,1920,96,96
4,3,2160,5200,1,0,0,3,7,1320,840,47.3627,-122.091,1460,5144,7360,6604,2160,41,41
2,1,1700,3040,1,0,0,3,8,1460,240,47.6442,-122.369,1620,3230,4740,4850,1700,105,105
4,2,1680,2600,1,0,0,5,7,840,840,47.6648,-122.363,1680,3340,4280,5020,1680,104,104
5,2.5,2850,209523,1,0,0,4,7,1930,920,47.3939,-122.089,2220,209523,212373,211743,2850,94,46
4,2.5,1640,6000,2,0,0,3,7,1640,0,47.559,-122.365,1640,4800,7640,6440,1640,8,8
3,1,1030,24750,1,0,2,3,5,1030,0,47.3343,-122.362,2810,28800,25780,31610,1030,76,76
3,2.75,2490,3600,2,0,0,3,8,2290,200,47.6098,-122.292,1880,3600,6090,5480,2490,113,113
2,1,900,4500,1,0,0,3,7,900,0,47.5273,-122.265,1175,5320,5400,6495,900,68,68
4,1.5,1600,6180,1,0,0,3,6,1600,0,47.5681,-122.285,1410,6180,7780,7590,1600,73,73
3,2,1290,7952,1,0,0,3,7,1290,0,47.3867,-122.19,1670,7280,9242,8950,1290,21,21
3,2.5,1909,1300,3,0,0,3,8,1766,143,47.6538,-122.352,1780,1248,3209,3028,1909,13,13
4,2.25,2000,9000,1,0,0,4,8,2000,0,47.3125,-122.387,2190,8374,11000,10564,2000,41,41
3,1.75,1000,8268,1,0,0,3,6,1000,0,47.7417,-122.172,1220,7800,9268,9020,1000,50,50
3,1.75,2230,13529,1,0,0,3,9,2230,0,47.6204,-122.217,2230,11900,15759,14130,2230,70,70
4,2.75,3120,34040,2,0,0,3,9,3120,0,47.3431,-122.03,2420,25201,37160,27621,3120,22,22
3,2.75,3940,9671,1,0,4,5,9,2140,1800,47.5654,-122.158,3390,9360,13611,12750,3940,52,52
4,2.5,2030,3974,2,0,0,3,8,2030,0,47.5692,-122.006,1780,3953,6004,5733,2030,25,25
4,2.5,2370,30378,2,0,0,3,8,2370,0,47.3389,-122.066,2870,34834,32748,37704,2370,23,23
4,2.5,3172,5033,2,0,0,3,8,3172,0,47.2961,-122.348,2704,5232,8205,7936,3172,5,5
3,1,1300,8266,1,0,0,4,7,1300,0,47.6337,-122.199,1300,8707,9566,10007,1300,66,66
2,1.75,2090,11317,1,0,0,5,7,1090,1000,47.4594,-122.279,1940,11317,13407,13257,2090,88,88
3,2,2560,216777,1,0,0,3,8,2560,0,47.295,-122.086,2360,108463,219337,110823,2560,33,33
5,2.25,2660,8400,1,0,0,5,7,2660,0,47.2909,-122.189,1590,8165,11060,9755,2660,58,58
3,2.5,3020,12184,2,0,0,3,8,3020,0,47.744,-121.976,2980,10029,15204,13009,3020,16,16
3,2.5,2210,70567,2,0,3,3,9,2210,0,47.6087,-121.895,2000,73616,72777,75616,2210,24,24
4,2.75,1500,7036,1,0,0,3,7,1060,440,47.3665,-122.276,1620,7200,8536,8820,1500,40,40
3,1.75,2040,81021,1,0,0,3,8,2040,0,47.6536,-122.045,2260,39280,83061,41540,2040,39,39
3,2.5,2090,8505,2,0,0,3,8,2090,0,47.7195,-122.371,1640,8100,10595,9740,2090,68,37
3,2,1350,11150,1,0,0,3,7,1110,240,47.446,-121.776,1290,10043,12500,11333,1350,24,24
3,2,2660,257875,1,0,2,4,8,1530,1130,47.553,-121.887,1710,64033,260535,65743,2660,43,43
4,2,2130,9579,1,0,0,4,7,1250,880,47.3069,-122.271,1590,9800,11709,11390,2130,51,51
3,1.5,1500,10200,1,0,0,3,8,1300,200,47.7598,-122.359,1950,9500,11700,11450,1500,64,64
4,2.5,2650,5880,2,0,0,3,9,2650,0,47.3509,-122.165,2610,6490,8530,9100,2650,14,14
4,1.5,2040,10726,1,0,0,3,7,1380,660,47.772,-122.358,1610,10020,12766,11630,2040,65,65
3,1,940,9272,1,0,0,3,7,940,0,47.4353,-122.335,1270,9375,10212,10645,940,65,65
2,1,1810,10360,1,0,0,3,6,1010,800,47.5039,-122.266,1810,10360,12170,12170,1810,73,73
3,1.75,2240,5657,1,0,2,4,8,1910,330,47.6621,-122.27,2970,5657,7897,8627,2240,78,78
2,1.5,1540,6549,2,0,0,3,7,1540,0,47.7189,-122.353,1470,6552,8089,8022,1540,39,39
3,1,1110,5000,1,0,0,3,7,1110,0,47.655,-122.359,1420,5000,6110,6420,1110,72,72
4,2.25,3010,12202,1,0,0,4,9,3010,0,47.6387,-122.174,2480,10143,15212,12623,3010,60,60
2,1,970,4560,1,0,0,4,7,970,0,47.6561,-122.332,1500,4560,5530,6060,970,112,112
2,2.25,930,747,2,0,0,3,8,630,300,47.5844,-122.316,940,6000,1677,6940,930,12,12
4,2.5,1890,7867,2,0,0,3,8,1890,0,47.3788,-122.031,2250,7867,9757,10117,1890,23,23
4,2.75,2230,50094,1,0,2,4,7,1330,900,47.2576,-122.099,2230,40770,52324,43000,2230,42,42
3,1,1200,9194,1,0,0,4,7,1200,0,47.7362,-122.319,1330,8650,10394,9980,1200,67,67
2,1,840,5400,1,0,0,4,7,840,0,47.5489,-122.271,1340,5400,6240,6740,840,71,71
4,2.5,3110,11422,2,0,0,3,9,3110,0,47.6833,-122.271,2850,7254,14532,10104,3110,30,30
3,2.5,3040,4535,2,0,0,3,9,3040,0,47.51,-122.185,2670,4666,7575,7336,3040,12,12
3,1,970,4800,1,0,0,3,6,970,0,47.6212,-122.298,1500,2042,5770,3542,970,69,69
4,3.5,2640,5900,2,0,2,3,8,2640,0,47.5421,-122.383,1700,5900,8540,7600,2640,82,16
3,2.25,1760,8287,1,0,0,3,7,1160,600,47.4501,-122.274,1290,9587,10047,10877,1760,33,33
3,1.5,1460,5040,1,0,0,3,7,1100,360,47.7112,-122.357,2330,7560,6500,9890,1460,48,48
3,2,1440,7008,1,0,0,3,7,1440,0,47.3702,-122.182,1680,7200,8448,8880,1440,34,34
4,2.75,4230,31747,2,0,0,4,10,4230,0,47.731,-122.132,4080,35576,35977,39656,4230,34,34
4,1.75,1620,10530,1,0,0,3,7,1620,0,47.3808,-122.211,1890,9975,12150,11865,1620,51,51
6,3.25,3560,107362,1,0,0,4,8,2760,800,47.6356,-122.15,3210,35001,110922,38211,3560,56,56
2,1,1100,4160,1,0,0,3,7,1100,0,47.6352,-122.352,1900,4000,5260,5900,1100,100,100
3,1.75,2040,11294,1,0,0,4,7,1340,700,47.5923,-122.197,2120,9587,13334,11707,2040,67,67
3,2.5,2830,5802,2,0,0,3,9,2830,0,47.7605,-122.234,2500,5788,8632,8288,2830,18,18
4,2.5,2080,4080,1,0,0,5,7,1040,1040,47.572,-122.29,1340,4080,6160,5420,2080,57,57
4,2,1650,3504,1,0,0,3,7,760,890,47.5803,-122.294,1480,3504,5154,4984,1650,68,2
2,1.5,1010,2102,2,0,0,3,7,1010,0,47.6374,-122.375,1480,2632,3112,4112,1010,35,35
3,3.5,3760,5634,2,1,4,3,11,2830,930,47.5285,-122.205,3560,5762,9394,9322,3760,5,5
2,1,1440,33747,1,0,0,3,7,1440,0,47.7223,-122.209,1980,8400,35187,10380,1440,91,91
3,1.5,1250,4000,1,0,0,3,7,1250,0,47.6916,-122.379,1030,4000,5250,5030,1250,64,64
3,2.25,1940,11612,1,0,0,4,8,1100,840,47.5018,-122.23,2180,8954,13552,11134,1940,38,38
4,2.5,2240,4447,2,0,0,3,7,2240,0,47.4868,-122.159,2000,3800,6687,5800,2240,13,13
4,2.5,1750,11381,1,0,0,4,7,1610,140,47.7425,-122.321,1080,11375,13131,12455,1750,72,72
4,3.25,4030,36762,2,0,0,3,11,4030,0,47.7235,-122.039,4090,40371,40792,44461,4030,31,31
3,2.25,2430,8327,1,0,0,4,9,1430,1000,47.5534,-122.16,2550,10427,10757,12977,2430,41,41
3,2.75,3010,206910,2,0,2,3,10,3010,0,47.4881,-121.721,1580,120675,209920,122255,3010,18,18
4,2.5,1830,6360,2,0,0,3,8,1830,0,47.4184,-122.18,1830,6596,8190,8426,1830,25,25
4,1.75,2510,7440,1,0,2,4,8,1290,1220,47.3748,-122.276,1790,8000,9950,9790,2510,57,57
4,2.5,2350,7203,2,0,0,3,8,2350,0,47.5123,-122.151,2260,7274,9553,9534,2350,30,30
4,2.5,2270,5000,2,0,0,3,9,2270,0,47.6916,-122.37,1210,5000,7270,6210,2270,5,5
3,2.5,3160,13603,2,0,0,3,8,3160,0,47.7443,-121.977,3050,9232,16763,12282,3160,16,16
3,3.5,2710,3475,2,0,0,3,8,1650,1060,47.5359,-122.072,2440,2867,6185,5307,2710,14,14
2,1,700,4800,1,0,0,3,7,700,0,47.6147,-122.3,1440,4800,5500,6240,700,97,97
2,2,1170,1890,1,0,1,4,8,1170,0,47.6402,-122.371,2160,4000,3060,6160,1170,92,92
1,1,710,4000,1,0,0,4,6,610,100,47.6562,-122.354,1440,4500,4710,5940,710,91,91
3,2.5,2790,31798,1,0,0,5,8,1650,1140,47.5241,-122.039,1400,14849,34588,16249,2790,66,66
4,2.5,3260,5608,2,0,0,3,9,3260,0,47.5453,-121.995,3010,5608,8868,8618,3260,16,16
2,1.75,1000,5100,1,0,0,3,6,940,60,47.6787,-122.391,1900,5100,6100,7000,1000,113,113
4,2.5,3180,5438,2,0,0,3,9,3180,0,47.5416,-121.864,3030,5335,8618,8365,3180,16,16
3,2.25,1920,7738,1,0,0,3,8,1520,400,47.4562,-122.33,2170,8452,9658,10622,1920,54,54
4,2.5,2400,9612,1,0,0,3,8,1230,1170,47.4799,-122.127,2430,5539,12012,7969,2400,57,6
2,1.75,2330,10143,1,0,2,4,7,1220,1110,47.4899,-122.359,2560,9750,12473,12310,2330,66,66
2,1,700,5200,1,0,0,5,5,700,0,47.4924,-122.174,970,5200,5900,6170,700,67,67
3,2.5,2680,87117,1,0,0,3,7,1340,1340,47.5646,-121.935,2580,87117,89797,89697,2680,30,30
3,1.75,1210,4400,1,0,0,4,8,1210,0,47.6621,-122.288,2020,3750,5610,5770,1210,89,89
3,1,840,8470,1,0,0,4,6,840,0,47.3275,-122.338,840,8450,9310,9290,840,58,58
2,1,990,57499,1,0,0,2,6,990,0,47.4145,-122.463,2090,27442,58489,29532,990,70,70
4,2.5,1900,5790,2,0,0,3,8,1900,0,47.5691,-121.996,2030,5790,7690,7820,1900,25,25
2,1,730,5040,1,0,0,3,6,730,0,47.5387,-122.374,790,5040,5770,5830,730,92,92
3,2,1290,7372,1,0,0,5,7,1290,0,47.3658,-122.085,1290,7366,8662,8656,1290,29,29
3,1,1190,11120,1,0,0,3,6,1190,0,47.5687,-121.898,1230,12720,12310,13950,1190,72,72
3,2.5,1690,10592,1,0,0,3,8,1690,0,47.58,-122.231,2260,9945,12282,12205,1690,46,6
5,1.75,2250,8970,1,0,0,4,7,1500,750,47.7217,-122.188,1940,8710,11220,10650,2250,53,53
2,1,710,9900,1,0,0,3,6,710,0,47.479,-122.339,1070,9900,10610,10970,710,76,76
4,2.25,1840,7575,1,0,0,4,7,1390,450,47.7328,-122.198,1820,7500,9415,9320,1840,46,46
4,2.5,2230,5970,2,0,0,4,7,2230,0,47.3745,-122.131,1970,4919,8200,6889,2230,17,17
4,2.5,3150,7277,2,0,0,3,9,3150,0,47.5159,-122.202,3030,8643,10427,11673,3150,13,13
4,1.75,2210,6375,1,0,0,3,8,1640,570,47.3268,-122.328,2070,7210,8585,9280,2210,42,42
3,1.5,1510,6600,1,0,0,3,6,1510,0,47.4821,-122.331,990,6600,8110,7590,1510,81,81
4,1.75,1200,7680,1,0,0,3,7,1200,0,47.3138,-122.192,1490,7800,8880,9290,1200,51,51
3,1.75,1470,9750,1,0,0,4,7,1470,0,47.6975,-122.12,1800,9600,11220,11400,1470,41,41
4,3.5,3560,4951,2,0,0,3,9,3560,0,47.6178,-122.055,3540,5500,8511,9040,3560,5,5
3,1.5,1440,28516,1,0,0,4,7,1440,0,47.5829,-122.005,2080,27049,29956,29129,1440,44,44
4,2.5,2470,4945,2,0,0,3,8,2470,0,47.6898,-122.015,2510,4988,7415,7498,2470,7,7
2,1,1380,4390,1,0,0,4,8,880,500,47.6947,-122.323,1390,5234,5770,6624,1380,88,88
4,3.25,3830,8331,2,0,0,3,9,3830,0,47.6906,-122.019,4080,8425,12161,12505,3830,5,5
4,3.75,2810,10840,2,0,2,4,8,2070,740,47.4861,-121.804,2370,11248,13650,13618,2810,25,25
3,2,2380,17950,2,0,0,4,8,2110,270,47.7591,-122.28,2030,23900,20330,25930,2380,85,85
2,2.75,1370,1140,2,0,0,3,8,1080,290,47.7052,-122.343,1370,1090,2510,2460,1370,10,10
3,1,1600,16868,1,0,1,3,7,990,610,47.5872,-122.241,2600,12735,18468,15335,1600,73,73
4,2.5,1930,14196,1,0,0,4,7,1330,600,47.7407,-122.097,1470,12852,16126,14322,1930,42,42
4,2,2730,12000,1,0,0,4,8,1410,1320,47.7733,-122.271,2730,9039,14730,11769,2730,21,21
4,1.75,2190,9400,1,0,0,4,7,1450,740,47.6531,-122.196,1980,9000,11590,10980,2190,57,57
5,1,1740,27350,1,0,0,4,5,1740,0,47.4809,-122.153,2760,10749,29090,13509,1740,61,61
3,1.75,1410,8100,2,0,0,3,7,1410,0,47.3617,-122.046,1560,8100,9510,9660,1410,34,34
2,1,680,6400,1,0,0,3,6,680,0,47.5136,-122.316,1240,7800,7080,9040,680,76,76
3,1.75,2170,73616,1,0,0,3,7,2170,0,47.2881,-122.086,1710,297514,75786,299224,2170,11,11
4,1.75,1640,10500,1,0,0,4,7,1010,630,47.6933,-122.116,1680,7650,12140,9330,1640,51,51
4,1.5,1580,10230,1,0,0,3,6,790,790,47.5002,-122.246,1130,6955,11810,8085,1580,74,6
3,2,1270,3090,2,0,0,5,7,1270,0,47.685,-122.359,1440,3090,4360,4530,1270,108,108
3,2.5,2930,33981,2,0,2,3,9,2930,0,47.5151,-122.12,3720,35230,36911,38950,2930,19,19
2,1,780,13500,1,0,0,4,7,780,0,47.7383,-122.074,2200,67518,14280,69718,780,73,25
2,1.75,800,4800,1,0,0,4,6,800,0,47.5559,-122.396,1090,5000,5600,6090,800,97,97
2,2,1470,2541,2,0,0,3,6,1470,0,47.3502,-122.02,1310,2721,4011,4031,1470,14,14
6,1.75,2460,6000,1,0,0,4,7,1230,1230,47.6721,-122.323,1560,4275,8460,5835,2460,106,106
5,1.75,2850,11860,1,0,0,3,9,2850,0,47.7503,-122.28,2640,11604,14710,14244,2850,68,68
2,1.5,1280,2096,2,0,0,3,7,1080,200,47.5872,-122.308,1340,7452,3376,8792,1280,12,12
3,2.5,2150,14092,2,0,0,3,8,2150,0,47.4621,-122.129,2400,10699,16242,13099,2150,28,28
3,2.5,1425,1179,3,0,0,3,8,1425,0,47.6963,-122.318,1285,1253,2604,2538,1425,11,11
3,2.5,3680,35617,1,0,0,3,10,2390,1290,47.7213,-122.12,3570,35633,39297,39203,3680,34,34
3,2.5,2432,9391,2,0,2,3,9,2432,0,47.3453,-122.267,2912,8932,11823,11844,2432,14,14
3,1.75,1240,13869,1,0,0,4,7,1240,0,47.6919,-122.21,1970,7790,15109,9760,1240,62,62
4,2.5,2040,11841,2,0,0,3,7,2040,0,47.3691,-122.074,1730,8808,13881,10538,2040,25,25
3,1.75,1660,8303,1,0,0,3,7,1380,280,47.4366,-122.171,1740,8320,9963,10060,1660,45,45
4,1.75,2000,5100,1,0,0,4,7,1130,870,47.6798,-122.391,1540,5100,7100,6640,2000,70,70
4,1.5,3160,19745,1,0,0,4,6,1840,1320,47.3103,-122.006,1540,8611,22905,10151,3160,51,51
4,1.75,1720,8300,1,0,0,4,8,1720,0,47.4654,-122.194,1840,8300,10020,10140,1720,54,54
4,2.25,2380,4876,2,0,0,4,9,2240,140,47.6822,-122.4,1780,4559,7256,6339,2380,71,71
3,1,810,7000,1,0,0,3,7,810,0,47.6591,-122.134,1820,7589,7810,9409,810,51,51
4,2.5,3450,39683,2,0,0,3,10,3450,0,47.342,-122.025,3350,39750,43133,43100,3450,17,17
4,2.5,2630,48706,2,0,0,3,8,2630,0,47.775,-122.125,2680,48706,51336,51386,2630,33,33
3,1.5,1270,1416,3,0,0,3,8,1270,0,47.6988,-122.317,1270,1413,2686,2683,1270,12,12
2,2.5,2270,1763,3,0,0,3,7,1820,450,47.6757,-122.121,2180,1763,4033,3943,2270,10,10
5,2.5,4600,19831,1,0,3,3,9,2300,2300,47.7608,-122.378,2890,19831,24431,22721,4600,63,0
3,2.25,1840,5752,2,0,0,3,7,1840,0,47.7042,-122.187,1670,2462,7592,4132,1840,16,16
4,2.5,2610,3500,1,0,0,5,7,1610,1000,47.6848,-122.326,1820,3900,6110,5720,2610,92,92
3,1,1230,9568,1,0,0,5,7,1230,0,47.539,-122.179,1270,9575,10798,10845,1230,57,57
2,1,950,7560,1,0,0,3,6,950,0,47.4499,-122.176,1160,7560,8510,8720,950,61,61
5,2,1750,8220,1,0,0,3,7,1750,0,47.7694,-122.321,1210,6760,9970,7970,1750,63,63
2,1,1000,3513,1,0,4,4,5,1000,0,47.5935,-122.39,1930,4920,4513,6850,1000,105,105
4,2,2040,11850,1,0,2,3,7,1020,1020,47.6891,-122.208,2040,8504,13890,10544,2040,60,60
3,2.5,1690,4102,2,0,0,3,7,1690,0,47.3552,-122.015,1830,4733,5792,6563,1690,16,16
2,1,870,7227,1,0,0,3,7,870,0,47.7288,-122.331,1250,7252,8097,8502,870,71,71
3,2.5,2160,9888,2,0,0,4,9,2160,0,47.6712,-122.142,3060,7829,12048,10889,2160,30,30
4,2.5,2040,16200,2,0,0,3,8,2040,0,47.7366,-121.958,2530,15389,18240,17919,2040,22,22
3,2.5,1520,5649,2,0,0,4,7,1520,0,47.7221,-122.162,1540,5000,7169,6540,1520,30,30
4,2.5,2000,37045,2,0,0,3,8,2000,0,47.3398,-122.071,2390,36868,39045,39258,2000,30,30
4,2.25,3130,41382,2,0,0,3,9,3130,0,47.6683,-122.034,3130,54886,44512,58016,3130,33,33
